"season","player_id","player_name","num_wins","num_loses","num_matches","win_percent"
1969,100002,"Pancho Segura",1,2,3,33.333333333333336
1969,100004,"Giuseppe Merlo",1,2,3,33.333333333333336
1969,100005,"Richard Pancho Gonzales",34,11,45,75.55555555555556
1969,100007,"Abe Segal",1,3,4,25
1969,100009,"Istvan Gulyas",6,6,12,50
1969,100010,"Luis Ayala",8,8,16,50
1969,100011,"Torben Ulrich",4,9,13,30.76923076923077
1969,100012,"Nicola Pietrangeli",8,6,14,57.142857142857146
1969,100014,"Trevor Fancutt",1,2,3,33.333333333333336
1969,100016,"Ken Rosewall",33,11,44,75
1969,100017,"Mal Anderson",11,8,19,57.89473684210526
1969,100018,"Barry Mackay",1,2,3,33.333333333333336
1969,100019,"Wieslaw Gasiorek",4,4,8,50
1969,100022,"Roy Emerson",40,17,57,70.17543859649123
1969,100025,"Barry Phillips Moore",11,10,21,52.38095238095238
1969,100026,"Andres Gimeno",35,13,48,72.91666666666667
1969,100027,"Gene Scott",1,3,4,25
1969,100028,"Manuel Santana",20,6,26,76.92307692307692
1969,100029,"Rod Laver",62,7,69,89.85507246376811
1969,100030,"Fred Stolle",40,15,55,72.72727272727273
1969,100032,"Patricio Rodriguez Chi",3,6,9,33.333333333333336
1969,100033,"Wilhelm Bungert",4,2,6,66.66666666666667
1969,100034,"Christian Kuhnke",7,4,11,63.63636363636363
1969,100035,"Ion Tiriac",13,12,25,52
1969,100036,"Rudy Hernando",2,3,5,40
1969,100037,"Nikola Pilic",21,16,37,56.75675675675676
1969,100038,"Jaime Pinto Bravo",5,7,12,41.666666666666664
1969,100039,"Boro Jovanovic",1,3,4,25
1969,100040,"Bob Hewitt",20,8,28,71.42857142857143
1969,100044,"Sergei Likhachev",1,3,4,25
1969,100047,"Bob Carmichael",16,11,27,59.25925925925926
1969,100048,"Earl Butch Buchholz",32,15,47,68.08510638297872
1969,100049,"Jim Mcmanus",6,12,18,33.333333333333336
1969,100050,"Martin Mulligan",13,5,18,72.22222222222223
1969,100051,"Premjit Lall",5,6,11,45.45454545454545
1969,100055,"Cliff Drysdale",23,16,39,58.97435897435897
1969,100056,"Harald Elschenbroich",4,3,7,57.142857142857146
1969,100057,"Pierre Barthes",17,20,37,45.945945945945944
1969,100058,"Roger Taylor",40,23,63,63.492063492063494
1969,100060,"Marty Riessen",27,17,44,61.36363636363637
1969,100061,"Tom Edlefsen",6,11,17,35.294117647058826
1969,100062,"Francois Jauffret",13,6,19,68.42105263157895
1969,100063,"William Higgins",2,9,11,18.181818181818183
1969,100065,"Terry Ryan",3,4,7,42.857142857142854
1969,100067,"Frew Mcmillan",7,11,18,38.888888888888886
1969,100068,"Herb Fitzgibbon",1,2,3,33.333333333333336
1969,100069,"Dennis Ralston",17,10,27,62.96296296296296
1969,100070,"Jan Kukal",8,7,15,53.333333333333336
1969,100071,"Jean Claude Barclay",3,10,13,23.076923076923077
1969,100073,"Mark Cox",11,8,19,57.89473684210526
1969,100074,"Arthur Ashe",53,17,70,75.71428571428571
1969,100075,"Owen Davidson",15,12,27,55.55555555555556
1969,100076,"Milan Holecek",7,8,15,46.666666666666664
1969,100077,"Daniel Contet",4,7,11,36.36363636363637
1969,100078,"Clark Graebner",17,8,25,68
1969,100079,"Bill Bowrey",23,14,37,62.16216216216216
1969,100081,"Charlie Pasarell",29,18,47,61.702127659574465
1969,100083,"Nicola Spear",3,7,10,30
1969,100084,"Tom Okker",63,15,78,80.76923076923077
1969,100085,"Hans Joachim Ploetz",5,7,12,41.666666666666664
1969,100086,"Frantisek Pala",1,4,5,20
1969,100087,"John Newcombe",59,19,78,75.64102564102564
1969,100088,"Patricio Cornejo",8,8,16,50
1969,100089,"Patrice Beust",7,10,17,41.1764705882353
1969,100090,"Dick Crealy",26,20,46,56.52173913043478
1969,100092,"Alex Metreveli",1,4,5,20
1969,100094,"Jim Osborne",17,8,25,68
1969,100096,"Peter Burwash",1,6,7,14.285714285714286
1969,100097,"Nicholas Kalogeropoulos",4,5,9,44.44444444444444
1969,100098,"Ove Nils Bengtson",4,6,10,40
1969,100099,"Thomaz Koch",15,9,24,62.5
1969,100100,"Tony Roche",66,16,82,80.48780487804878
1969,100101,"Mike Belkin",17,7,24,70.83333333333333
1969,100102,"Joaquin Loyo Mayo",3,4,7,42.857142857142854
1969,100103,"Peter Curtis",1,8,9,11.11111111111111
1969,100104,"D Richard Russell",2,7,9,22.22222222222222
1969,100105,"Allan Stone",21,16,37,56.75675675675676
1969,100106,"Graham Stilwell",10,5,15,66.66666666666667
1969,100108,"Chris Bovett",1,1,2,50
1969,100109,"Jun Kuki",1,2,3,33.333333333333336
1969,100110,"Terry Addison",11,13,24,45.833333333333336
1969,100111,"Ray Keldie",9,13,22,40.90909090909091
1969,100112,"John Clifton",1,2,3,33.333333333333336
1969,100113,"Jan Kodes",21,12,33,63.63636363636363
1969,100114,"Ray Ruffels",16,13,29,55.172413793103445
1969,100115,"Jaime Fillol",11,9,20,55
1969,100117,"Butch Seewagen",3,4,7,42.857142857142854
1969,100118,"Ivan Molina",2,2,4,50
1969,100119,"Ilie Nastase",16,15,31,51.61290322580645
1969,100120,"Robert Maud",15,8,23,65.21739130434783
1969,100121,"Raymond Moore",22,20,42,52.38095238095238
1969,100122,"Julian Ganzabal",2,2,4,50
1969,100123,"Patrick Hombergen",1,5,6,16.666666666666668
1969,100125,"John Cooper",5,5,10,50
1969,100126,"Stan Smith",39,12,51,76.47058823529412
1969,100127,"Tom Gorman",6,9,15,40
1969,100128,"Cliff Richey",41,13,54,75.92592592592592
1969,100129,"Jean Baptiste Chanfreau",3,15,18,16.666666666666668
1969,100130,"Vladimir Zednik",4,2,6,66.66666666666667
1969,100132,"Armistead Neely",1,3,4,25
1969,100134,"Roy Barth",9,6,15,60
1969,100135,"Onny Parun",6,11,17,35.294117647058826
1969,100136,"Humphrey Hose",3,5,8,37.5
1969,100137,"Hans Jurgen Pohmann",1,5,6,16.666666666666668
1969,100138,"Dan Bleckinger",1,4,5,20
1969,100139,"Gerald Battrick",8,10,18,44.44444444444444
1969,100140,"Steve Faulk",1,3,4,25
1969,100141,"Zeljko Franulovic",27,12,39,69.23076923076923
1969,100142,"Peter Szoke",1,1,2,50
1969,100144,"Robert Lutz",20,10,30,66.66666666666667
1969,100145,"Dick Dell",2,6,8,25
1969,100147,"Marcello Lara",1,2,3,33.333333333333336
1969,100148,"Ismail El Shafei",17,10,27,62.96296296296296
1969,100150,"Lito Alvarez",1,2,3,33.333333333333336
1969,100152,"David Lloyd",3,7,10,30
1969,100156,"Jasjit Singh",1,2,3,33.333333333333336
1969,100157,"Stanley Pasarell",1,1,2,50
1969,100158,"John Bartlett",3,5,8,37.5
1969,100159,"Vladimir Korotkov",4,2,6,66.66666666666667
1969,100160,"Georges Goven",10,10,20,50
1969,100161,"Jurgen Fassbender",1,3,4,25
1969,100162,"Brian Fairlie",5,6,11,45.45454545454545
1969,100163,"Tom Leonard",1,4,5,20
1969,100171,"John Yuill",2,2,4,50
1969,100173,"Andrew Pattison",1,1,2,50
1969,100174,"Manuel Orantes",14,7,21,66.66666666666667
1969,100175,"Zan Guerry",3,4,7,42.857142857142854
1969,100181,"Larry Turville",1,3,4,25
1969,100182,"Mike Estep",1,6,7,14.285714285714286
1969,100185,"Patrick Proisy",4,8,12,33.333333333333336
1969,100187,"Luis Felipe Tavares",1,1,2,50
1969,100201,"Syd Ball",1,4,5,20
1969,100203,"Phil Dent",10,12,22,45.45454545454545
1969,100212,"Franklin Robbins",4,4,8,50
1969,100214,"Adriano Panatta",1,4,5,20
1969,100215,"Fred Mcnair",1,2,3,33.333333333333336
1969,100217,"Robert Mckinley",5,4,9,55.55555555555556
1969,100219,"Geoff Masters",4,4,8,50
1969,100225,"Peter Doerner",3,3,6,50
1969,100227,"Alvin Gardiner",2,5,7,28.571428571428573
1969,100229,"Dick Stockton",2,4,6,33.333333333333336
1969,100231,"Erik Van Dillen",5,5,10,50
1969,100235,"Antonio Munoz",3,2,5,60
1969,100237,"Bill Freer",2,2,4,50
1969,100244,"John Alexander",15,12,27,55.55555555555556
1969,100250,"Woody Blocher",1,2,3,33.333333333333336
1969,100282,"Guillermo Vilas",2,1,3,66.66666666666667
1969,100317,"Stephen Warboys",1,2,3,33.333333333333336
1969,105914,"Ashley Hewitt",5,1,6,83.33333333333333
1969,106562,"Anthony Hammond",2,3,5,40
1969,106583,"Armando Cornejo",3,7,10,30
1969,106867,"Derek Schroder",1,2,3,33.333333333333336
1969,106964,"Ernie Mccabe",1,1,2,50
1969,107092,"Geza Varga",1,1,2,50
1969,107264,"Jaidip Mukherjea",1,1,2,50
1969,107309,"Jean Loup Rouyer",14,17,31,45.16129032258065
1969,107425,"Jose Moreno",1,1,2,50
1969,107436,"Jose Guerrero",1,2,3,33.333333333333336
1969,107728,"Massimo Di Domenico",3,4,7,42.857142857142854
1969,107799,"Miguel Olvera",2,2,4,50
1969,107969,"Per Jemsby",1,1,2,50
1969,107993,"Peter Pokorny",2,4,6,33.333333333333336
1969,108012,"Piero Toci",1,4,5,20
1969,108021,"Pietro Marzano",3,3,6,50
1969,108052,"Rauty Krog",5,8,13,38.46153846153846
1969,108085,"Richard Hawkes",2,4,6,33.333333333333336
1969,108342,"Tadeusz Nowicki",1,2,3,33.333333333333336
1969,108519,"William Coghlan",1,1,2,50
1969,109743,"Paul Hutchins",1,5,6,16.666666666666668
1969,109746,"Michele Leclercq",4,4,8,50
1969,109749,"Pancho Guzman",11,10,21,52.38095238095238
1969,109752,"Ingo Buding",10,9,19,52.63157894736842
1969,109760,"Jean Courcol",5,6,11,45.45454545454545
1969,109761,"Eric Drossart",1,3,4,25
1969,109764,"Bernard Paul",1,6,7,14.285714285714286
1969,109766,"Frank Tutvin",1,2,3,33.333333333333336
1969,109771,"Jairo Velasco",3,3,6,50
1969,109772,"Sergio Palmieri",1,5,6,16.666666666666668
1969,109775,"Robert Wilson",3,4,7,42.857142857142854
1969,109781,"Peter Marmureanu",3,2,5,60
1969,109782,"William Alvarez",1,1,2,50
1969,109783,"Bob Howe",3,7,10,30
1969,109792,"Vittorio Crotta",3,7,10,30
1969,109795,"Keith Carpenter",1,2,3,33.333333333333336
1969,109803,"John Brown",3,7,10,30
1969,109804,"Rod Brent",1,1,2,50
1969,109806,"David Brown",1,1,2,50
1969,109811,"Chauncey Steele Iii",1,4,5,20
1969,109812,"Jan Leschly",2,1,3,66.66666666666667
1969,109813,"Ken Fletcher",1,3,4,25
1969,109815,"Stanley Matthews",3,5,8,37.5
1969,109816,"E Victor Seixas",1,3,4,25
1969,109817,"Stefan Koudelka",3,3,6,50
1969,109819,"Keith Wooldridge",1,2,3,33.333333333333336
1969,109821,"Jorgen Ulrich",1,3,4,25
1969,109822,"Thomas Lejus",6,7,13,46.15384615384615
1969,109823,"Ron Holmberg",8,13,21,38.095238095238095
1969,109824,"Julian Krinsky",5,3,8,62.5
1969,109825,"Koji Watanabe",2,8,10,20
1969,109832,"Ezzat Nemati",1,1,2,50
1969,109833,"Richard Russell",2,2,4,50
1969,109835,"John Gardner",1,1,2,50
1969,109838,"Henry Hank Irvine",3,3,6,50
1969,109856,"Edison Mandarino",4,2,6,66.66666666666667
1969,109857,"Brian Cheney",1,2,3,33.333333333333336
1969,109879,"Jose Luis Arillla",1,3,4,25
1969,109891,"Hakar Zahr",1,1,2,50
1969,109895,"Ken Binns",2,1,3,66.66666666666667
1969,109898,"Jon Hainline",1,1,2,50
1969,109914,"Jackie Saul",2,2,4,50
1969,109927,"G Turner Howard",1,3,4,25
1969,109930,"Michael Sprenglemeyer",2,3,5,40
1969,109931,"Richard Leach",1,2,3,33.333333333333336
1969,109935,"John Sharpe",1,2,3,33.333333333333336
1969,109938,"Tom Mozur",2,4,6,33.333333333333336
1969,109960,"Harry Fauquier",2,2,4,50
1969,109961,"Lester Sack",4,3,7,57.142857142857146
1969,109964,"Brian Flood",1,1,2,50
1969,109968,"John Mcmanus",1,1,2,50
1969,109971,"Bill Monan",1,1,2,50
1969,109977,"William Harris",1,4,5,20
1969,109978,"Tony Pospisil",1,1,2,50
1969,109983,"Pedro Langre",1,2,3,33.333333333333336
1969,109985,"Tico Carrero",2,2,4,50
1969,109992,"Alphonso Ochoa",2,1,3,66.66666666666667
1969,109994,"Dave Harmon",1,3,4,25
1969,110001,"John Yeomans",1,1,2,50
1969,110004,"Josef Stabholz",1,1,2,50
1969,110007,"B Moreau",1,2,3,33.333333333333336
1969,110017,"John McDonald",2,2,4,50
1969,110018,"Keith Diepraam",1,2,3,33.333333333333336
1969,110130,"Andrzej Licis",1,2,3,33.333333333333336
1969,110175,"Thedy Stalder",1,1,2,50
1969,110181,"Hans Nerell",3,2,5,60
1969,110258,"Milan Tajenar",1,1,2,50
1969,110957,"Peter Jackson",1,1,2,50
1969,111136,"Terry Ryan",6,7,13,46.15384615384615
1969,112312,"Frank Arthur Sedgman",1,2,3,33.333333333333336
1969,112985,"Jean Pierre Courcol",4,5,9,44.44444444444444
1969,116865,"Bodo Nitsche",1,1,2,50
1969,117302,"Albert Gaertner",1,1,2,50
1969,125672,"Kenneth Reid",1,1,2,50
1969,125716,"James Buckley",1,1,2,50
1969,199999,"U Unknown",7,31,38,18.42105263157895
1969,201293,"Paul Sullivan",1,2,3,33.333333333333336
1969,201749,"Graydon Garner",1,2,3,33.333333333333336
1969,202515,"Pancho Segura",1,2,3,33.333333333333336
1969,202567,"Lenny Schloss",1,2,3,33.333333333333336
1969,202581,"Wanaro Ngodrella",1,4,5,20
1969,202674,"Keith Brebnor",1,1,2,50
1969,202715,"Peter Mors",1,1,2,50
1969,202896,"Rohan Summers",1,2,3,33.333333333333336
1969,202898,"Quentin Pretorius",1,2,3,33.333333333333336
1969,202955,"William Tym",1,4,5,20
1969,204611,"Brian Bowman",1,1,2,50
1969,207073,"John Mcgrath",1,1,2,50
1969,209027,"Peter Rigg",2,1,3,66.66666666666667
1969,209426,"Sidney Gordon",1,2,3,33.333333333333336
1969,209539,"Rob Kilderry",1,1,2,50
1969,209540,"Philip Holton",2,1,3,66.66666666666667
1969,209541,"Brian Ford",1,1,2,50
1969,209542,"Clive Wilderspin",1,1,2,50
1969,209543,"Tim Clayton",1,1,2,50
1969,209544,"J Bougher",1,1,2,50
1969,209545,"Trevor Baker",1,1,2,50
1969,209558,"Toomas Leius",3,2,5,60
1969,209561,"Alan Schwarz",1,1,2,50
1969,209573,"B Johnston",1,1,2,50
1969,209580,"Luis Alberto Ayala",1,1,2,50
1970,100002,"Pancho Segura",1,1,2,50
1970,100003,"Frank Sedgman",1,1,2,50
1970,100005,"Richard Pancho Gonzales",27,14,41,65.85365853658537
1970,100007,"Abe Segal",1,2,3,33.333333333333336
1970,100009,"Istvan Gulyas",12,7,19,63.1578947368421
1970,100010,"Luis Ayala",3,3,6,50
1970,100011,"Torben Ulrich",12,20,32,37.5
1970,100012,"Nicola Pietrangeli",4,4,8,50
1970,100016,"Ken Rosewall",68,18,86,79.06976744186046
1970,100017,"Mal Anderson",1,2,3,33.333333333333336
1970,100018,"Barry Mackay",9,9,18,50
1970,100019,"Wieslaw Gasiorek",3,3,6,50
1970,100020,"Alejandro Olmedo",1,3,4,25
1970,100022,"Roy Emerson",35,20,55,63.63636363636363
1970,100024,"Jan Eric Lundquist",1,1,2,50
1970,100025,"Barry Phillips Moore",17,11,28,60.714285714285715
1970,100026,"Andres Gimeno",41,23,64,64.0625
1970,100027,"Gene Scott",2,2,4,50
1970,100028,"Manuel Santana",21,7,28,75
1970,100029,"Rod Laver",85,14,99,85.85858585858585
1970,100030,"Fred Stolle",18,21,39,46.15384615384615
1970,100032,"Patricio Rodriguez Chi",7,6,13,53.84615384615385
1970,100033,"Wilhelm Bungert",6,2,8,75
1970,100034,"Christian Kuhnke",7,3,10,70
1970,100035,"Ion Tiriac",32,19,51,62.745098039215684
1970,100037,"Nikola Pilic",42,25,67,62.6865671641791
1970,100038,"Jaime Pinto Bravo",2,6,8,25
1970,100039,"Boro Jovanovic",1,4,5,20
1970,100040,"Bob Hewitt",40,15,55,72.72727272727273
1970,100041,"Ned Neely",1,1,2,50
1970,100047,"Bob Carmichael",42,26,68,61.76470588235294
1970,100048,"Earl Butch Buchholz",8,7,15,53.333333333333336
1970,100049,"Jim Mcmanus",23,24,47,48.93617021276596
1970,100050,"Martin Mulligan",7,7,14,50
1970,100051,"Premjit Lall",7,12,19,36.8421052631579
1970,100054,"Jose Mandarino",2,2,4,50
1970,100055,"Cliff Drysdale",45,25,70,64.28571428571429
1970,100056,"Harald Elschenbroich",8,8,16,50
1970,100057,"Pierre Barthes",20,21,41,48.78048780487805
1970,100058,"Roger Taylor",51,29,80,63.75
1970,100060,"Marty Riessen",44,25,69,63.768115942028984
1970,100061,"Tom Edlefsen",11,15,26,42.30769230769231
1970,100062,"Francois Jauffret",16,12,28,57.142857142857146
1970,100063,"William Higgins",2,4,6,33.333333333333336
1970,100064,"Juan Gisbert",7,6,13,53.84615384615385
1970,100065,"Terry Ryan",4,3,7,57.142857142857146
1970,100066,"Frank Froehling",8,10,18,44.44444444444444
1970,100067,"Frew Mcmillan",23,19,42,54.76190476190476
1970,100068,"Herb Fitzgibbon",1,4,5,20
1970,100069,"Dennis Ralston",37,23,60,61.666666666666664
1970,100070,"Jan Kukal",11,11,22,50
1970,100071,"Jean Claude Barclay",2,3,5,40
1970,100073,"Mark Cox",35,29,64,54.6875
1970,100074,"Arthur Ashe",66,18,84,78.57142857142857
1970,100075,"Owen Davidson",23,20,43,53.48837209302326
1970,100076,"Milan Holecek",1,5,6,16.666666666666668
1970,100077,"Daniel Contet",5,8,13,38.46153846153846
1970,100078,"Clark Graebner",42,20,62,67.74193548387096
1970,100079,"Bill Bowrey",22,22,44,50
1970,100080,"Szabolcz Baranyi",6,10,16,37.5
1970,100081,"Charlie Pasarell",20,16,36,55.55555555555556
1970,100083,"Nicola Spear",14,13,27,51.851851851851855
1970,100084,"Tom Okker",50,21,71,70.4225352112676
1970,100085,"Hans Joachim Ploetz",8,14,22,36.36363636363637
1970,100086,"Frantisek Pala",2,3,5,40
1970,100087,"John Newcombe",56,20,76,73.6842105263158
1970,100088,"Patricio Cornejo",8,14,22,36.36363636363637
1970,100089,"Patrice Beust",1,2,3,33.333333333333336
1970,100090,"Dick Crealy",28,17,45,62.22222222222222
1970,100092,"Alex Metreveli",15,6,21,71.42857142857143
1970,100093,"William Brown",1,3,4,25
1970,100094,"Jim Osborne",19,21,40,47.5
1970,100095,"Tony Bardsley",3,2,5,60
1970,100097,"Nicholas Kalogeropoulos",6,5,11,54.54545454545455
1970,100098,"Ove Nils Bengtson",1,4,5,20
1970,100099,"Thomaz Koch",12,9,21,57.142857142857146
1970,100100,"Tony Roche",47,14,61,77.04918032786885
1970,100101,"Mike Belkin",5,7,12,41.666666666666664
1970,100102,"Joaquin Loyo Mayo",19,19,38,50
1970,100103,"Peter Curtis",13,13,26,50
1970,100104,"D Richard Russell",2,12,14,14.285714285714286
1970,100105,"Allan Stone",10,13,23,43.47826086956522
1970,100106,"Graham Stilwell",15,28,43,34.883720930232556
1970,100109,"Jun Kuki",1,9,10,10
1970,100110,"Terry Addison",7,16,23,30.434782608695652
1970,100111,"Ray Keldie",6,15,21,28.571428571428573
1970,100112,"John Clifton",4,8,12,33.333333333333336
1970,100113,"Jan Kodes",47,24,71,66.19718309859155
1970,100114,"Ray Ruffels",26,17,43,60.46511627906977
1970,100115,"Jaime Fillol",26,19,45,57.77777777777778
1970,100117,"Butch Seewagen",6,10,16,37.5
1970,100119,"Ilie Nastase",53,17,70,75.71428571428571
1970,100120,"Robert Maud",16,12,28,57.142857142857146
1970,100121,"Raymond Moore",17,28,45,37.77777777777778
1970,100122,"Julian Ganzabal",1,1,2,50
1970,100123,"Patrick Hombergen",2,6,8,25
1970,100125,"John Cooper",5,9,14,35.714285714285715
1970,100126,"Stan Smith",60,21,81,74.07407407407408
1970,100127,"Tom Gorman",31,23,54,57.407407407407405
1970,100128,"Cliff Richey",80,20,100,80
1970,100129,"Jean Baptiste Chanfreau",3,12,15,20
1970,100130,"Vladimir Zednik",3,4,7,42.857142857142854
1970,100133,"Pat Cramer",2,2,4,50
1970,100134,"Roy Barth",8,19,27,29.62962962962963
1970,100135,"Onny Parun",14,17,31,45.16129032258065
1970,100137,"Hans Jurgen Pohmann",4,4,8,50
1970,100138,"Dan Bleckinger",1,1,2,50
1970,100139,"Gerald Battrick",17,15,32,53.125
1970,100141,"Zeljko Franulovic",51,23,74,68.91891891891892
1970,100142,"Peter Szoke",6,8,14,42.857142857142854
1970,100144,"Robert Lutz",15,13,28,53.57142857142857
1970,100147,"Marcello Lara",2,4,6,33.333333333333336
1970,100148,"Ismail El Shafei",19,26,45,42.22222222222222
1970,100150,"Lito Alvarez",2,4,6,33.333333333333336
1970,100152,"David Lloyd",3,10,13,23.076923076923077
1970,100157,"Stanley Pasarell",1,2,3,33.333333333333336
1970,100158,"John Bartlett",4,5,9,44.44444444444444
1970,100159,"Vladimir Korotkov",3,5,8,37.5
1970,100160,"Georges Goven",25,14,39,64.1025641025641
1970,100161,"Jurgen Fassbender",1,5,6,16.666666666666668
1970,100162,"Brian Fairlie",24,15,39,61.53846153846154
1970,100163,"Tom Leonard",1,5,6,16.666666666666668
1970,100169,"Ian Fletcher",2,3,5,40
1970,100172,"Modesto Tito Vazquez",3,1,4,75
1970,100173,"Andrew Pattison",8,10,18,44.44444444444444
1970,100174,"Manuel Orantes",21,8,29,72.41379310344827
1970,100175,"Zan Guerry",1,3,4,25
1970,100176,"Hans Kary",3,7,10,30
1970,100178,"Bob Giltinan",3,4,7,42.857142857142854
1970,100179,"Karl Meiler",4,5,9,44.44444444444444
1970,100182,"Mike Estep",3,4,7,42.857142857142854
1970,100186,"Jeff Borowiak",6,6,12,50
1970,100196,"Haroon Rahim",5,7,12,41.666666666666664
1970,100203,"Phil Dent",12,11,23,52.17391304347826
1970,100205,"Paul Gerken",3,6,9,33.333333333333336
1970,100213,"Fred Hemmes",1,2,3,33.333333333333336
1970,100214,"Adriano Panatta",4,4,8,50
1970,100217,"Robert Mckinley",3,7,10,30
1970,100219,"Geoff Masters",3,3,6,50
1970,100220,"Jiri Hrebec",1,1,2,50
1970,100225,"Peter Doerner",2,6,8,25
1970,100227,"Alvin Gardiner",2,3,5,40
1970,100229,"Dick Stockton",7,7,14,50
1970,100231,"Erik Van Dillen",2,9,11,18.181818181818183
1970,100232,"Eddie Dibbs",1,1,2,50
1970,100234,"Allan McDonald",2,8,10,20
1970,100235,"Antonio Munoz",2,4,6,33.333333333333336
1970,100237,"Bill Freer",3,4,7,42.857142857142854
1970,100244,"John Alexander",17,11,28,60.714285714285715
1970,100251,"Grover Raz Reid",1,1,2,50
1970,100257,"Ross Case",3,5,8,37.5
1970,100270,"Anand Amritraj",1,2,3,33.333333333333336
1970,100272,"Sandy Mayer",1,2,3,33.333333333333336
1970,100273,"Kim Warwick",2,5,7,28.571428571428573
1970,100281,"Sashi Menon",1,2,3,33.333333333333336
1970,100282,"Guillermo Vilas",2,4,6,33.333333333333336
1970,100284,"Jimmy Connors",5,4,9,55.55555555555556
1970,100289,"Byron Bertram",8,10,18,44.44444444444444
1970,100309,"Raul Ramirez",1,1,2,50
1970,100317,"Stephen Warboys",2,2,4,50
1970,100321,"Vijay Amritraj",1,2,3,33.333333333333336
1970,104039,"Petar Popovic",1,1,2,50
1970,106594,"Attila Korpas",4,3,7,57.142857142857146
1970,106616,"Bernard Montrenaud",2,5,7,28.571428571428573
1970,106631,"Bo Holmstrom",1,1,2,50
1970,106751,"Christoph Meyer",2,1,3,66.66666666666667
1970,106867,"Derek Schroder",3,5,8,37.5
1970,106971,"Ezio Di Matteo",1,3,4,25
1970,106996,"Felix Ponte",1,1,2,50
1970,107039,"Frank Schmitz",1,1,2,50
1970,107264,"Jaidip Mukherjea",3,3,6,50
1970,107275,"Jan Hordijk",1,1,2,50
1970,107309,"Jean Loup Rouyer",11,12,23,47.82608695652174
1970,107311,"Jean Paul Meyer",1,3,4,25
1970,107342,"Jim Moore",2,1,3,66.66666666666667
1970,107436,"Jose Guerrero",2,1,3,66.66666666666667
1970,107453,"Juan Couder",1,1,2,50
1970,107728,"Massimo Di Domenico",1,4,5,20
1970,107768,"Michael Burgener",1,1,2,50
1970,107799,"Miguel Olvera",2,3,5,40
1970,107810,"Mike Kreiss",1,4,5,20
1970,107965,"Pekka Saila",1,2,3,33.333333333333336
1970,107969,"Per Jemsby",2,2,4,50
1970,107993,"Peter Pokorny",2,8,10,20
1970,108052,"Rauty Krog",3,6,9,33.333333333333336
1970,108085,"Richard Hawkes",1,4,5,20
1970,108124,"Robert Stock",1,2,3,33.333333333333336
1970,108184,"Ruby Hoskowetz",1,1,2,50
1970,108342,"Tadeusz Nowicki",1,1,2,50
1970,108360,"Teimuraz Kakoulia",1,1,2,50
1970,109743,"Paul Hutchins",1,3,4,25
1970,109745,"Lew Hoad",9,6,15,60
1970,109746,"Michele Leclercq",4,4,8,50
1970,109748,"John Barrett",3,2,5,60
1970,109749,"Pancho Guzman",3,9,12,25
1970,109751,"Sever Dron",1,1,2,50
1970,109752,"Ingo Buding",11,13,24,45.833333333333336
1970,109761,"Eric Drossart",3,4,7,42.857142857142854
1970,109763,"Eduardo Zuleta",1,4,5,20
1970,109764,"Bernard Paul",2,8,10,20
1970,109771,"Jairo Velasco",1,1,2,50
1970,109777,"Alan Fox",4,4,8,50
1970,109781,"Peter Marmureanu",2,2,4,50
1970,109783,"Bob Howe",3,5,8,37.5
1970,109798,"Lenny Schloss",1,5,6,16.666666666666668
1970,109800,"Mathias Werren",2,2,4,50
1970,109801,"Ken Stuart",2,7,9,22.22222222222222
1970,109803,"John Brown",1,1,2,50
1970,109811,"Chauncey Steele Iii",5,6,11,45.45454545454545
1970,109812,"Jan Leschly",2,3,5,40
1970,109815,"Stanley Matthews",4,5,9,44.44444444444444
1970,109816,"E Victor Seixas",1,1,2,50
1970,109817,"Stefan Koudelka",5,6,11,45.45454545454545
1970,109823,"Ron Holmberg",3,15,18,16.666666666666668
1970,109833,"Richard Russell",2,3,5,40
1970,109835,"John Gardner",2,4,6,33.333333333333336
1970,109837,"John De Mendoza",1,2,3,33.333333333333336
1970,109844,"John Williams",1,1,2,50
1970,109856,"Edison Mandarino",1,2,3,33.333333333333336
1970,109862,"Alex Kurucz",1,3,4,25
1970,109887,"Ma Ilahi",1,1,2,50
1970,109914,"Jackie Saul",3,3,6,50
1970,109927,"G Turner Howard",3,5,8,37.5
1970,109957,"Gerry Perry",1,2,3,33.333333333333336
1970,110006,"Jean Pierre Loizeau",1,2,3,33.333333333333336
1970,110017,"John McDonald",1,2,3,33.333333333333336
1970,110018,"Keith Diepraam",8,9,17,47.05882352941177
1970,110107,"David Segal",2,1,3,66.66666666666667
1970,110181,"Hans Nerell",1,1,2,50
1970,110194,"Uwe Gottschalk",1,1,2,50
1970,110257,"Hansjorg Elzer",1,5,6,16.666666666666668
1970,110268,"Ernesto Aguirre",1,1,2,50
1970,110271,"Dieter Schultheiss",1,1,2,50
1970,110308,"U Lockington",1,1,2,50
1970,110849,"Luis Augusto Garcia",2,1,3,66.66666666666667
1970,110957,"Peter Jackson",1,1,2,50
1970,110991,"Jaidip Mukerjea",3,3,6,50
1970,111135,"Greg Perkins",2,2,4,50
1970,111136,"Terry Ryan",6,4,10,60
1970,111138,"Dennis Matthews",2,3,5,40
1970,112312,"Frank Arthur Sedgman",1,1,2,50
1970,117263,"William Alvarez",1,3,4,25
1970,117315,"Stepan Koudelka",2,3,5,40
1970,125583,"Tito Vazquez",1,1,2,50
1970,125676,"Pieter Soeters",1,1,2,50
1970,199999,"U Unknown",2,17,19,10.526315789473685
1970,202567,"Lenny Schloss",1,4,5,20
1970,202581,"Wanaro Ngodrella",2,2,4,50
1970,202909,"Frank McDonald",1,3,4,25
1970,202911,"Richard Howes",1,1,2,50
1970,202964,"Rodney Mandelstam",1,1,2,50
1970,207073,"John Mcgrath",1,1,2,50
1970,207077,"Desmond Early",1,1,2,50
1970,209427,"Lewis Sylvester",4,2,6,66.66666666666667
1970,209533,"Harry Sheridan",1,1,2,50
1970,209610,"Jamie Presslie",2,2,4,50
1970,209624,"C Wijono",1,1,2,50
1970,209639,"A G Barker",1,1,2,50
1970,209641,"A J Gould",1,1,2,50
1970,209642,"R Walker",1,1,2,50
1970,209643,"P Mortoire",1,1,2,50
1970,209644,"R Jenkin",1,1,2,50
1970,209645,"R W Davies",1,1,2,50
1970,209646,"P Scott",1,1,2,50
1970,209648,"C J Bendall",1,1,2,50
1970,209651,"S Joseph",1,1,2,50
1970,209679,"Geoff Stubbs",1,1,2,50
1970,209685,"L B Taylor",1,1,2,50
1970,209686,"Patrice Wiman",1,1,2,50
1971,100003,"Frank Sedgman",8,10,18,44.44444444444444
1971,100005,"Richard Pancho Gonzales",18,6,24,75
1971,100007,"Abe Segal",1,2,3,33.333333333333336
1971,100009,"Istvan Gulyas",11,10,21,52.38095238095238
1971,100010,"Luis Ayala",2,2,4,50
1971,100011,"Torben Ulrich",6,33,39,15.384615384615385
1971,100012,"Nicola Pietrangeli",7,5,12,58.333333333333336
1971,100013,"Neale Fraser",1,1,2,50
1971,100016,"Ken Rosewall",80,22,102,78.43137254901961
1971,100017,"Mal Anderson",6,3,9,66.66666666666667
1971,100019,"Wieslaw Gasiorek",3,3,6,50
1971,100020,"Alejandro Olmedo",15,14,29,51.724137931034484
1971,100022,"Roy Emerson",45,27,72,62.5
1971,100025,"Barry Phillips Moore",18,15,33,54.54545454545455
1971,100026,"Andres Gimeno",45,26,71,63.38028169014085
1971,100027,"Gene Scott",2,5,7,28.571428571428573
1971,100028,"Manuel Santana",14,7,21,66.66666666666667
1971,100029,"Rod Laver",72,20,92,78.26086956521739
1971,100030,"Fred Stolle",24,26,50,48
1971,100032,"Patricio Rodriguez Chi",1,6,7,14.285714285714286
1971,100033,"Wilhelm Bungert",2,4,6,33.333333333333336
1971,100034,"Christian Kuhnke",11,3,14,78.57142857142857
1971,100035,"Ion Tiriac",27,15,42,64.28571428571429
1971,100037,"Nikola Pilic",39,31,70,55.714285714285715
1971,100038,"Jaime Pinto Bravo",9,12,21,42.857142857142854
1971,100039,"Boro Jovanovic",12,11,23,52.17391304347826
1971,100040,"Bob Hewitt",15,8,23,65.21739130434783
1971,100045,"John Paish",3,7,10,30
1971,100047,"Bob Carmichael",39,34,73,53.42465753424658
1971,100049,"Jim Mcmanus",10,24,34,29.41176470588235
1971,100050,"Martin Mulligan",24,17,41,58.53658536585366
1971,100051,"Premjit Lall",2,4,6,33.333333333333336
1971,100053,"Colin Stubs",2,3,5,40
1971,100054,"Jose Mandarino",1,2,3,33.333333333333336
1971,100055,"Cliff Drysdale",76,29,105,72.38095238095238
1971,100056,"Harald Elschenbroich",11,8,19,57.89473684210526
1971,100057,"Pierre Barthes",47,25,72,65.27777777777777
1971,100058,"Roger Taylor",44,35,79,55.69620253164557
1971,100060,"Marty Riessen",68,31,99,68.68686868686869
1971,100061,"Tom Edlefsen",21,19,40,52.5
1971,100062,"Francois Jauffret",13,12,25,52
1971,100063,"William Higgins",3,4,7,42.857142857142854
1971,100064,"Juan Gisbert",22,14,36,61.111111111111114
1971,100065,"Terry Ryan",7,16,23,30.434782608695652
1971,100066,"Frank Froehling",44,31,75,58.666666666666664
1971,100067,"Frew Mcmillan",14,32,46,30.434782608695652
1971,100068,"Herb Fitzgibbon",6,3,9,66.66666666666667
1971,100069,"Dennis Ralston",25,19,44,56.81818181818182
1971,100070,"Jan Kukal",4,9,13,30.76923076923077
1971,100071,"Jean Claude Barclay",7,10,17,41.1764705882353
1971,100073,"Mark Cox",27,32,59,45.76271186440678
1971,100074,"Arthur Ashe",69,25,94,73.40425531914893
1971,100075,"Owen Davidson",21,29,50,42
1971,100076,"Milan Holecek",26,28,54,48.148148148148145
1971,100077,"Daniel Contet",3,5,8,37.5
1971,100078,"Clark Graebner",73,28,101,72.27722772277228
1971,100079,"Bill Bowrey",16,33,49,32.6530612244898
1971,100080,"Szabolcz Baranyi",4,8,12,33.333333333333336
1971,100081,"Charlie Pasarell",26,32,58,44.827586206896555
1971,100083,"Nicola Spear",9,20,29,31.03448275862069
1971,100084,"Tom Okker",72,28,100,72
1971,100085,"Hans Joachim Ploetz",2,5,7,28.571428571428573
1971,100086,"Frantisek Pala",10,11,21,47.61904761904762
1971,100087,"John Newcombe",61,16,77,79.22077922077922
1971,100088,"Patricio Cornejo",13,19,32,40.625
1971,100089,"Patrice Beust",1,3,4,25
1971,100090,"Dick Crealy",12,24,36,33.333333333333336
1971,100091,"Colin Dibley",31,20,51,60.78431372549019
1971,100092,"Alex Metreveli",18,4,22,81.81818181818181
1971,100093,"William Brown",1,3,4,25
1971,100094,"Jim Osborne",15,18,33,45.45454545454545
1971,100097,"Nicholas Kalogeropoulos",4,7,11,36.36363636363637
1971,100098,"Ove Nils Bengtson",6,7,13,46.15384615384615
1971,100099,"Thomaz Koch",19,11,30,63.333333333333336
1971,100100,"Tony Roche",17,14,31,54.83870967741935
1971,100101,"Mike Belkin",18,14,32,56.25
1971,100102,"Joaquin Loyo Mayo",12,18,30,40
1971,100103,"Peter Curtis",6,18,24,25
1971,100105,"Allan Stone",17,32,49,34.69387755102041
1971,100106,"Graham Stilwell",9,33,42,21.428571428571427
1971,100109,"Jun Kuki",7,10,17,41.1764705882353
1971,100110,"Terry Addison",14,23,37,37.83783783783784
1971,100111,"Ray Keldie",6,17,23,26.08695652173913
1971,100112,"John Clifton",2,6,8,25
1971,100113,"Jan Kodes",49,23,72,68.05555555555556
1971,100114,"Ray Ruffels",33,33,66,50
1971,100115,"Jaime Fillol",39,20,59,66.10169491525424
1971,100117,"Butch Seewagen",7,8,15,46.666666666666664
1971,100118,"Ivan Molina",2,3,5,40
1971,100119,"Ilie Nastase",73,13,86,84.88372093023256
1971,100120,"Robert Maud",22,31,53,41.509433962264154
1971,100121,"Raymond Moore",33,24,57,57.89473684210526
1971,100122,"Julian Ganzabal",1,1,2,50
1971,100123,"Patrick Hombergen",4,5,9,44.44444444444444
1971,100125,"John Cooper",17,17,34,50
1971,100126,"Stan Smith",62,16,78,79.48717948717949
1971,100127,"Tom Gorman",42,26,68,61.76470588235294
1971,100128,"Cliff Richey",67,21,88,76.13636363636364
1971,100129,"Jean Baptiste Chanfreau",15,17,32,46.875
1971,100130,"Vladimir Zednik",17,19,36,47.22222222222222
1971,100132,"Armistead Neely",4,4,8,50
1971,100133,"Pat Cramer",5,7,12,41.666666666666664
1971,100134,"Roy Barth",6,30,36,16.666666666666668
1971,100135,"Onny Parun",26,24,50,52
1971,100137,"Hans Jurgen Pohmann",5,6,11,45.45454545454545
1971,100139,"Gerald Battrick",29,17,46,63.04347826086956
1971,100140,"Steve Faulk",6,11,17,35.294117647058826
1971,100141,"Zeljko Franulovic",59,28,87,67.816091954023
1971,100142,"Peter Szoke",13,10,23,56.52173913043478
1971,100144,"Robert Lutz",51,28,79,64.55696202531645
1971,100145,"Dick Dell",2,8,10,20
1971,100146,"Jun Kamiwazumi",5,5,10,50
1971,100147,"Marcello Lara",3,3,6,50
1971,100148,"Ismail El Shafei",27,37,64,42.1875
1971,100149,"Toshiro Sakai",5,6,11,45.45454545454545
1971,100150,"Lito Alvarez",1,7,8,12.5
1971,100152,"David Lloyd",1,2,3,33.333333333333336
1971,100158,"John Bartlett",1,8,9,11.11111111111111
1971,100159,"Vladimir Korotkov",1,1,2,50
1971,100160,"Georges Goven",35,20,55,63.63636363636363
1971,100161,"Jurgen Fassbender",2,6,8,25
1971,100162,"Brian Fairlie",20,29,49,40.816326530612244
1971,100163,"Tom Leonard",4,15,19,21.05263157894737
1971,100169,"Ian Fletcher",10,8,18,55.55555555555556
1971,100170,"Bernard Mignot",3,5,8,37.5
1971,100171,"John Yuill",1,2,3,33.333333333333336
1971,100172,"Modesto Tito Vazquez",1,2,3,33.333333333333336
1971,100173,"Andrew Pattison",13,10,23,56.52173913043478
1971,100174,"Manuel Orantes",33,17,50,66
1971,100175,"Zan Guerry",5,7,12,41.666666666666664
1971,100176,"Hans Kary",7,13,20,35
1971,100178,"Bob Giltinan",10,6,16,62.5
1971,100179,"Karl Meiler",1,5,6,16.666666666666668
1971,100182,"Mike Estep",1,8,9,11.11111111111111
1971,100183,"Jim Ward",2,7,9,22.22222222222222
1971,100185,"Patrick Proisy",27,18,45,60
1971,100186,"Jeff Borowiak",26,20,46,56.52173913043478
1971,100190,"Norman Holmes",2,1,3,66.66666666666667
1971,100193,"Wanaro N'Godrella",3,5,8,37.5
1971,100196,"Haroon Rahim",16,16,32,50
1971,100199,"Patrice Dominguez",9,8,17,52.94117647058823
1971,100200,"Antonio Zugarelli",3,6,9,33.333333333333336
1971,100201,"Syd Ball",1,10,11,9.090909090909092
1971,100203,"Phil Dent",27,34,61,44.26229508196721
1971,100205,"Paul Gerken",8,10,18,44.44444444444444
1971,100206,"Kenichi Hirai",1,7,8,12.5
1971,100213,"Fred Hemmes",1,2,3,33.333333333333336
1971,100214,"Adriano Panatta",17,9,26,65.38461538461539
1971,100215,"Fred Mcnair",1,6,7,14.285714285714286
1971,100217,"Robert Mckinley",2,6,8,25
1971,100219,"Geoff Masters",12,19,31,38.70967741935484
1971,100220,"Jiri Hrebec",6,5,11,54.54545454545455
1971,100225,"Peter Doerner",5,5,10,50
1971,100226,"Mike Machette",1,2,3,33.333333333333336
1971,100227,"Alvin Gardiner",2,4,6,33.333333333333336
1971,100228,"Kjell Johansson",1,3,4,25
1971,100229,"Dick Stockton",13,9,22,59.09090909090909
1971,100231,"Erik Van Dillen",14,15,29,48.275862068965516
1971,100232,"Eddie Dibbs",5,3,8,62.5
1971,100234,"Allan McDonald",2,5,7,28.571428571428573
1971,100235,"Antonio Munoz",3,9,12,25
1971,100237,"Bill Freer",2,5,7,28.571428571428573
1971,100238,"Rick Fisher",1,2,3,33.333333333333336
1971,100243,"Steve Krulevitz",2,7,9,22.22222222222222
1971,100244,"John Alexander",45,36,81,55.55555555555556
1971,100245,"Jeff Austin",4,7,11,36.36363636363637
1971,100249,"Paolo Bertolucci",4,1,5,80
1971,100251,"Grover Raz Reid",1,2,3,33.333333333333336
1971,100255,"Roscoe Tanner",16,10,26,61.53846153846154
1971,100257,"Ross Case",21,18,39,53.84615384615385
1971,100261,"Brian Gottfried",5,8,13,38.46153846153846
1971,100265,"Cliff Letcher",3,4,7,42.857142857142854
1971,100267,"Rayno Seegers",1,2,3,33.333333333333336
1971,100272,"Sandy Mayer",1,4,5,20
1971,100278,"Frank Gebert",1,2,3,33.333333333333336
1971,100282,"Guillermo Vilas",1,1,2,50
1971,100283,"Andre Zietsmann",1,1,2,50
1971,100284,"Jimmy Connors",23,13,36,63.888888888888886
1971,100286,"Harold Solomon",10,7,17,58.8235294117647
1971,100288,"Tenny Svensson",1,2,3,33.333333333333336
1971,100289,"Byron Bertram",5,11,16,31.25
1971,100300,"Jose Higueras",1,1,2,50
1971,100304,"Robert Kreiss",4,6,10,40
1971,100309,"Raul Ramirez",1,4,5,20
1971,100317,"Stephen Warboys",2,1,3,66.66666666666667
1971,100327,"Willem Prinsloo",1,1,2,50
1971,100346,"Paul Kronk",1,2,3,33.333333333333336
1971,100374,"Javier Soler",1,1,2,50
1971,100376,"Buster C Mottram",2,1,3,66.66666666666667
1971,100545,"Deon Joubert",1,1,2,50
1971,106517,"Anatoli Volkov",1,1,2,50
1971,106561,"Anthony Fawcett",1,1,2,50
1971,106594,"Attila Korpas",3,5,8,37.5
1971,106616,"Bernard Montrenaud",1,1,2,50
1971,106797,"Cyril Rudman",1,1,2,50
1971,106867,"Derek Schroder",4,5,9,44.44444444444444
1971,106968,"Eugenio Castigliano",1,1,2,50
1971,106971,"Ezio Di Matteo",8,9,17,47.05882352941177
1971,107034,"Frank Falderbaum",3,3,6,50
1971,107078,"George Rudman",1,1,2,50
1971,107092,"Geza Varga",1,3,4,25
1971,107264,"Jaidip Mukherjea",2,3,5,40
1971,107275,"Jan Hordijk",1,2,3,33.333333333333336
1971,107309,"Jean Loup Rouyer",14,12,26,53.84615384615385
1971,107311,"Jean Paul Meyer",2,4,6,33.333333333333336
1971,107326,"Jeff Twist",2,2,4,50
1971,107425,"Jose Moreno",1,3,4,25
1971,107429,"Jose Castanon",1,2,3,33.333333333333336
1971,107436,"Jose Guerrero",2,5,7,28.571428571428573
1971,107453,"Juan Couder",1,1,2,50
1971,107456,"Juan Herrera",2,2,4,50
1971,107457,"Juan Ignacio Muntanola",1,1,2,50
1971,107561,"Leif Johansson",2,2,4,50
1971,107591,"Luis Bruguera",1,4,5,20
1971,107654,"Marco Consolini",1,1,2,50
1971,107728,"Massimo Di Domenico",4,7,11,36.36363636363637
1971,107810,"Mike Kreiss",2,8,10,20
1971,107965,"Pekka Saila",1,1,2,50
1971,107969,"Per Jemsby",2,1,3,66.66666666666667
1971,107993,"Peter Pokorny",3,5,8,37.5
1971,108012,"Piero Toci",3,4,7,42.857142857142854
1971,108036,"Rafael Ruiz",1,1,2,50
1971,108052,"Rauty Krog",3,2,5,60
1971,108124,"Robert Stock",1,2,3,33.333333333333336
1971,108133,"Roberto Lombardi",1,1,2,50
1971,108342,"Tadeusz Nowicki",3,1,4,75
1971,108350,"Takeshi Koura",1,4,5,20
1971,108360,"Teimuraz Kakoulia",1,1,2,50
1971,108477,"Vincenzo Franchitti",2,5,7,28.571428571428573
1971,109746,"Michele Leclercq",4,4,8,50
1971,109749,"Pancho Guzman",2,3,5,40
1971,109752,"Ingo Buding",4,8,12,33.333333333333336
1971,109760,"Jean Courcol",2,2,4,50
1971,109761,"Eric Drossart",2,6,8,25
1971,109763,"Eduardo Zuleta",1,2,3,33.333333333333336
1971,109769,"Norm Perry",1,2,3,33.333333333333336
1971,109771,"Jairo Velasco",3,4,7,42.857142857142854
1971,109772,"Sergio Palmieri",4,5,9,44.44444444444444
1971,109777,"Alan Fox",1,3,4,25
1971,109780,"Lars Olander",2,4,6,33.333333333333336
1971,109781,"Peter Marmureanu",3,3,6,50
1971,109792,"Vittorio Crotta",2,4,6,33.333333333333336
1971,109796,"Tito Vasquez",2,2,4,50
1971,109798,"Lenny Schloss",1,5,6,16.666666666666668
1971,109801,"Ken Stuart",1,1,2,50
1971,109804,"Rod Brent",1,1,2,50
1971,109812,"Jan Leschly",29,18,47,61.702127659574465
1971,109815,"Stanley Matthews",1,4,5,20
1971,109816,"E Victor Seixas",1,2,3,33.333333333333336
1971,109817,"Stefan Koudelka",2,5,7,28.571428571428573
1971,109821,"Jorgen Ulrich",3,5,8,37.5
1971,109823,"Ron Holmberg",4,6,10,40
1971,109824,"Julian Krinsky",1,2,3,33.333333333333336
1971,109833,"Richard Russell",9,15,24,37.5
1971,109835,"John Gardner",2,4,6,33.333333333333336
1971,109838,"Henry Hank Irvine",8,11,19,42.10526315789474
1971,109856,"Edison Mandarino",10,6,16,62.5
1971,109875,"Victor Egorov",1,1,2,50
1971,109878,"Franco Bartoni",4,5,9,44.44444444444444
1971,109879,"Jose Luis Arillla",2,7,9,22.22222222222222
1971,109881,"Atet Wijono",2,2,4,50
1971,109884,"Mervyn Rose",3,4,7,42.857142857142854
1971,109891,"Hakar Zahr",2,4,6,33.333333333333336
1971,109903,"Whitney Reed",1,1,2,50
1971,109908,"Tom Brown",1,2,3,33.333333333333336
1971,109912,"Ricky Buwalda",1,1,2,50
1971,109913,"Ralph Sender",1,1,2,50
1971,109914,"Jackie Saul",4,2,6,66.66666666666667
1971,109923,"Roberto Aubone",2,1,3,66.66666666666667
1971,109927,"G Turner Howard",1,7,8,12.5
1971,109935,"John Sharpe",1,2,3,33.333333333333336
1971,109948,"Clive Brebnor",3,2,5,60
1971,110031,"Brian Connor",1,1,2,50
1971,110039,"Sutarjo Sugiarto",1,1,2,50
1971,110081,"Brian Marcus",1,2,3,33.333333333333336
1971,110109,"Giordano Maioli",4,2,6,66.66666666666667
1971,110121,"Robin Ray",1,1,2,50
1971,110185,"Michael Hickey",1,1,2,50
1971,110194,"Uwe Gottschalk",1,1,2,50
1971,110276,"Ernst Blanke",1,1,2,50
1971,110286,"Vicente Zarazua",1,2,3,33.333333333333336
1971,110957,"Peter Jackson",1,1,2,50
1971,111135,"Greg Perkins",1,3,4,25
1971,111136,"Terry Ryan",3,5,8,37.5
1971,111138,"Dennis Matthews",3,2,5,60
1971,112299,"John Gavan Fraser",1,1,2,50
1971,112312,"Frank Arthur Sedgman",2,2,4,50
1971,112708,"Julian Mayers",1,1,2,50
1971,117263,"William Alvarez",1,2,3,33.333333333333336
1971,117308,"Eduardo Zuleta",1,3,4,25
1971,125578,"Tomas Lynch",1,1,2,50
1971,125672,"Kenneth Reid",1,1,2,50
1971,125716,"James Buckley",1,1,2,50
1971,143672,"William Mason",1,2,3,33.333333333333336
1971,201749,"Graydon Garner",2,2,4,50
1971,202515,"Pancho Segura",1,1,2,50
1971,202567,"Lenny Schloss",1,5,6,16.666666666666668
1971,202716,"Frank Briscoe",1,2,3,33.333333333333336
1971,202776,"Robert Millington",1,1,2,50
1971,202879,"Max Cocks",1,1,2,50
1971,202896,"Rohan Summers",2,2,4,50
1971,207077,"Desmond Early",1,1,2,50
1971,209422,"Colin Rees",4,2,6,66.66666666666667
1971,209423,"Stan Myerson",1,1,2,50
1971,209424,"Piet Snyman",1,1,2,50
1971,209425,"Alfred Schwartz",1,1,2,50
1971,209426,"Sidney Gordon",1,2,3,33.333333333333336
1971,209427,"Lewis Sylvester",1,2,3,33.333333333333336
1971,209428,"Errol Kilov",1,1,2,50
1971,209429,"Robert Morrison",1,1,2,50
1971,209430,"Ruan Kruger",1,1,2,50
1971,209431,"Basil Wheeler",1,1,2,50
1971,209533,"Harry Sheridan",1,1,2,50
1971,209574,"Roy Schwegman",1,1,2,50
1971,209577,"Dave Phillips",1,1,2,50
1971,209604,"Colin Diederichs",1,1,2,50
1971,209705,"Neville Nette",1,1,2,50
1971,209706,"Paul Hearnden",1,1,2,50
1971,209707,"M Lorenzo",1,1,2,50
1971,209726,"Lex Hester",1,NA,NA,NA
1971,209731,"Antonio Martinez",1,1,2,50
1971,209732,"Alberto Riba",1,1,2,50
1971,209733,"Ignacio Garcia Atance",1,1,2,50
1971,209734,"Antonio Solana",1,1,2,50
1971,209735,"Jose Manuel Dominguez",1,1,2,50
1971,209736,"Juan Carlos Arroyo",1,1,2,50
1971,209748,"Walter Lanz",1,1,2,50
1971,209750,"Reinhard Mattern",1,2,3,33.333333333333336
1971,209762,"Maurizio Aracri",1,1,2,50
1971,209766,"Giovanni Capozza",1,1,2,50
1972,100004,"Giuseppe Merlo",1,1,2,50
1972,100005,"Richard Pancho Gonzales",27,12,39,69.23076923076923
1972,100009,"Istvan Gulyas",4,7,11,36.36363636363637
1972,100011,"Torben Ulrich",1,7,8,12.5
1972,100012,"Nicola Pietrangeli",6,10,16,37.5
1972,100013,"Neale Fraser",6,7,13,46.15384615384615
1972,100016,"Ken Rosewall",61,15,76,80.26315789473684
1972,100017,"Mal Anderson",25,9,34,73.52941176470588
1972,100019,"Wieslaw Gasiorek",3,3,6,50
1972,100020,"Alejandro Olmedo",19,16,35,54.285714285714285
1972,100022,"Roy Emerson",31,25,56,55.357142857142854
1972,100025,"Barry Phillips Moore",35,23,58,60.3448275862069
1972,100026,"Andres Gimeno",51,23,74,68.91891891891892
1972,100027,"Gene Scott",6,6,12,50
1972,100028,"Manuel Santana",1,2,3,33.333333333333336
1972,100029,"Rod Laver",50,16,66,75.75757575757575
1972,100030,"Fred Stolle",23,29,52,44.23076923076923
1972,100032,"Patricio Rodriguez Chi",1,6,7,14.285714285714286
1972,100033,"Wilhelm Bungert",6,6,12,50
1972,100034,"Christian Kuhnke",1,1,2,50
1972,100035,"Ion Tiriac",23,26,49,46.93877551020408
1972,100037,"Nikola Pilic",34,29,63,53.96825396825397
1972,100038,"Jaime Pinto Bravo",10,12,22,45.45454545454545
1972,100039,"Boro Jovanovic",10,10,20,50
1972,100040,"Bob Hewitt",48,14,62,77.41935483870968
1972,100045,"John Paish",15,14,29,51.724137931034484
1972,100047,"Bob Carmichael",20,31,51,39.21568627450981
1972,100049,"Jim Mcmanus",14,26,40,35
1972,100050,"Martin Mulligan",3,8,11,27.272727272727273
1972,100051,"Premjit Lall",3,3,6,50
1972,100054,"Jose Mandarino",3,4,7,42.857142857142854
1972,100055,"Cliff Drysdale",51,29,80,63.75
1972,100056,"Harald Elschenbroich",8,8,16,50
1972,100057,"Pierre Barthes",40,25,65,61.53846153846154
1972,100058,"Roger Taylor",43,28,71,60.563380281690144
1972,100060,"Marty Riessen",56,29,85,65.88235294117646
1972,100061,"Tom Edlefsen",10,10,20,50
1972,100062,"Francois Jauffret",12,8,20,60
1972,100063,"William Higgins",6,9,15,40
1972,100064,"Juan Gisbert",24,20,44,54.54545454545455
1972,100065,"Terry Ryan",3,7,10,30
1972,100066,"Frank Froehling",13,36,49,26.53061224489796
1972,100067,"Frew Mcmillan",30,27,57,52.63157894736842
1972,100068,"Herb Fitzgibbon",1,3,4,25
1972,100069,"Dennis Ralston",2,2,4,50
1972,100070,"Jan Kukal",6,12,18,33.333333333333336
1972,100071,"Jean Claude Barclay",3,5,8,37.5
1972,100073,"Mark Cox",46,30,76,60.526315789473685
1972,100074,"Arthur Ashe",70,26,96,72.91666666666667
1972,100075,"Owen Davidson",2,12,14,14.285714285714286
1972,100076,"Milan Holecek",5,14,19,26.31578947368421
1972,100077,"Daniel Contet",1,3,4,25
1972,100078,"Clark Graebner",29,20,49,59.183673469387756
1972,100079,"Bill Bowrey",5,11,16,31.25
1972,100080,"Szabolcz Baranyi",14,15,29,48.275862068965516
1972,100081,"Charlie Pasarell",37,28,65,56.92307692307692
1972,100082,"Roger Dowdeswell",1,1,2,50
1972,100083,"Nicola Spear",3,11,14,21.428571428571427
1972,100084,"Tom Okker",73,32,105,69.52380952380952
1972,100085,"Hans Joachim Ploetz",1,4,5,20
1972,100086,"Frantisek Pala",15,15,30,50
1972,100087,"John Newcombe",72,23,95,75.78947368421052
1972,100088,"Patricio Cornejo",10,18,28,35.714285714285715
1972,100090,"Dick Crealy",18,13,31,58.064516129032256
1972,100091,"Colin Dibley",48,31,79,60.75949367088607
1972,100092,"Alex Metreveli",38,5,43,88.37209302325581
1972,100093,"William Brown",1,2,3,33.333333333333336
1972,100094,"Jim Osborne",8,20,28,28.571428571428573
1972,100096,"Peter Burwash",2,4,6,33.333333333333336
1972,100097,"Nicholas Kalogeropoulos",4,7,11,36.36363636363637
1972,100098,"Ove Nils Bengtson",17,24,41,41.46341463414634
1972,100099,"Thomaz Koch",13,17,30,43.333333333333336
1972,100100,"Tony Roche",19,15,34,55.88235294117647
1972,100101,"Mike Belkin",3,10,13,23.076923076923077
1972,100102,"Joaquin Loyo Mayo",5,9,14,35.714285714285715
1972,100104,"D Richard Russell",1,2,3,33.333333333333336
1972,100105,"Allan Stone",17,30,47,36.170212765957444
1972,100106,"Graham Stilwell",10,28,38,26.31578947368421
1972,100109,"Jun Kuki",3,11,14,21.428571428571427
1972,100110,"Terry Addison",8,26,34,23.529411764705884
1972,100111,"Ray Keldie",2,5,7,28.571428571428573
1972,100113,"Jan Kodes",44,15,59,74.57627118644068
1972,100114,"Ray Ruffels",19,22,41,46.34146341463415
1972,100115,"Jaime Fillol",43,31,74,58.108108108108105
1972,100116,"Sherwood Stewart",3,8,11,27.272727272727273
1972,100117,"Butch Seewagen",7,9,16,43.75
1972,100118,"Ivan Molina",9,15,24,37.5
1972,100119,"Ilie Nastase",110,20,130,84.61538461538461
1972,100120,"Robert Maud",6,26,32,18.75
1972,100121,"Raymond Moore",20,20,40,50
1972,100122,"Julian Ganzabal",3,3,6,50
1972,100123,"Patrick Hombergen",12,8,20,60
1972,100125,"John Cooper",25,17,42,59.523809523809526
1972,100126,"Stan Smith",74,11,85,87.05882352941177
1972,100127,"Tom Gorman",41,25,66,62.121212121212125
1972,100128,"Cliff Richey",54,25,79,68.35443037974683
1972,100129,"Jean Baptiste Chanfreau",5,16,21,23.80952380952381
1972,100130,"Vladimir Zednik",19,20,39,48.717948717948715
1972,100133,"Pat Cramer",17,19,36,47.22222222222222
1972,100134,"Roy Barth",1,27,28,3.5714285714285716
1972,100135,"Onny Parun",35,35,70,50
1972,100136,"Humphrey Hose",4,5,9,44.44444444444444
1972,100138,"Dan Bleckinger",2,4,6,33.333333333333336
1972,100139,"Gerald Battrick",17,33,50,34
1972,100140,"Steve Faulk",8,9,17,47.05882352941177
1972,100141,"Zeljko Franulovic",4,7,11,36.36363636363637
1972,100142,"Peter Szoke",3,13,16,18.75
1972,100144,"Robert Lutz",40,30,70,57.142857142857146
1972,100145,"Dick Dell",7,15,22,31.818181818181817
1972,100146,"Jun Kamiwazumi",13,12,25,52
1972,100147,"Marcello Lara",1,3,4,25
1972,100148,"Ismail El Shafei",23,27,50,46
1972,100149,"Toshiro Sakai",11,9,20,55
1972,100152,"David Lloyd",4,9,13,30.76923076923077
1972,100156,"Jasjit Singh",3,3,6,50
1972,100158,"John Bartlett",2,7,9,22.22222222222222
1972,100159,"Vladimir Korotkov",4,4,8,50
1972,100160,"Georges Goven",15,22,37,40.54054054054054
1972,100161,"Jurgen Fassbender",9,10,19,47.36842105263158
1972,100162,"Brian Fairlie",13,28,41,31.70731707317073
1972,100163,"Tom Leonard",4,26,30,13.333333333333334
1972,100169,"Ian Fletcher",22,17,39,56.41025641025641
1972,100170,"Bernard Mignot",11,12,23,47.82608695652174
1972,100171,"John Yuill",1,1,2,50
1972,100173,"Andrew Pattison",45,23,68,66.17647058823529
1972,100174,"Manuel Orantes",69,20,89,77.52808988764045
1972,100175,"Zan Guerry",5,7,12,41.666666666666664
1972,100176,"Hans Kary",9,12,21,42.857142857142854
1972,100178,"Bob Giltinan",3,3,6,50
1972,100179,"Karl Meiler",13,5,18,72.22222222222223
1972,100180,"Bill Lloyd",1,8,9,11.11111111111111
1972,100182,"Mike Estep",5,10,15,33.333333333333336
1972,100185,"Patrick Proisy",35,22,57,61.40350877192982
1972,100186,"Jeff Borowiak",21,29,50,42
1972,100187,"Luis Felipe Tavares",1,1,2,50
1972,100191,"Doug Crawford",1,1,2,50
1972,100193,"Wanaro N'Godrella",10,14,24,41.666666666666664
1972,100196,"Haroon Rahim",30,34,64,46.875
1972,100199,"Patrice Dominguez",31,24,55,56.36363636363637
1972,100200,"Antonio Zugarelli",4,10,14,28.571428571428573
1972,100201,"Syd Ball",4,7,11,36.36363636363637
1972,100203,"Phil Dent",5,23,28,17.857142857142858
1972,100204,"Pancho Walthall",1,4,5,20
1972,100205,"Paul Gerken",14,12,26,53.84615384615385
1972,100206,"Kenichi Hirai",1,2,3,33.333333333333336
1972,100212,"Franklin Robbins",1,6,7,14.285714285714286
1972,100213,"Fred Hemmes",1,1,2,50
1972,100214,"Adriano Panatta",25,17,42,59.523809523809526
1972,100215,"Fred Mcnair",2,6,8,25
1972,100216,"Charles Owens",6,7,13,46.15384615384615
1972,100217,"Robert Mckinley",5,8,13,38.46153846153846
1972,100219,"Geoff Masters",18,18,36,50
1972,100220,"Jiri Hrebec",11,9,20,55
1972,100223,"Jeff Simpson",8,13,21,38.095238095238095
1972,100225,"Peter Doerner",1,5,6,16.666666666666668
1972,100226,"Mike Machette",3,4,7,42.857142857142854
1972,100227,"Alvin Gardiner",1,5,6,16.666666666666668
1972,100228,"Kjell Johansson",1,3,4,25
1972,100229,"Dick Stockton",27,21,48,56.25
1972,100231,"Erik Van Dillen",11,10,21,52.38095238095238
1972,100232,"Eddie Dibbs",5,9,14,35.714285714285715
1972,100233,"Ricardo Cano",1,3,4,25
1972,100234,"Allan McDonald",1,5,6,16.666666666666668
1972,100235,"Antonio Munoz",11,16,27,40.74074074074074
1972,100236,"John James",3,3,6,50
1972,100238,"Rick Fisher",3,5,8,37.5
1972,100239,"Hans Engert",2,2,4,50
1972,100244,"John Alexander",36,33,69,52.17391304347826
1972,100245,"Jeff Austin",3,10,13,23.076923076923077
1972,100249,"Paolo Bertolucci",7,6,13,53.84615384615385
1972,100251,"Grover Raz Reid",4,6,10,40
1972,100255,"Roscoe Tanner",29,14,43,67.44186046511628
1972,100257,"Ross Case",21,22,43,48.83720930232558
1972,100258,"Jorge Andrew",2,1,3,66.66666666666667
1972,100261,"Brian Gottfried",11,13,24,45.833333333333336
1972,100262,"Rolf Norberg",1,2,3,33.333333333333336
1972,100265,"Cliff Letcher",1,2,3,33.333333333333336
1972,100266,"John Feaver",1,3,4,25
1972,100270,"Anand Amritraj",7,12,19,36.8421052631579
1972,100271,"Jean Francois Caujolle",2,2,4,50
1972,100272,"Sandy Mayer",13,8,21,61.904761904761905
1972,100273,"Kim Warwick",8,9,17,47.05882352941177
1972,100278,"Frank Gebert",2,2,4,50
1972,100281,"Sashi Menon",5,6,11,45.45454545454545
1972,100282,"Guillermo Vilas",18,14,32,56.25
1972,100284,"Jimmy Connors",76,25,101,75.24752475247524
1972,100285,"Rod Frawley",2,3,5,40
1972,100286,"Harold Solomon",12,11,23,52.17391304347826
1972,100287,"Robin Drysdale",4,3,7,57.142857142857146
1972,100288,"Tenny Svensson",1,7,8,12.5
1972,100290,"Timothy Noonan",1,1,2,50
1972,100297,"Corrado Barazzutti",3,8,11,27.272727272727273
1972,100299,"James Chico Hagey",1,4,5,20
1972,100301,"Jim Delaney",1,5,6,16.666666666666668
1972,100304,"Robert Kreiss",2,6,8,25
1972,100309,"Raul Ramirez",8,9,17,47.05882352941177
1972,100317,"Stephen Warboys",3,9,12,25
1972,100321,"Vijay Amritraj",4,12,16,25
1972,100331,"Jean Louis Haillet",1,1,2,50
1972,100332,"Balazs Taroczy",4,3,7,57.142857142857146
1972,100338,"Benjy Robins",1,1,2,50
1972,100342,"Vitas Gerulaitis",4,5,9,44.44444444444444
1972,100372,"Trey Waltke",1,1,2,50
1972,100376,"Buster C Mottram",1,2,3,33.333333333333336
1972,100437,"Bjorn Borg",11,9,20,55
1972,106594,"Attila Korpas",3,5,8,37.5
1972,106629,"Birger Andersson",1,3,4,25
1972,106968,"Eugenio Castigliano",1,1,2,50
1972,106971,"Ezio Di Matteo",3,10,13,23.076923076923077
1972,107034,"Frank Falderbaum",1,1,2,50
1972,107062,"Gary Thoroughood",1,1,2,50
1972,107092,"Geza Varga",5,5,10,50
1972,107140,"Greg Perkins",2,1,3,66.66666666666667
1972,107217,"Ian Crookenden",3,3,6,50
1972,107264,"Jaidip Mukherjea",1,2,3,33.333333333333336
1972,107275,"Jan Hordijk",1,3,4,25
1972,107309,"Jean Loup Rouyer",7,10,17,41.1764705882353
1972,107311,"Jean Paul Meyer",1,7,8,12.5
1972,107334,"Jerry Van Linge",1,1,2,50
1972,107436,"Jose Guerrero",1,3,4,25
1972,107518,"Kiyoski Tanabe",2,2,4,50
1972,107591,"Luis Bruguera",1,4,5,20
1972,107728,"Massimo Di Domenico",1,1,2,50
1972,107780,"Michael Phillips",2,3,5,40
1972,107917,"Pancho Musalem",1,1,2,50
1972,107954,"Paul Van Min",1,1,2,50
1972,108017,"Pierre Joly",1,1,2,50
1972,108036,"Rafael Ruiz",2,1,3,66.66666666666667
1972,108118,"Robert Machan",2,3,5,40
1972,108342,"Tadeusz Nowicki",1,3,4,25
1972,108360,"Teimuraz Kakoulia",4,5,9,44.44444444444444
1972,108374,"Thierry Bernasconi",3,3,6,50
1972,108434,"Tony Parun P071",1,2,3,33.333333333333336
1972,108436,"Tony Richey",1,1,2,50
1972,109745,"Lew Hoad",7,9,16,43.75
1972,109771,"Jairo Velasco",6,10,16,37.5
1972,109810,"Dave Simmonds",1,1,2,50
1972,109812,"Jan Leschly",1,2,3,33.333333333333336
1972,109815,"Stanley Matthews",2,3,5,40
1972,109816,"E Victor Seixas",1,2,3,33.333333333333336
1972,109821,"Jorgen Ulrich",2,3,5,40
1972,109823,"Ron Holmberg",2,4,6,33.333333333333336
1972,109825,"Koji Watanabe",1,1,2,50
1972,109828,"Hector Romani",1,1,2,50
1972,109833,"Richard Russell",1,2,3,33.333333333333336
1972,109834,"Dan Birchmore",1,5,6,16.666666666666668
1972,109837,"John De Mendoza",4,5,9,44.44444444444444
1972,109838,"Henry Hank Irvine",1,3,4,25
1972,109856,"Edison Mandarino",5,2,7,71.42857142857143
1972,109884,"Mervyn Rose",1,5,6,16.666666666666668
1972,109891,"Hakar Zahr",1,2,3,33.333333333333336
1972,109893,"Don Mccormick",1,7,8,12.5
1972,109895,"Ken Binns",1,1,2,50
1972,109903,"Whitney Reed",1,2,3,33.333333333333336
1972,109907,"Henry Hank Kamakana",1,1,2,50
1972,109954,"John Stephens",1,1,2,50
1972,109988,"Dick Knight",1,3,4,25
1972,110017,"John McDonald",1,1,2,50
1972,110024,"Gondo Widjojo",1,1,2,50
1972,110058,"David Mitchell",1,1,2,50
1972,110091,"Ian Hewitt",3,1,4,75
1972,110108,"Frederick Ted Schroeder",1,2,3,33.333333333333336
1972,110185,"Michael Hickey",2,1,3,66.66666666666667
1972,110209,"Jackie Cooper",1,1,2,50
1972,110403,"Geoffery Newton",1,1,2,50
1972,110957,"Peter Jackson",1,1,2,50
1972,111006,"William Brown",2,3,5,40
1972,111033,"Kiyoshi Tanabe",2,3,5,40
1972,111107,"Teimuraz Kakulia",1,NA,NA,NA
1972,111138,"Dennis Matthews",1,1,2,50
1972,112312,"Frank Arthur Sedgman",4,2,6,66.66666666666667
1972,125586,"Kenneth Tsui",1,1,2,50
1972,199999,"U Unknown",1,3,4,25
1972,202581,"Wanaro Ngodrella",1,6,7,14.285714285714286
1972,202860,"Ron Bohrnstedt",1,1,2,50
1972,202879,"Max Cocks",2,1,3,66.66666666666667
1972,202880,"Jiri Zigmund",1,1,2,50
1972,208966,"Jim Corn",1,1,2,50
1972,209525,"Dennis Foley",1,1,2,50
1972,209592,"Ronan Fearon",1,1,2,50
1972,209706,"Paul Hearnden",1,1,2,50
1972,209732,"Alberto Riba",1,NA,NA,NA
1972,209792,"AJ Mitha",1,1,2,50
1972,209793,"Don O'Connell",1,1,2,50
1973,100004,"Giuseppe Merlo",1,1,2,50
1973,100005,"Richard Pancho Gonzales",6,5,11,54.54545454545455
1973,100009,"Istvan Gulyas",3,10,13,23.076923076923077
1973,100011,"Torben Ulrich",9,22,31,29.032258064516128
1973,100013,"Neale Fraser",1,3,4,25
1973,100016,"Ken Rosewall",70,17,87,80.45977011494253
1973,100017,"Mal Anderson",11,7,18,61.111111111111114
1973,100020,"Alejandro Olmedo",2,3,5,40
1973,100022,"Roy Emerson",35,18,53,66.0377358490566
1973,100023,"Ramanathan Krishnan",1,1,2,50
1973,100025,"Barry Phillips Moore",26,33,59,44.067796610169495
1973,100026,"Andres Gimeno",12,9,21,57.142857142857146
1973,100027,"Gene Scott",5,6,11,45.45454545454545
1973,100029,"Rod Laver",65,16,81,80.24691358024691
1973,100030,"Fred Stolle",23,16,39,58.97435897435897
1973,100032,"Patricio Rodriguez Chi",1,4,5,20
1973,100033,"Wilhelm Bungert",2,2,4,50
1973,100035,"Ion Tiriac",35,35,70,50
1973,100036,"Rudy Hernando",1,1,2,50
1973,100037,"Nikola Pilic",44,27,71,61.971830985915496
1973,100038,"Jaime Pinto Bravo",12,23,35,34.285714285714285
1973,100039,"Boro Jovanovic",9,15,24,37.5
1973,100040,"Bob Hewitt",2,5,7,28.571428571428573
1973,100045,"John Paish",10,16,26,38.46153846153846
1973,100047,"Bob Carmichael",24,37,61,39.34426229508197
1973,100049,"Jim Mcmanus",15,33,48,31.25
1973,100050,"Martin Mulligan",20,19,39,51.282051282051285
1973,100051,"Premjit Lall",3,13,16,18.75
1973,100054,"Jose Mandarino",4,14,18,22.22222222222222
1973,100055,"Cliff Drysdale",34,24,58,58.62068965517241
1973,100056,"Harald Elschenbroich",18,11,29,62.06896551724138
1973,100057,"Pierre Barthes",13,20,33,39.39393939393939
1973,100058,"Roger Taylor",47,22,69,68.1159420289855
1973,100060,"Marty Riessen",47,25,72,65.27777777777777
1973,100061,"Tom Edlefsen",10,25,35,28.571428571428573
1973,100062,"Francois Jauffret",18,13,31,58.064516129032256
1973,100063,"William Higgins",2,7,9,22.22222222222222
1973,100064,"Juan Gisbert",25,22,47,53.191489361702125
1973,100065,"Terry Ryan",2,9,11,18.181818181818183
1973,100066,"Frank Froehling",14,27,41,34.146341463414636
1973,100067,"Frew Mcmillan",25,38,63,39.682539682539684
1973,100068,"Herb Fitzgibbon",5,5,10,50
1973,100069,"Dennis Ralston",1,6,7,14.285714285714286
1973,100070,"Jan Kukal",2,13,15,13.333333333333334
1973,100073,"Mark Cox",56,28,84,66.66666666666667
1973,100074,"Arthur Ashe",69,29,98,70.40816326530613
1973,100075,"Owen Davidson",11,11,22,50
1973,100076,"Milan Holecek",21,30,51,41.1764705882353
1973,100078,"Clark Graebner",34,19,53,64.15094339622641
1973,100080,"Szabolcz Baranyi",17,19,36,47.22222222222222
1973,100081,"Charlie Pasarell",39,30,69,56.52173913043478
1973,100083,"Nicola Spear",5,13,18,27.77777777777778
1973,100084,"Tom Okker",91,23,114,79.82456140350877
1973,100085,"Hans Joachim Ploetz",3,5,8,37.5
1973,100086,"Frantisek Pala",7,17,24,29.166666666666668
1973,100087,"John Newcombe",63,19,82,76.82926829268293
1973,100088,"Patricio Cornejo",11,23,34,32.35294117647059
1973,100090,"Dick Crealy",27,32,59,45.76271186440678
1973,100091,"Colin Dibley",37,32,69,53.6231884057971
1973,100092,"Alex Metreveli",29,18,47,61.702127659574465
1973,100093,"William Brown",1,7,8,12.5
1973,100095,"Tony Bardsley",1,3,4,25
1973,100097,"Nicholas Kalogeropoulos",11,17,28,39.285714285714285
1973,100098,"Ove Nils Bengtson",22,27,49,44.89795918367347
1973,100099,"Thomaz Koch",1,2,3,33.333333333333336
1973,100100,"Tony Roche",3,4,7,42.857142857142854
1973,100101,"Mike Belkin",3,6,9,33.333333333333336
1973,100102,"Joaquin Loyo Mayo",1,18,19,5.2631578947368425
1973,100103,"Peter Curtis",2,2,4,50
1973,100104,"D Richard Russell",1,2,3,33.333333333333336
1973,100105,"Allan Stone",34,34,68,50
1973,100106,"Graham Stilwell",15,33,48,31.25
1973,100107,"Robert Rheinberger",1,4,5,20
1973,100109,"Jun Kuki",3,9,12,25
1973,100110,"Terry Addison",4,13,17,23.529411764705884
1973,100111,"Ray Keldie",6,6,12,50
1973,100113,"Jan Kodes",48,19,67,71.64179104477611
1973,100114,"Ray Ruffels",1,1,2,50
1973,100115,"Jaime Fillol",48,28,76,63.1578947368421
1973,100116,"Sherwood Stewart",19,18,37,51.351351351351354
1973,100117,"Butch Seewagen",7,14,21,33.333333333333336
1973,100118,"Ivan Molina",17,18,35,48.57142857142857
1973,100119,"Ilie Nastase",113,17,130,86.92307692307692
1973,100120,"Robert Maud",8,16,24,33.333333333333336
1973,100121,"Raymond Moore",36,36,72,50
1973,100122,"Julian Ganzabal",7,7,14,50
1973,100123,"Patrick Hombergen",5,7,12,41.666666666666664
1973,100125,"John Cooper",14,15,29,48.275862068965516
1973,100126,"Stan Smith",78,20,98,79.59183673469387
1973,100127,"Tom Gorman",49,28,77,63.63636363636363
1973,100128,"Cliff Richey",47,26,73,64.38356164383562
1973,100129,"Jean Baptiste Chanfreau",17,25,42,40.476190476190474
1973,100130,"Vladimir Zednik",14,23,37,37.83783783783784
1973,100133,"Pat Cramer",17,25,42,40.476190476190474
1973,100134,"Roy Barth",4,21,25,16
1973,100135,"Onny Parun",47,37,84,55.95238095238095
1973,100136,"Humphrey Hose",1,5,6,16.666666666666668
1973,100137,"Hans Jurgen Pohmann",29,13,42,69.04761904761905
1973,100139,"Gerald Battrick",30,37,67,44.776119402985074
1973,100140,"Steve Faulk",4,17,21,19.047619047619047
1973,100141,"Zeljko Franulovic",19,20,39,48.717948717948715
1973,100142,"Peter Szoke",15,19,34,44.11764705882353
1973,100144,"Robert Lutz",17,16,33,51.515151515151516
1973,100145,"Dick Dell",7,15,22,31.818181818181817
1973,100146,"Jun Kamiwazumi",10,17,27,37.03703703703704
1973,100147,"Marcello Lara",16,21,37,43.24324324324324
1973,100148,"Ismail El Shafei",11,24,35,31.428571428571427
1973,100149,"Toshiro Sakai",13,14,27,48.148148148148145
1973,100150,"Lito Alvarez",1,5,6,16.666666666666668
1973,100152,"David Lloyd",5,8,13,38.46153846153846
1973,100154,"Peter Kanderal",2,2,4,50
1973,100156,"Jasjit Singh",10,18,28,35.714285714285715
1973,100158,"John Bartlett",10,20,30,33.333333333333336
1973,100159,"Vladimir Korotkov",5,2,7,71.42857142857143
1973,100160,"Georges Goven",27,28,55,49.09090909090909
1973,100161,"Jurgen Fassbender",46,25,71,64.78873239436619
1973,100162,"Brian Fairlie",33,21,54,61.111111111111114
1973,100163,"Tom Leonard",4,17,21,19.047619047619047
1973,100167,"Sever Muresan",1,2,3,33.333333333333336
1973,100169,"Ian Fletcher",34,35,69,49.27536231884058
1973,100170,"Bernard Mignot",11,9,20,55
1973,100171,"John Yuill",6,3,9,66.66666666666667
1973,100172,"Modesto Tito Vazquez",2,5,7,28.571428571428573
1973,100173,"Andrew Pattison",29,30,59,49.152542372881356
1973,100174,"Manuel Orantes",68,23,91,74.72527472527473
1973,100175,"Zan Guerry",3,5,8,37.5
1973,100176,"Hans Kary",15,23,38,39.473684210526315
1973,100178,"Bob Giltinan",14,12,26,53.84615384615385
1973,100179,"Karl Meiler",44,27,71,61.971830985915496
1973,100180,"Bill Lloyd",6,14,20,30
1973,100182,"Mike Estep",26,30,56,46.42857142857143
1973,100185,"Patrick Proisy",32,22,54,59.25925925925926
1973,100186,"Jeff Borowiak",23,34,57,40.35087719298246
1973,100190,"Norman Holmes",2,3,5,40
1973,100193,"Wanaro N'Godrella",15,20,35,42.857142857142854
1973,100195,"Nicolas Kelaidis",1,5,6,16.666666666666668
1973,100196,"Haroon Rahim",20,34,54,37.03703703703704
1973,100199,"Patrice Dominguez",26,24,50,52
1973,100200,"Antonio Zugarelli",13,17,30,43.333333333333336
1973,100201,"Syd Ball",10,11,21,47.61904761904762
1973,100203,"Phil Dent",38,31,69,55.072463768115945
1973,100204,"Pancho Walthall",2,2,4,50
1973,100205,"Paul Gerken",48,33,81,59.25925925925926
1973,100206,"Kenichi Hirai",2,6,8,25
1973,100208,"Dick R Bohrnstedt",8,8,16,50
1973,100214,"Adriano Panatta",46,18,64,71.875
1973,100215,"Fred Mcnair",8,15,23,34.78260869565217
1973,100216,"Charles Owens",11,13,24,45.833333333333336
1973,100217,"Robert Mckinley",6,11,17,35.294117647058826
1973,100219,"Geoff Masters",29,24,53,54.716981132075475
1973,100220,"Jiri Hrebec",24,21,45,53.333333333333336
1973,100223,"Jeff Simpson",15,18,33,45.45454545454545
1973,100226,"Mike Machette",3,3,6,50
1973,100228,"Kjell Johansson",19,18,37,51.351351351351354
1973,100229,"Dick Stockton",38,24,62,61.29032258064516
1973,100231,"Erik Van Dillen",24,20,44,54.54545454545455
1973,100232,"Eddie Dibbs",37,17,54,68.51851851851852
1973,100233,"Ricardo Cano",1,1,2,50
1973,100234,"Allan McDonald",2,5,7,28.571428571428573
1973,100235,"Antonio Munoz",12,23,35,34.285714285714285
1973,100238,"Rick Fisher",4,4,8,50
1973,100239,"Hans Engert",1,5,6,16.666666666666668
1973,100243,"Steve Krulevitz",1,4,5,20
1973,100244,"John Alexander",46,30,76,60.526315789473685
1973,100245,"Jeff Austin",15,11,26,57.69230769230769
1973,100249,"Paolo Bertolucci",30,19,49,61.224489795918366
1973,100251,"Grover Raz Reid",4,9,13,30.76923076923077
1973,100255,"Roscoe Tanner",43,28,71,60.563380281690144
1973,100257,"Ross Case",39,34,73,53.42465753424658
1973,100261,"Brian Gottfried",54,34,88,61.36363636363637
1973,100262,"Rolf Norberg",1,6,7,14.285714285714286
1973,100265,"Cliff Letcher",3,3,6,50
1973,100266,"John Feaver",13,15,28,46.42857142857143
1973,100270,"Anand Amritraj",11,18,29,37.93103448275862
1973,100271,"Jean Francois Caujolle",2,7,9,22.22222222222222
1973,100272,"Sandy Mayer",24,12,36,66.66666666666667
1973,100273,"Kim Warwick",13,23,36,36.111111111111114
1973,100274,"Eric Deblicker",2,4,6,33.333333333333336
1973,100275,"Hartmut Kirchhubel",3,1,4,75
1973,100276,"Terry Moor",1,2,3,33.333333333333336
1973,100277,"Jacques Thamin",5,6,11,45.45454545454545
1973,100278,"Frank Gebert",6,6,12,50
1973,100282,"Guillermo Vilas",24,14,38,63.1578947368421
1973,100284,"Jimmy Connors",82,15,97,84.5360824742268
1973,100286,"Harold Solomon",17,22,39,43.58974358974359
1973,100288,"Tenny Svensson",6,7,13,46.15384615384615
1973,100289,"Byron Bertram",6,8,14,42.857142857142854
1973,100297,"Corrado Barazzutti",11,16,27,40.74074074074074
1973,100298,"George Hardie",1,3,4,25
1973,100299,"James Chico Hagey",1,4,5,20
1973,100300,"Jose Higueras",6,2,8,75
1973,100301,"Jim Delaney",4,5,9,44.44444444444444
1973,100304,"Robert Kreiss",3,6,9,33.333333333333336
1973,100305,"Mark Farrell",1,3,4,25
1973,100309,"Raul Ramirez",32,19,51,62.745098039215684
1973,100312,"Chiraid Mukherjea",3,3,6,50
1973,100317,"Stephen Warboys",3,10,13,23.076923076923077
1973,100321,"Vijay Amritraj",33,15,48,68.75
1973,100324,"John Whitlinger",1,1,2,50
1973,100325,"Ulrich Pinner",4,3,7,57.142857142857146
1973,100326,"Russell Simpson",4,4,8,50
1973,100331,"Jean Louis Haillet",4,9,13,30.76923076923077
1973,100332,"Balazs Taroczy",3,5,8,37.5
1973,100334,"Ernie Ewert",3,2,5,60
1973,100339,"Victor Amaya",2,5,7,28.571428571428573
1973,100342,"Vitas Gerulaitis",7,10,17,41.1764705882353
1973,100343,"John Lloyd",11,16,27,40.74074074074074
1973,100345,"Pat Dupre",2,7,9,22.22222222222222
1973,100346,"Paul Kronk",7,13,20,35
1973,100354,"Bernard Mitton",7,3,10,70
1973,100359,"Richard Lewis",2,2,4,50
1973,100360,"Brian Teacher",6,6,12,50
1973,100361,"Willie Davies",1,1,2,50
1973,100362,"Peter Fleming",1,1,2,50
1973,100364,"Jonathan Smith",2,1,3,66.66666666666667
1973,100367,"Belus Prajoux",1,2,3,33.333333333333336
1973,100376,"Buster C Mottram",14,11,25,56
1973,100377,"Colin Dowdeswell",4,4,8,50
1973,100382,"Chris Kachel",1,1,2,50
1973,100414,"Gunther Gnettner",1,1,2,50
1973,100422,"Bruce Manson",1,1,2,50
1973,100437,"Bjorn Borg",43,24,67,64.17910447761194
1973,100461,"Billy Martin",2,6,8,25
1973,100492,"John Austin",1,1,2,50
1973,100545,"Deon Joubert",2,2,4,50
1973,101014,"John Ross",1,1,2,50
1973,101334,"Alexander Volkov",1,1,2,50
1973,106542,"Andrew Rae",1,2,3,33.333333333333336
1973,106594,"Attila Korpas",10,11,21,47.61904761904762
1973,106616,"Bernard Montrenaud",1,6,7,14.285714285714286
1973,106619,"Bertalan Csoknyai",1,1,2,50
1973,106629,"Birger Andersson",2,6,8,25
1973,106631,"Bo Holmstrom",1,1,2,50
1973,106923,"Eduardo Mandarino",3,2,5,60
1973,106968,"Eugenio Castigliano",1,1,2,50
1973,106971,"Ezio Di Matteo",4,6,10,40
1973,106996,"Felix Ponte",1,8,9,11.11111111111111
1973,107034,"Frank Falderbaum",1,1,2,50
1973,107123,"Graeme Thomson",1,3,4,25
1973,107140,"Greg Perkins",2,2,4,50
1973,107217,"Ian Crookenden",1,5,6,16.666666666666668
1973,107264,"Jaidip Mukherjea",3,2,5,60
1973,107275,"Jan Hordijk",1,2,3,33.333333333333336
1973,107277,"Jan Pisecky",3,1,4,75
1973,107279,"Jan Simbera",1,1,2,50
1973,107284,"Janos Benyik",1,2,3,33.333333333333336
1973,107309,"Jean Loup Rouyer",4,5,9,44.44444444444444
1973,107425,"Jose Moreno",1,3,4,25
1973,107429,"Jose Castanon",1,3,4,25
1973,107453,"Juan Couder",1,1,2,50
1973,107456,"Juan Herrera",2,5,7,28.571428571428573
1973,107488,"Keith Hancock",1,1,2,50
1973,107518,"Kiyoski Tanabe",1,4,5,20
1973,107561,"Leif Johansson",5,3,8,62.5
1973,107760,"Max Senior",1,1,2,50
1973,107780,"Michael Phillips",2,2,4,50
1973,107825,"Mohammad Hossein Akbari",1,1,2,50
1973,107830,"Munawar Iqbal",1,3,4,25
1973,107892,"Olle Palmer",1,1,2,50
1973,107917,"Pancho Musalem",1,2,3,33.333333333333336
1973,108012,"Piero Toci",4,6,10,40
1973,108021,"Pietro Marzano",2,3,5,40
1973,108118,"Robert Machan",9,13,22,40.90909090909091
1973,108131,"Roberto Chavez",1,2,3,33.333333333333336
1973,108184,"Ruby Hoskowetz",1,1,2,50
1973,108249,"Shamil Tarpischev",2,2,4,50
1973,108304,"Stephen Myers",1,2,3,33.333333333333336
1973,108342,"Tadeusz Nowicki",7,5,12,58.333333333333336
1973,108350,"Takeshi Koura",1,1,2,50
1973,108360,"Teimuraz Kakoulia",2,3,5,40
1973,108374,"Thierry Bernasconi",2,3,5,40
1973,108387,"Thomas Furst",1,1,2,50
1973,108407,"Tom Christensen",1,1,2,50
1973,108421,"Toma Ovici",3,4,7,42.857142857142854
1973,108434,"Tony Parun P071",2,4,6,33.333333333333336
1973,108477,"Vincenzo Franchitti",4,9,13,30.76923076923077
1973,108519,"William Coghlan",1,1,2,50
1973,108525,"William Durham",2,3,5,40
1973,109771,"Jairo Velasco",1,3,4,25
1973,109792,"Vittorio Crotta",1,2,3,33.333333333333336
1973,109796,"Tito Vasquez",2,10,12,16.666666666666668
1973,109833,"Richard Russell",2,5,7,28.571428571428573
1973,109841,"Alex Mayer",6,1,7,85.71428571428571
1973,109845,"C Munoz",4,3,7,57.142857142857146
1973,109856,"Edison Mandarino",2,3,5,40
1973,109881,"Atet Wijono",1,1,2,50
1973,109890,"A Macdonald",1,1,2,50
1973,109892,"Kenneth Andersson",1,2,3,33.333333333333336
1973,109912,"Ricky Buwalda",2,2,4,50
1973,109944,"Greg Cooper",3,2,5,60
1973,109954,"John Stephens",1,1,2,50
1973,109985,"Tico Carrero",1,1,2,50
1973,110024,"Gondo Widjojo",2,1,3,66.66666666666667
1973,110039,"Sutarjo Sugiarto",1,1,2,50
1973,110048,"Clay Iles",1,1,2,50
1973,110148,"Mark Lyndon",1,1,2,50
1973,110159,"Gaurav Misra",1,2,3,33.333333333333336
1973,110166,"Chiradip Mukerjea",1,1,2,50
1973,110199,"Kevin Menton",1,1,2,50
1973,110215,"Diko Murdono",1,1,2,50
1973,110248,"Harry Turnbull",1,2,3,33.333333333333336
1973,110249,"Karl Fichtel",1,1,2,50
1973,110421,"Pato Rodriquez",2,1,3,66.66666666666667
1973,110957,"Peter Jackson",1,1,2,50
1973,110983,"Hadiman Hadiman",1,1,2,50
1973,110987,"Saeed Meer",1,3,4,25
1973,110991,"Jaidip Mukerjea",2,3,5,40
1973,111006,"William Brown",2,6,8,25
1973,111033,"Kiyoshi Tanabe",1,3,4,25
1973,111107,"Teimuraz Kakulia",1,1,2,50
1973,111135,"Greg Perkins",1,2,3,33.333333333333336
1973,111136,"Terry Ryan",5,4,9,55.55555555555556
1973,199999,"U Unknown",1,21,22,4.545454545454546
1973,202541,"John Andrews",2,2,4,50
1973,202581,"Wanaro Ngodrella",4,3,7,57.142857142857146
1973,209750,"Reinhard Mattern",2,1,3,66.66666666666667
1973,209760,"Erwin Jager",2,1,3,66.66666666666667
1973,209801,"Chris Walsh",1,1,2,50
1974,100011,"Torben Ulrich",3,13,16,18.75
1974,100013,"Neale Fraser",3,5,8,37.5
1974,100016,"Ken Rosewall",28,8,36,77.77777777777777
1974,100017,"Mal Anderson",2,5,7,28.571428571428573
1974,100022,"Roy Emerson",7,5,12,58.333333333333336
1974,100024,"Jan Eric Lundquist",5,6,11,45.45454545454545
1974,100025,"Barry Phillips Moore",32,38,70,45.714285714285715
1974,100026,"Andres Gimeno",1,1,2,50
1974,100027,"Gene Scott",2,4,6,33.333333333333336
1974,100028,"Manuel Santana",2,3,5,40
1974,100029,"Rod Laver",50,9,59,84.7457627118644
1974,100030,"Fred Stolle",6,8,14,42.857142857142854
1974,100031,"Dimitri Sturdza",1,2,3,33.333333333333336
1974,100032,"Patricio Rodriguez Chi",1,6,7,14.285714285714286
1974,100034,"Christian Kuhnke",2,10,12,16.666666666666668
1974,100035,"Ion Tiriac",10,16,26,38.46153846153846
1974,100037,"Nikola Pilic",22,12,34,64.70588235294117
1974,100038,"Jaime Pinto Bravo",8,27,35,22.857142857142858
1974,100039,"Boro Jovanovic",4,15,19,21.05263157894737
1974,100040,"Bob Hewitt",13,17,30,43.333333333333336
1974,100045,"John Paish",1,7,8,12.5
1974,100047,"Bob Carmichael",12,22,34,35.294117647058826
1974,100049,"Jim Mcmanus",4,22,26,15.384615384615385
1974,100050,"Martin Mulligan",1,3,4,25
1974,100051,"Premjit Lall",2,6,8,25
1974,100054,"Jose Mandarino",2,5,7,28.571428571428573
1974,100055,"Cliff Drysdale",27,14,41,65.85365853658537
1974,100056,"Harald Elschenbroich",5,20,25,20
1974,100057,"Pierre Barthes",8,13,21,38.095238095238095
1974,100058,"Roger Taylor",24,19,43,55.81395348837209
1974,100059,"Isao Watanabe",2,3,5,40
1974,100060,"Marty Riessen",55,24,79,69.62025316455696
1974,100061,"Tom Edlefsen",6,18,24,25
1974,100062,"Francois Jauffret",25,15,40,62.5
1974,100063,"William Higgins",2,3,5,40
1974,100064,"Juan Gisbert",37,26,63,58.73015873015873
1974,100066,"Frank Froehling",2,8,10,20
1974,100067,"Frew Mcmillan",20,18,38,52.63157894736842
1974,100069,"Dennis Ralston",3,5,8,37.5
1974,100071,"Jean Claude Barclay",1,3,4,25
1974,100072,"Bailey Brown",2,2,4,50
1974,100073,"Mark Cox",25,18,43,58.13953488372093
1974,100074,"Arthur Ashe",84,28,112,75
1974,100075,"Owen Davidson",5,13,18,27.77777777777778
1974,100076,"Milan Holecek",18,29,47,38.297872340425535
1974,100078,"Clark Graebner",11,14,25,44
1974,100079,"Bill Bowrey",3,3,6,50
1974,100080,"Szabolcz Baranyi",2,4,6,33.333333333333336
1974,100081,"Charlie Pasarell",23,26,49,46.93877551020408
1974,100082,"Roger Dowdeswell",7,18,25,28
1974,100083,"Nicola Spear",3,15,18,16.666666666666668
1974,100084,"Tom Okker",65,19,84,77.38095238095238
1974,100085,"Hans Joachim Ploetz",5,9,14,35.714285714285715
1974,100086,"Frantisek Pala",4,15,19,21.05263157894737
1974,100087,"John Newcombe",90,17,107,84.11214953271028
1974,100088,"Patricio Cornejo",19,32,51,37.254901960784316
1974,100089,"Patrice Beust",2,4,6,33.333333333333336
1974,100090,"Dick Crealy",41,40,81,50.617283950617285
1974,100091,"Colin Dibley",33,34,67,49.25373134328358
1974,100092,"Alex Metreveli",53,19,72,73.61111111111111
1974,100093,"William Brown",8,17,25,32
1974,100094,"Jim Osborne",3,2,5,60
1974,100097,"Nicholas Kalogeropoulos",1,11,12,8.333333333333334
1974,100098,"Ove Nils Bengtson",14,22,36,38.888888888888886
1974,100099,"Thomaz Koch",22,12,34,64.70588235294117
1974,100100,"Tony Roche",33,16,49,67.34693877551021
1974,100102,"Joaquin Loyo Mayo",10,17,27,37.03703703703704
1974,100104,"D Richard Russell",1,1,2,50
1974,100105,"Allan Stone",21,20,41,51.21951219512195
1974,100106,"Graham Stilwell",4,16,20,20
1974,100107,"Robert Rheinberger",3,8,11,27.272727272727273
1974,100109,"Jun Kuki",10,16,26,38.46153846153846
1974,100110,"Terry Addison",1,1,2,50
1974,100111,"Ray Keldie",8,17,25,32
1974,100112,"John Clifton",2,2,4,50
1974,100113,"Jan Kodes",45,24,69,65.21739130434783
1974,100114,"Ray Ruffels",17,18,35,48.57142857142857
1974,100115,"Jaime Fillol",48,32,80,60
1974,100116,"Sherwood Stewart",29,32,61,47.540983606557376
1974,100117,"Butch Seewagen",1,4,5,20
1974,100118,"Ivan Molina",20,30,50,40
1974,100119,"Ilie Nastase",78,21,99,78.78787878787878
1974,100120,"Robert Maud",12,13,25,48
1974,100121,"Raymond Moore",18,21,39,46.15384615384615
1974,100122,"Julian Ganzabal",14,13,27,51.851851851851855
1974,100124,"Steve Turner",2,4,6,33.333333333333336
1974,100126,"Stan Smith",64,22,86,74.4186046511628
1974,100127,"Tom Gorman",48,25,73,65.75342465753425
1974,100128,"Cliff Richey",25,16,41,60.97560975609756
1974,100129,"Jean Baptiste Chanfreau",4,16,20,20
1974,100130,"Vladimir Zednik",12,20,32,37.5
1974,100132,"Armistead Neely",3,9,12,25
1974,100133,"Pat Cramer",3,15,18,16.666666666666668
1974,100134,"Roy Barth",4,13,17,23.529411764705884
1974,100135,"Onny Parun",82,39,121,67.76859504132231
1974,100136,"Humphrey Hose",4,7,11,36.36363636363637
1974,100137,"Hans Jurgen Pohmann",29,27,56,51.785714285714285
1974,100139,"Gerald Battrick",12,17,29,41.37931034482759
1974,100140,"Steve Faulk",3,8,11,27.272727272727273
1974,100141,"Zeljko Franulovic",15,20,35,42.857142857142854
1974,100142,"Peter Szoke",2,6,8,25
1974,100144,"Robert Lutz",22,22,44,50
1974,100145,"Dick Dell",15,27,42,35.714285714285715
1974,100146,"Jun Kamiwazumi",16,23,39,41.02564102564103
1974,100147,"Marcello Lara",13,17,30,43.333333333333336
1974,100148,"Ismail El Shafei",36,28,64,56.25
1974,100149,"Toshiro Sakai",4,5,9,44.44444444444444
1974,100150,"Lito Alvarez",2,5,7,28.571428571428573
1974,100151,"Karl Coombes",2,8,10,20
1974,100154,"Peter Kanderal",3,6,9,33.333333333333336
1974,100155,"Ramiro Benavides",2,6,8,25
1974,100156,"Jasjit Singh",3,12,15,20
1974,100158,"John Bartlett",1,5,6,16.666666666666668
1974,100160,"Georges Goven",17,23,40,42.5
1974,100161,"Jurgen Fassbender",41,30,71,57.74647887323944
1974,100162,"Brian Fairlie",12,13,25,48
1974,100163,"Tom Leonard",6,16,22,27.272727272727273
1974,100169,"Ian Fletcher",20,22,42,47.61904761904762
1974,100170,"Bernard Mignot",4,2,6,66.66666666666667
1974,100171,"John Yuill",23,14,37,62.16216216216216
1974,100172,"Modesto Tito Vazquez",5,11,16,31.25
1974,100173,"Andrew Pattison",31,17,48,64.58333333333333
1974,100174,"Manuel Orantes",65,30,95,68.42105263157895
1974,100175,"Zan Guerry",1,1,2,50
1974,100176,"Hans Kary",18,22,40,45
1974,100178,"Bob Giltinan",20,18,38,52.63157894736842
1974,100179,"Karl Meiler",42,26,68,61.76470588235294
1974,100181,"Larry Turville",3,4,7,42.857142857142854
1974,100182,"Mike Estep",16,26,42,38.095238095238095
1974,100184,"Lars Elvstrom",1,7,8,12.5
1974,100185,"Patrick Proisy",13,19,32,40.625
1974,100186,"Jeff Borowiak",34,27,61,55.73770491803279
1974,100187,"Luis Felipe Tavares",1,4,5,20
1974,100188,"John Fort",1,7,8,12.5
1974,100190,"Norman Holmes",1,7,8,12.5
1974,100191,"Doug Crawford",1,11,12,8.333333333333334
1974,100193,"Wanaro N'Godrella",3,7,10,30
1974,100194,"Larry Parker",1,2,3,33.333333333333336
1974,100196,"Haroon Rahim",9,21,30,30
1974,100199,"Patrice Dominguez",18,21,39,46.15384615384615
1974,100200,"Antonio Zugarelli",15,22,37,40.54054054054054
1974,100201,"Syd Ball",31,34,65,47.69230769230769
1974,100202,"George Amaya",2,1,3,66.66666666666667
1974,100203,"Phil Dent",30,21,51,58.8235294117647
1974,100204,"Pancho Walthall",2,1,3,66.66666666666667
1974,100205,"Paul Gerken",24,30,54,44.44444444444444
1974,100206,"Kenichi Hirai",2,4,6,33.333333333333336
1974,100208,"Dick R Bohrnstedt",8,11,19,42.10526315789474
1974,100210,"Steve Docherty",1,3,4,25
1974,100211,"Louk Sanders",2,2,4,50
1974,100214,"Adriano Panatta",31,17,48,64.58333333333333
1974,100215,"Fred Mcnair",18,24,42,42.857142857142854
1974,100216,"Charles Owens",18,13,31,58.064516129032256
1974,100219,"Geoff Masters",28,23,51,54.90196078431372
1974,100220,"Jiri Hrebec",24,19,43,55.81395348837209
1974,100221,"Carlos Kirmayr",1,3,4,25
1974,100222,"Mike Powers",1,2,3,33.333333333333336
1974,100223,"Jeff Simpson",11,29,40,27.5
1974,100225,"Peter Doerner",2,5,7,28.571428571428573
1974,100226,"Mike Machette",4,8,12,33.333333333333336
1974,100228,"Kjell Johansson",7,17,24,29.166666666666668
1974,100229,"Dick Stockton",47,20,67,70.14925373134328
1974,100231,"Erik Van Dillen",24,31,55,43.63636363636363
1974,100232,"Eddie Dibbs",59,29,88,67.04545454545455
1974,100233,"Ricardo Cano",2,2,4,50
1974,100235,"Antonio Munoz",9,22,31,29.032258064516128
1974,100236,"John James",2,3,5,40
1974,100238,"Rick Fisher",6,13,19,31.57894736842105
1974,100242,"Mike Collins",5,3,8,62.5
1974,100243,"Steve Krulevitz",14,22,36,38.888888888888886
1974,100244,"John Alexander",38,24,62,61.29032258064516
1974,100245,"Jeff Austin",13,18,31,41.935483870967744
1974,100247,"Rolf Thung",4,7,11,36.36363636363637
1974,100249,"Paolo Bertolucci",14,6,20,70
1974,100251,"Grover Raz Reid",17,25,42,40.476190476190474
1974,100255,"Roscoe Tanner",67,29,96,69.79166666666667
1974,100257,"Ross Case",43,28,71,60.563380281690144
1974,100258,"Jorge Andrew",1,6,7,14.285714285714286
1974,100261,"Brian Gottfried",53,31,84,63.095238095238095
1974,100262,"Rolf Norberg",1,3,4,25
1974,100263,"John Andrews",2,6,8,25
1974,100265,"Cliff Letcher",8,6,14,57.142857142857146
1974,100266,"John Feaver",5,24,29,17.24137931034483
1974,100267,"Rayno Seegers",5,8,13,38.46153846153846
1974,100268,"Denis Naegelen",1,2,3,33.333333333333336
1974,100270,"Anand Amritraj",11,24,35,31.428571428571427
1974,100271,"Jean Francois Caujolle",2,9,11,18.181818181818183
1974,100272,"Sandy Mayer",25,9,34,73.52941176470588
1974,100273,"Kim Warwick",30,23,53,56.60377358490566
1974,100274,"Eric Deblicker",2,4,6,33.333333333333336
1974,100277,"Jacques Thamin",2,6,8,25
1974,100278,"Frank Gebert",2,5,7,28.571428571428573
1974,100279,"Mike Cahill",4,4,8,50
1974,100280,"Wojtek Fibak",9,9,18,50
1974,100281,"Sashi Menon",1,7,8,12.5
1974,100282,"Guillermo Vilas",90,23,113,79.64601769911505
1974,100284,"Jimmy Connors",95,6,101,94.05940594059406
1974,100286,"Harold Solomon",60,36,96,62.5
1974,100288,"Tenny Svensson",3,13,16,18.75
1974,100289,"Byron Bertram",15,13,28,53.57142857142857
1974,100293,"John Marks",1,3,4,25
1974,100297,"Corrado Barazzutti",14,7,21,66.66666666666667
1974,100298,"George Hardie",3,10,13,23.076923076923077
1974,100299,"James Chico Hagey",2,5,7,28.571428571428573
1974,100300,"Jose Higueras",12,12,24,50
1974,100301,"Jim Delaney",9,7,16,56.25
1974,100303,"Henry Bunis",3,3,6,50
1974,100304,"Robert Kreiss",10,18,28,35.714285714285715
1974,100305,"Mark Farrell",9,16,25,36
1974,100309,"Raul Ramirez",69,35,104,66.34615384615384
1974,100317,"Stephen Warboys",5,6,11,45.45454545454545
1974,100321,"Vijay Amritraj",42,28,70,60
1974,100324,"John Whitlinger",11,9,20,55
1974,100325,"Ulrich Pinner",14,13,27,51.851851851851855
1974,100326,"Russell Simpson",2,3,5,40
1974,100331,"Jean Louis Haillet",2,8,10,20
1974,100332,"Balazs Taroczy",21,12,33,63.63636363636363
1974,100334,"Ernie Ewert",6,6,12,50
1974,100337,"Mark Edmondson",1,2,3,33.333333333333336
1974,100339,"Victor Amaya",4,6,10,40
1974,100342,"Vitas Gerulaitis",33,19,52,63.46153846153846
1974,100343,"John Lloyd",19,22,41,46.34146341463415
1974,100345,"Pat Dupre",1,6,7,14.285714285714286
1974,100346,"Paul Kronk",18,29,47,38.297872340425535
1974,100354,"Bernard Mitton",3,4,7,42.857142857142854
1974,100359,"Richard Lewis",4,7,11,36.36363636363637
1974,100360,"Brian Teacher",9,7,16,56.25
1974,100367,"Belus Prajoux",9,20,29,31.03448275862069
1974,100372,"Trey Waltke",2,5,7,28.571428571428573
1974,100376,"Buster C Mottram",14,13,27,51.851851851851855
1974,100377,"Colin Dowdeswell",6,4,10,60
1974,100382,"Chris Kachel",2,6,8,25
1974,100395,"Victor Pecci",2,4,6,33.333333333333336
1974,100396,"Martin Robinson",1,3,4,25
1974,100403,"Rolf Gehring",2,4,6,33.333333333333336
1974,100413,"Ulrich Marten",4,5,9,44.44444444444444
1974,100422,"Bruce Manson",1,2,3,33.333333333333336
1974,100430,"David Carter",1,1,2,50
1974,100436,"Nick Saviano",1,3,4,25
1974,100437,"Bjorn Borg",96,24,120,80
1974,100456,"Ferdi Taygan",4,2,6,66.66666666666667
1974,100461,"Billy Martin",18,14,32,56.25
1974,100474,"Chris Lewis",1,2,3,33.333333333333336
1974,100492,"John Austin",3,4,7,42.857142857142854
1974,100545,"Deon Joubert",2,1,3,66.66666666666667
1974,100859,"Robert Casey C100",1,4,5,20
1974,100957,"Greg Holmes",1,1,2,50
1974,106452,"Akifumi Machidori",2,1,3,66.66666666666667
1974,106594,"Attila Korpas",5,6,11,45.45454545454545
1974,106629,"Birger Andersson",2,4,6,33.333333333333336
1974,106867,"Derek Schroder",1,2,3,33.333333333333336
1974,106899,"Douglas Palm",2,4,6,33.333333333333336
1974,106923,"Eduardo Mandarino",1,2,3,33.333333333333336
1974,106971,"Ezio Di Matteo",1,4,5,20
1974,107092,"Geza Varga",1,2,3,33.333333333333336
1974,107123,"Graeme Thomson",3,4,7,42.857142857142854
1974,107217,"Ian Crookenden",12,9,21,57.142857142857146
1974,107233,"Ingo Wimmer",2,1,3,66.66666666666667
1974,107235,"Ionel Santeiu",3,11,14,21.428571428571427
1974,107275,"Jan Hordijk",1,4,5,20
1974,107277,"Jan Pisecky",3,7,10,30
1974,107279,"Jan Simbera",1,1,2,50
1974,107284,"Janos Benyik",2,3,5,40
1974,107302,"Jay Royappa",1,2,3,33.333333333333336
1974,107309,"Jean Loup Rouyer",2,1,3,66.66666666666667
1974,107311,"Jean Paul Meyer",2,4,6,33.333333333333336
1974,107398,"John Trickey",1,3,4,25
1974,107425,"Jose Moreno",1,7,8,12.5
1974,107429,"Jose Castanon",1,2,3,33.333333333333336
1974,107456,"Juan Herrera",1,1,2,50
1974,107488,"Keith Hancock",5,7,12,41.666666666666664
1974,107518,"Kiyoski Tanabe",1,1,2,50
1974,107561,"Leif Johansson",6,8,14,42.857142857142854
1974,107761,"Max Wunschig",1,2,3,33.333333333333336
1974,107823,"Mitsuru Motoi",2,1,3,66.66666666666667
1974,107968,"Per Hegna",1,1,2,50
1974,108118,"Robert Machan",1,5,6,16.666666666666668
1974,108192,"Sachio Kato",2,1,3,66.66666666666667
1974,108198,"Salvador Cabeza",1,1,2,50
1974,108254,"Shinya Tanaka",1,1,2,50
1974,108304,"Stephen Myers",1,1,2,50
1974,108342,"Tadeusz Nowicki",3,6,9,33.333333333333336
1974,108360,"Teimuraz Kakoulia",3,3,6,50
1974,108374,"Thierry Bernasconi",1,3,4,25
1974,108415,"Tom Kreiss",2,1,3,66.66666666666667
1974,108421,"Toma Ovici",8,10,18,44.44444444444444
1974,108434,"Tony Parun P071",1,6,7,14.285714285714286
1974,108446,"Trevor Little",1,3,4,25
1974,108477,"Vincenzo Franchitti",3,6,9,33.333333333333336
1974,108525,"William Durham",3,6,9,33.333333333333336
1974,108567,"Yuji Tezuka",3,3,6,50
1974,109771,"Jairo Velasco",19,22,41,46.34146341463415
1974,109775,"Robert Wilson",3,1,4,75
1974,109796,"Tito Vasquez",2,4,6,33.333333333333336
1974,109841,"Alex Mayer",4,1,5,80
1974,109856,"Edison Mandarino",3,3,6,50
1974,109860,"Ryan Moore2",1,1,2,50
1974,109893,"Don Mccormick",1,1,2,50
1974,109921,"Eugenio Munoz",3,1,4,75
1974,109950,"Francois Van Der Merwe",3,2,5,60
1974,109951,"Moon Il Kim",2,1,3,66.66666666666667
1974,110020,"Jean Lovera",1,1,2,50
1974,110024,"Gondo Widjojo",1,1,2,50
1974,110102,"Phil Siviter",1,2,3,33.333333333333336
1974,110106,"John Eastburn",1,3,4,25
1974,110163,"Reginald Bennett",1,1,2,50
1974,110164,"Max Franklin",2,1,3,66.66666666666667
1974,110165,"Ruben Porges",2,1,3,66.66666666666667
1974,110166,"Chiradip Mukerjea",1,2,3,33.333333333333336
1974,110987,"Saeed Meer",3,2,5,60
1974,110991,"Jaidip Mukerjea",2,2,4,50
1974,111033,"Kiyoshi Tanabe",1,NA,NA,NA
1974,111135,"Greg Perkins",1,2,3,33.333333333333336
1974,112312,"Frank Arthur Sedgman",2,1,3,66.66666666666667
1974,125578,"Tomas Lynch",1,1,2,50
1974,125583,"Tito Vazquez",1,1,2,50
1974,199999,"U Unknown",4,17,21,19.047619047619047
1974,201701,"Reijo Tuomola",1,1,2,50
1974,202541,"John Andrews",5,5,10,50
1974,202581,"Wanaro Ngodrella",4,3,7,57.142857142857146
1974,202761,"Terry Hassall",1,1,2,50
1974,209419,"Bill Brown",1,1,2,50
1974,209822,"T Allen",1,NA,NA,NA
1974,209825,"D Beasant",1,1,2,50
1974,209827,"Pieter Burki",1,1,2,50
1974,209828,"A Jackson",1,1,2,50
1974,209829,"A Ferguson",1,1,2,50
1974,209830,"E Davies",1,1,2,50
1974,209831,"Rick Jordan",1,1,2,50
1975,100016,"Ken Rosewall",41,12,53,77.35849056603773
1975,100022,"Roy Emerson",3,8,11,27.272727272727273
1975,100024,"Jan Eric Lundquist",1,2,3,33.333333333333336
1975,100025,"Barry Phillips Moore",17,35,52,32.69230769230769
1975,100028,"Manuel Santana",2,3,5,40
1975,100029,"Rod Laver",51,12,63,80.95238095238095
1975,100030,"Fred Stolle",2,3,5,40
1975,100035,"Ion Tiriac",8,11,19,42.10526315789474
1975,100037,"Nikola Pilic",20,15,35,57.142857142857146
1975,100038,"Jaime Pinto Bravo",12,12,24,50
1975,100039,"Boro Jovanovic",1,6,7,14.285714285714286
1975,100040,"Bob Hewitt",27,16,43,62.7906976744186
1975,100047,"Bob Carmichael",21,27,48,43.75
1975,100048,"Earl Butch Buchholz",3,2,5,60
1975,100049,"Jim Mcmanus",5,17,22,22.727272727272727
1975,100054,"Jose Mandarino",3,7,10,30
1975,100055,"Cliff Drysdale",32,20,52,61.53846153846154
1975,100056,"Harald Elschenbroich",20,22,42,47.61904761904762
1975,100057,"Pierre Barthes",2,5,7,28.571428571428573
1975,100058,"Roger Taylor",39,23,62,62.903225806451616
1975,100060,"Marty Riessen",23,16,39,58.97435897435897
1975,100061,"Tom Edlefsen",2,10,12,16.666666666666668
1975,100062,"Francois Jauffret",25,15,40,62.5
1975,100064,"Juan Gisbert",48,28,76,63.1578947368421
1975,100067,"Frew Mcmillan",13,18,31,41.935483870967744
1975,100069,"Dennis Ralston",2,5,7,28.571428571428573
1975,100070,"Jan Kukal",2,1,3,66.66666666666667
1975,100073,"Mark Cox",31,13,44,70.45454545454545
1975,100074,"Arthur Ashe",102,22,124,82.25806451612904
1975,100075,"Owen Davidson",1,1,2,50
1975,100076,"Milan Holecek",13,21,34,38.23529411764706
1975,100078,"Clark Graebner",8,11,19,42.10526315789474
1975,100079,"Bill Bowrey",1,2,3,33.333333333333336
1975,100080,"Szabolcz Baranyi",1,4,5,20
1975,100081,"Charlie Pasarell",22,25,47,46.808510638297875
1975,100082,"Roger Dowdeswell",6,14,20,30
1975,100083,"Nicola Spear",20,25,45,44.44444444444444
1975,100084,"Tom Okker",39,13,52,75
1975,100085,"Hans Joachim Ploetz",15,18,33,45.45454545454545
1975,100086,"Frantisek Pala",8,14,22,36.36363636363637
1975,100087,"John Newcombe",21,9,30,70
1975,100088,"Patricio Cornejo",8,23,31,25.806451612903224
1975,100089,"Patrice Beust",1,3,4,25
1975,100090,"Dick Crealy",41,37,78,52.56410256410256
1975,100091,"Colin Dibley",18,29,47,38.297872340425535
1975,100092,"Alex Metreveli",25,17,42,59.523809523809526
1975,100093,"William Brown",3,13,16,18.75
1975,100098,"Ove Nils Bengtson",2,16,18,11.11111111111111
1975,100099,"Thomaz Koch",20,22,42,47.61904761904762
1975,100100,"Tony Roche",31,13,44,70.45454545454545
1975,100101,"Mike Belkin",2,2,4,50
1975,100102,"Joaquin Loyo Mayo",14,23,37,37.83783783783784
1975,100103,"Peter Curtis",1,1,2,50
1975,100105,"Allan Stone",30,21,51,58.8235294117647
1975,100106,"Graham Stilwell",14,25,39,35.8974358974359
1975,100107,"Robert Rheinberger",1,14,15,6.666666666666667
1975,100109,"Jun Kuki",11,28,39,28.205128205128204
1975,100111,"Ray Keldie",1,5,6,16.666666666666668
1975,100113,"Jan Kodes",55,21,76,72.36842105263158
1975,100114,"Ray Ruffels",16,23,39,41.02564102564103
1975,100115,"Jaime Fillol",62,27,89,69.66292134831461
1975,100116,"Sherwood Stewart",18,27,45,40
1975,100118,"Ivan Molina",32,34,66,48.484848484848484
1975,100119,"Ilie Nastase",89,21,110,80.9090909090909
1975,100120,"Robert Maud",2,11,13,15.384615384615385
1975,100121,"Raymond Moore",32,34,66,48.484848484848484
1975,100122,"Julian Ganzabal",10,16,26,38.46153846153846
1975,100123,"Patrick Hombergen",2,1,3,66.66666666666667
1975,100124,"Steve Turner",4,6,10,40
1975,100125,"John Cooper",1,1,2,50
1975,100126,"Stan Smith",41,21,62,66.12903225806451
1975,100127,"Tom Gorman",28,29,57,49.12280701754386
1975,100128,"Cliff Richey",37,24,61,60.65573770491803
1975,100129,"Jean Baptiste Chanfreau",1,6,7,14.285714285714286
1975,100130,"Vladimir Zednik",3,11,14,21.428571428571427
1975,100132,"Armistead Neely",3,9,12,25
1975,100133,"Pat Cramer",4,4,8,50
1975,100135,"Onny Parun",66,31,97,68.04123711340206
1975,100136,"Humphrey Hose",1,7,8,12.5
1975,100137,"Hans Jurgen Pohmann",19,27,46,41.30434782608695
1975,100139,"Gerald Battrick",10,22,32,31.25
1975,100141,"Zeljko Franulovic",23,26,49,46.93877551020408
1975,100142,"Peter Szoke",8,6,14,57.142857142857146
1975,100144,"Robert Lutz",43,23,66,65.15151515151516
1975,100145,"Dick Dell",6,24,30,20
1975,100146,"Jun Kamiwazumi",11,23,34,32.35294117647059
1975,100147,"Marcello Lara",4,21,25,16
1975,100148,"Ismail El Shafei",24,27,51,47.05882352941177
1975,100149,"Toshiro Sakai",1,5,6,16.666666666666668
1975,100150,"Lito Alvarez",11,22,33,33.333333333333336
1975,100152,"David Lloyd",1,2,3,33.333333333333336
1975,100153,"Patrice Hagelauer",1,2,3,33.333333333333336
1975,100154,"Peter Kanderal",2,4,6,33.333333333333336
1975,100155,"Ramiro Benavides",7,18,25,28
1975,100156,"Jasjit Singh",3,6,9,33.333333333333336
1975,100158,"John Bartlett",2,8,10,20
1975,100160,"Georges Goven",17,16,33,51.515151515151516
1975,100161,"Jurgen Fassbender",28,25,53,52.83018867924528
1975,100162,"Brian Fairlie",22,17,39,56.41025641025641
1975,100168,"Kenneth McMillan",2,4,6,33.333333333333336
1975,100169,"Ian Fletcher",2,9,11,18.181818181818183
1975,100170,"Bernard Mignot",9,14,23,39.130434782608695
1975,100171,"John Yuill",9,24,33,27.272727272727273
1975,100173,"Andrew Pattison",27,22,49,55.10204081632653
1975,100174,"Manuel Orantes",89,19,108,82.4074074074074
1975,100175,"Zan Guerry",2,2,4,50
1975,100176,"Hans Kary",23,29,52,44.23076923076923
1975,100177,"Pavel Hutka",3,5,8,37.5
1975,100178,"Bob Giltinan",11,15,26,42.30769230769231
1975,100179,"Karl Meiler",47,24,71,66.19718309859155
1975,100180,"Bill Lloyd",1,1,2,50
1975,100181,"Larry Turville",1,1,2,50
1975,100182,"Mike Estep",15,28,43,34.883720930232556
1975,100185,"Patrick Proisy",23,17,40,57.5
1975,100186,"Jeff Borowiak",32,27,59,54.23728813559322
1975,100187,"Luis Felipe Tavares",1,3,4,25
1975,100190,"Norman Holmes",12,19,31,38.70967741935484
1975,100191,"Doug Crawford",8,10,18,44.44444444444444
1975,100193,"Wanaro N'Godrella",2,4,6,33.333333333333336
1975,100196,"Haroon Rahim",22,26,48,45.833333333333336
1975,100198,"Alvaro Betancur",3,5,8,37.5
1975,100199,"Patrice Dominguez",17,19,36,47.22222222222222
1975,100200,"Antonio Zugarelli",7,14,21,33.333333333333336
1975,100201,"Syd Ball",14,28,42,33.333333333333336
1975,100203,"Phil Dent",42,27,69,60.869565217391305
1975,100204,"Pancho Walthall",1,2,3,33.333333333333336
1975,100205,"Paul Gerken",15,20,35,42.857142857142854
1975,100208,"Dick R Bohrnstedt",6,8,14,42.857142857142854
1975,100210,"Steve Docherty",1,4,5,20
1975,100214,"Adriano Panatta",53,27,80,66.25
1975,100215,"Fred Mcnair",9,29,38,23.68421052631579
1975,100216,"Charles Owens",12,16,28,42.857142857142854
1975,100219,"Geoff Masters",27,25,52,51.92307692307692
1975,100220,"Jiri Hrebec",21,17,38,55.26315789473684
1975,100221,"Carlos Kirmayr",7,13,20,35
1975,100223,"Jeff Simpson",3,1,4,75
1975,100224,"Peter Campbell",1,1,2,50
1975,100226,"Mike Machette",2,9,11,18.181818181818183
1975,100227,"Alvin Gardiner",4,8,12,33.333333333333336
1975,100228,"Kjell Johansson",11,20,31,35.483870967741936
1975,100229,"Dick Stockton",39,20,59,66.10169491525424
1975,100231,"Erik Van Dillen",20,26,46,43.47826086956522
1975,100232,"Eddie Dibbs",53,25,78,67.94871794871794
1975,100233,"Ricardo Cano",18,13,31,58.064516129032256
1975,100235,"Antonio Munoz",13,19,32,40.625
1975,100236,"John James",5,10,15,33.333333333333336
1975,100238,"Rick Fisher",5,17,22,22.727272727272727
1975,100240,"Joao Soares",2,5,7,28.571428571428573
1975,100243,"Steve Krulevitz",13,28,41,31.70731707317073
1975,100244,"John Alexander",67,24,91,73.62637362637362
1975,100245,"Jeff Austin",13,16,29,44.827586206896555
1975,100247,"Rolf Thung",11,28,39,28.205128205128204
1975,100249,"Paolo Bertolucci",18,20,38,47.36842105263158
1975,100251,"Grover Raz Reid",11,21,32,34.375
1975,100252,"Tim Gullikson",2,6,8,25
1975,100255,"Roscoe Tanner",65,24,89,73.03370786516854
1975,100257,"Ross Case",38,22,60,63.333333333333336
1975,100258,"Jorge Andrew",4,15,19,21.05263157894737
1975,100261,"Brian Gottfried",70,31,101,69.3069306930693
1975,100262,"Rolf Norberg",4,8,12,33.333333333333336
1975,100263,"John Andrews",12,15,27,44.44444444444444
1975,100265,"Cliff Letcher",3,10,13,23.076923076923077
1975,100266,"John Feaver",10,28,38,26.31578947368421
1975,100268,"Denis Naegelen",7,7,14,50
1975,100270,"Anand Amritraj",13,28,41,31.70731707317073
1975,100271,"Jean Francois Caujolle",13,15,28,46.42857142857143
1975,100272,"Sandy Mayer",35,17,52,67.3076923076923
1975,100273,"Kim Warwick",28,24,52,53.84615384615385
1975,100274,"Eric Deblicker",9,9,18,50
1975,100277,"Jacques Thamin",1,1,2,50
1975,100278,"Frank Gebert",4,14,18,22.22222222222222
1975,100279,"Mike Cahill",10,17,27,37.03703703703704
1975,100280,"Wojtek Fibak",39,33,72,54.166666666666664
1975,100281,"Sashi Menon",11,15,26,42.30769230769231
1975,100282,"Guillermo Vilas",87,18,105,82.85714285714286
1975,100284,"Jimmy Connors",79,10,89,88.76404494382022
1975,100286,"Harold Solomon",71,32,103,68.93203883495146
1975,100287,"Robin Drysdale",4,4,8,50
1975,100288,"Tenny Svensson",5,13,18,27.77777777777778
1975,100289,"Byron Bertram",5,8,13,38.46153846153846
1975,100292,"Alvaro Fillol",1,1,2,50
1975,100293,"John Marks",5,1,6,83.33333333333333
1975,100297,"Corrado Barazzutti",21,19,40,52.5
1975,100298,"George Hardie",8,8,16,50
1975,100299,"James Chico Hagey",1,2,3,33.333333333333336
1975,100300,"Jose Higueras",31,27,58,53.44827586206897
1975,100301,"Jim Delaney",10,14,24,41.666666666666664
1975,100303,"Henry Bunis",3,7,10,30
1975,100304,"Robert Kreiss",11,21,32,34.375
1975,100305,"Mark Farrell",4,17,21,19.047619047619047
1975,100309,"Raul Ramirez",67,29,96,69.79166666666667
1975,100316,"Scott Carnahan",2,1,3,66.66666666666667
1975,100321,"Vijay Amritraj",42,24,66,63.63636363636363
1975,100324,"John Whitlinger",6,15,21,28.571428571428573
1975,100325,"Ulrich Pinner",25,21,46,54.34782608695652
1975,100326,"Russell Simpson",4,16,20,20
1975,100327,"Willem Prinsloo",1,1,2,50
1975,100332,"Balazs Taroczy",17,16,33,51.515151515151516
1975,100334,"Ernie Ewert",2,8,10,20
1975,100337,"Mark Edmondson",2,4,6,33.333333333333336
1975,100339,"Victor Amaya",7,11,18,38.888888888888886
1975,100342,"Vitas Gerulaitis",39,14,53,73.58490566037736
1975,100343,"John Lloyd",17,27,44,38.63636363636363
1975,100346,"Paul Kronk",16,22,38,42.10526315789474
1975,100354,"Bernard Mitton",20,19,39,51.282051282051285
1975,100358,"Mike Fishbach",2,6,8,25
1975,100359,"Richard Lewis",3,7,10,30
1975,100360,"Brian Teacher",6,10,16,37.5
1975,100362,"Peter Fleming",6,7,13,46.15384615384615
1975,100367,"Belus Prajoux",12,17,29,41.37931034482759
1975,100372,"Trey Waltke",12,23,35,34.285714285714285
1975,100376,"Buster C Mottram",26,15,41,63.41463414634146
1975,100377,"Colin Dowdeswell",22,24,46,47.82608695652174
1975,100382,"Chris Kachel",1,13,14,7.142857142857143
1975,100383,"Peter Mcnamara",3,4,7,42.857142857142854
1975,100394,"Angel Gimenez",2,3,5,40
1975,100395,"Victor Pecci",21,21,42,50
1975,100396,"Martin Robinson",8,14,22,36.36363636363637
1975,100403,"Rolf Gehring",7,7,14,50
1975,100409,"Randy Crawford",1,1,2,50
1975,100411,"Pavel Slozil",1,6,7,14.285714285714286
1975,100413,"Ulrich Marten",2,7,9,22.22222222222222
1975,100422,"Bruce Manson",1,6,7,14.285714285714286
1975,100428,"Gene Mayer",6,10,16,37.5
1975,100430,"David Carter",3,2,5,60
1975,100431,"Mansour Bahrami",1,1,2,50
1975,100436,"Nick Saviano",2,6,8,25
1975,100437,"Bjorn Borg",77,18,95,81.05263157894737
1975,100444,"Werner Zirngibl",1,2,3,33.333333333333336
1975,100456,"Ferdi Taygan",6,7,13,46.15384615384615
1975,100461,"Billy Martin",18,16,34,52.94117647058823
1975,100533,"Paul Avis",1,1,2,50
1975,100585,"Van Winitsky",1,1,2,50
1975,100634,"Larry Gottfried",1,3,4,25
1975,106468,"Alberto Martorell",1,1,2,50
1975,106510,"Aly El Dawoudi",2,2,4,50
1975,106517,"Anatoli Volkov",1,1,2,50
1975,106594,"Attila Korpas",2,8,10,20
1975,106629,"Birger Andersson",14,17,31,45.16129032258065
1975,106883,"Dimitru Haradau",1,1,2,50
1975,106899,"Douglas Palm",4,5,9,44.44444444444444
1975,107001,"Fernando Gentil",1,4,5,20
1975,107082,"Gerard Wimmer",2,2,4,50
1975,107123,"Graeme Thomson",1,1,2,50
1975,107177,"Harry Brittain",1,1,2,50
1975,107217,"Ian Crookenden",1,6,7,14.285714285714286
1975,107255,"Jacek Niedzwiedzki",1,2,3,33.333333333333336
1975,107264,"Jaidip Mukherjea",1,1,2,50
1975,107277,"Jan Pisecky",13,14,27,48.148148148148145
1975,107281,"Jan Zabrodsky",1,2,3,33.333333333333336
1975,107284,"Janos Benyik",2,5,7,28.571428571428573
1975,107311,"Jean Paul Meyer",1,1,2,50
1975,107342,"Jim Moore",1,1,2,50
1975,107385,"John Holladay",3,7,10,30
1975,107425,"Jose Moreno",1,5,6,16.666666666666668
1975,107436,"Jose Guerrero",1,1,2,50
1975,107457,"Juan Ignacio Muntanola",8,4,12,66.66666666666667
1975,107744,"Matti Timonen",1,2,3,33.333333333333336
1975,107993,"Peter Pokorny",1,1,2,50
1975,108012,"Piero Toci",1,4,5,20
1975,108021,"Pietro Marzano",1,2,3,33.333333333333336
1975,108036,"Rafael Ruiz",1,2,3,33.333333333333336
1975,108052,"Rauty Krog",1,2,3,33.333333333333336
1975,108118,"Robert Machan",7,5,12,58.333333333333336
1975,108275,"Spencer Segura",3,12,15,20
1975,108342,"Tadeusz Nowicki",1,1,2,50
1975,108360,"Teimuraz Kakoulia",6,13,19,31.57894736842105
1975,108415,"Tom Kreiss",1,3,4,25
1975,108418,"Tom Mott",1,1,2,50
1975,108421,"Toma Ovici",5,4,9,55.55555555555556
1975,108430,"Tony Dawson",1,2,3,33.333333333333336
1975,108477,"Vincenzo Franchitti",4,3,7,57.142857142857146
1975,108567,"Yuji Tezuka",1,2,3,33.333333333333336
1975,109764,"Bernard Paul",1,1,2,50
1975,109771,"Jairo Velasco",18,24,42,42.857142857142854
1975,109787,"Cm Robinson",1,2,3,33.333333333333336
1975,109808,"Graham Oliver",1,1,2,50
1975,109841,"Alex Mayer",12,6,18,66.66666666666667
1975,109856,"Edison Mandarino",5,5,10,50
1975,109889,"Tim Sturdza",1,1,2,50
1975,109958,"Viorel Marcu",1,10,11,9.090909090909092
1975,110390,"Nikola Soear",1,1,2,50
1975,110427,"Yildirak Das",1,1,2,50
1975,110438,"Umit Center",1,1,2,50
1975,110441,"Cahit Atas",1,1,2,50
1975,111006,"William Brown",2,4,6,33.333333333333336
1975,111107,"Teimuraz Kakulia",4,2,6,66.66666666666667
1975,112312,"Frank Arthur Sedgman",1,NA,NA,NA
1975,125583,"Tito Vazquez",1,2,3,33.333333333333336
1975,199999,"U Unknown",1,13,14,7.142857142857143
1975,202541,"John Andrews",1,1,2,50
1975,202581,"Wanaro Ngodrella",2,1,3,66.66666666666667
1975,202733,"Zdravko Mincek",1,1,2,50
1976,100003,"Frank Sedgman",1,2,3,33.333333333333336
1976,100016,"Ken Rosewall",35,18,53,66.0377358490566
1976,100017,"Mal Anderson",2,3,5,40
1976,100025,"Barry Phillips Moore",14,27,41,34.146341463414636
1976,100028,"Manuel Santana",4,6,10,40
1976,100029,"Rod Laver",9,10,19,47.36842105263158
1976,100035,"Ion Tiriac",1,7,8,12.5
1976,100037,"Nikola Pilic",13,14,27,48.148148148148145
1976,100038,"Jaime Pinto Bravo",6,8,14,42.857142857142854
1976,100040,"Bob Hewitt",11,22,33,33.333333333333336
1976,100047,"Bob Carmichael",11,19,30,36.666666666666664
1976,100049,"Jim Mcmanus",1,17,18,5.555555555555555
1976,100054,"Jose Mandarino",3,5,8,37.5
1976,100055,"Cliff Drysdale",17,13,30,56.666666666666664
1976,100056,"Harald Elschenbroich",4,10,14,28.571428571428573
1976,100058,"Roger Taylor",13,14,27,48.148148148148145
1976,100060,"Marty Riessen",18,23,41,43.90243902439025
1976,100062,"Francois Jauffret",24,13,37,64.86486486486487
1976,100064,"Juan Gisbert",18,24,42,42.857142857142854
1976,100065,"Terry Ryan",1,3,4,25
1976,100067,"Frew Mcmillan",13,19,32,40.625
1976,100069,"Dennis Ralston",1,9,10,10
1976,100070,"Jan Kukal",1,1,2,50
1976,100073,"Mark Cox",22,15,37,59.45945945945946
1976,100074,"Arthur Ashe",63,22,85,74.11764705882354
1976,100076,"Milan Holecek",2,7,9,22.22222222222222
1976,100080,"Szabolcz Baranyi",1,4,5,20
1976,100081,"Charlie Pasarell",24,25,49,48.97959183673469
1976,100083,"Nicola Spear",5,16,21,23.80952380952381
1976,100084,"Tom Okker",33,18,51,64.70588235294117
1976,100085,"Hans Joachim Ploetz",2,10,12,16.666666666666668
1976,100086,"Frantisek Pala",12,15,27,44.44444444444444
1976,100087,"John Newcombe",21,17,38,55.26315789473684
1976,100088,"Patricio Cornejo",13,15,28,46.42857142857143
1976,100090,"Dick Crealy",49,35,84,58.333333333333336
1976,100091,"Colin Dibley",39,40,79,49.36708860759494
1976,100092,"Alex Metreveli",13,15,28,46.42857142857143
1976,100093,"William Brown",1,1,2,50
1976,100094,"Jim Osborne",2,2,4,50
1976,100098,"Ove Nils Bengtson",13,11,24,54.166666666666664
1976,100099,"Thomaz Koch",15,8,23,65.21739130434783
1976,100100,"Tony Roche",17,11,28,60.714285714285715
1976,100102,"Joaquin Loyo Mayo",1,2,3,33.333333333333336
1976,100105,"Allan Stone",12,21,33,36.36363636363637
1976,100109,"Jun Kuki",19,17,36,52.77777777777778
1976,100113,"Jan Kodes",49,21,70,70
1976,100114,"Ray Ruffels",34,20,54,62.96296296296296
1976,100115,"Jaime Fillol",50,28,78,64.1025641025641
1976,100116,"Sherwood Stewart",20,30,50,40
1976,100117,"Butch Seewagen",3,3,6,50
1976,100118,"Ivan Molina",22,24,46,47.82608695652174
1976,100119,"Ilie Nastase",78,16,94,82.97872340425532
1976,100121,"Raymond Moore",39,32,71,54.929577464788736
1976,100122,"Julian Ganzabal",12,16,28,42.857142857142854
1976,100124,"Steve Turner",4,16,20,20
1976,100126,"Stan Smith",52,27,79,65.82278481012658
1976,100127,"Tom Gorman",31,25,56,55.357142857142854
1976,100128,"Cliff Richey",33,24,57,57.89473684210526
1976,100130,"Vladimir Zednik",5,11,16,31.25
1976,100132,"Armistead Neely",1,3,4,25
1976,100133,"Pat Cramer",2,21,23,8.695652173913043
1976,100135,"Onny Parun",38,23,61,62.295081967213115
1976,100137,"Hans Jurgen Pohmann",25,18,43,58.13953488372093
1976,100139,"Gerald Battrick",14,24,38,36.8421052631579
1976,100141,"Zeljko Franulovic",39,24,63,61.904761904761905
1976,100142,"Peter Szoke",5,5,10,50
1976,100144,"Robert Lutz",30,19,49,61.224489795918366
1976,100146,"Jun Kamiwazumi",1,10,11,9.090909090909092
1976,100147,"Marcello Lara",2,6,8,25
1976,100148,"Ismail El Shafei",17,27,44,38.63636363636363
1976,100150,"Lito Alvarez",12,25,37,32.432432432432435
1976,100152,"David Lloyd",1,3,4,25
1976,100153,"Patrice Hagelauer",2,4,6,33.333333333333336
1976,100154,"Peter Kanderal",4,3,7,57.142857142857146
1976,100155,"Ramiro Benavides",9,18,27,33.333333333333336
1976,100156,"Jasjit Singh",1,1,2,50
1976,100158,"John Bartlett",3,16,19,15.789473684210526
1976,100160,"Georges Goven",3,12,15,20
1976,100161,"Jurgen Fassbender",9,12,21,42.857142857142854
1976,100162,"Brian Fairlie",41,29,70,58.57142857142857
1976,100166,"Gene Stuart Malin",1,1,2,50
1976,100170,"Bernard Mignot",3,6,9,33.333333333333336
1976,100171,"John Yuill",11,17,28,39.285714285714285
1976,100173,"Andrew Pattison",17,18,35,48.57142857142857
1976,100174,"Manuel Orantes",82,19,101,81.18811881188118
1976,100176,"Hans Kary",25,28,53,47.16981132075472
1976,100177,"Pavel Hutka",3,7,10,30
1976,100178,"Bob Giltinan",4,12,16,25
1976,100179,"Karl Meiler",26,23,49,53.06122448979592
1976,100182,"Mike Estep",16,15,31,51.61290322580645
1976,100184,"Lars Elvstrom",4,NA,NA,NA
1976,100185,"Patrick Proisy",14,15,29,48.275862068965516
1976,100186,"Jeff Borowiak",18,23,41,43.90243902439025
1976,100187,"Luis Felipe Tavares",1,2,3,33.333333333333336
1976,100190,"Norman Holmes",8,22,30,26.666666666666668
1976,100191,"Doug Crawford",3,4,7,42.857142857142854
1976,100193,"Wanaro N'Godrella",1,2,3,33.333333333333336
1976,100196,"Haroon Rahim",28,18,46,60.869565217391305
1976,100197,"Alejandro Pierola",2,2,4,50
1976,100198,"Alvaro Betancur",9,19,28,32.142857142857146
1976,100199,"Patrice Dominguez",7,7,14,50
1976,100200,"Antonio Zugarelli",20,16,36,55.55555555555556
1976,100201,"Syd Ball",8,19,27,29.62962962962963
1976,100203,"Phil Dent",28,22,50,56
1976,100206,"Kenichi Hirai",2,4,6,33.333333333333336
1976,100208,"Dick R Bohrnstedt",1,6,7,14.285714285714286
1976,100211,"Louk Sanders",1,3,4,25
1976,100213,"Fred Hemmes",1,1,2,50
1976,100214,"Adriano Panatta",40,15,55,72.72727272727273
1976,100215,"Fred Mcnair",13,21,34,38.23529411764706
1976,100216,"Charles Owens",6,6,12,50
1976,100219,"Geoff Masters",27,31,58,46.55172413793103
1976,100220,"Jiri Hrebec",27,27,54,50
1976,100221,"Carlos Kirmayr",10,15,25,40
1976,100223,"Jeff Simpson",1,2,3,33.333333333333336
1976,100226,"Mike Machette",6,11,17,35.294117647058826
1976,100227,"Alvin Gardiner",5,15,20,25
1976,100228,"Kjell Johansson",16,19,35,45.714285714285715
1976,100229,"Dick Stockton",58,26,84,69.04761904761905
1976,100231,"Erik Van Dillen",16,26,42,38.095238095238095
1976,100232,"Eddie Dibbs",83,28,111,74.77477477477477
1976,100233,"Ricardo Cano",43,26,69,62.31884057971015
1976,100235,"Antonio Munoz",14,20,34,41.1764705882353
1976,100236,"John James",6,14,20,30
1976,100238,"Rick Fisher",2,9,11,18.181818181818183
1976,100240,"Joao Soares",1,4,5,20
1976,100243,"Steve Krulevitz",23,23,46,50
1976,100244,"John Alexander",19,21,40,47.5
1976,100245,"Jeff Austin",4,12,16,25
1976,100247,"Rolf Thung",3,19,22,13.636363636363637
1976,100249,"Paolo Bertolucci",33,17,50,66
1976,100250,"Woody Blocher",1,2,3,33.333333333333336
1976,100251,"Grover Raz Reid",7,22,29,24.137931034482758
1976,100252,"Tim Gullikson",10,19,29,34.48275862068966
1976,100253,"Tom Gullikson",9,13,22,40.90909090909091
1976,100255,"Roscoe Tanner",70,28,98,71.42857142857143
1976,100257,"Ross Case",28,24,52,53.84615384615385
1976,100258,"Jorge Andrew",11,20,31,35.483870967741936
1976,100259,"Peter Feigl",1,3,4,25
1976,100261,"Brian Gottfried",68,29,97,70.10309278350516
1976,100262,"Rolf Norberg",8,11,19,42.10526315789474
1976,100263,"John Andrews",7,11,18,38.888888888888886
1976,100265,"Cliff Letcher",6,16,22,27.272727272727273
1976,100266,"John Feaver",6,16,22,27.272727272727273
1976,100268,"Denis Naegelen",8,9,17,47.05882352941177
1976,100270,"Anand Amritraj",6,22,28,21.428571428571427
1976,100271,"Jean Francois Caujolle",15,15,30,50
1976,100272,"Sandy Mayer",13,15,28,46.42857142857143
1976,100273,"Kim Warwick",28,32,60,46.666666666666664
1976,100274,"Eric Deblicker",10,15,25,40
1976,100276,"Terry Moor",9,11,20,45
1976,100278,"Frank Gebert",5,12,17,29.41176470588235
1976,100279,"Mike Cahill",13,27,40,32.5
1976,100280,"Wojtek Fibak",76,32,108,70.37037037037037
1976,100281,"Sashi Menon",19,27,46,41.30434782608695
1976,100282,"Guillermo Vilas",82,20,102,80.3921568627451
1976,100284,"Jimmy Connors",98,9,107,91.58878504672897
1976,100285,"Rod Frawley",1,1,2,50
1976,100286,"Harold Solomon",72,29,101,71.2871287128713
1976,100287,"Robin Drysdale",5,12,17,29.41176470588235
1976,100288,"Tenny Svensson",1,11,12,8.333333333333334
1976,100289,"Byron Bertram",23,24,47,48.93617021276596
1976,100290,"Timothy Noonan",3,4,7,42.857142857142854
1976,100292,"Alvaro Fillol",5,12,17,29.41176470588235
1976,100293,"John Marks",3,15,18,16.666666666666668
1976,100297,"Corrado Barazzutti",32,15,47,68.08510638297872
1976,100298,"George Hardie",3,16,19,15.789473684210526
1976,100299,"James Chico Hagey",8,9,17,47.05882352941177
1976,100300,"Jose Higueras",36,20,56,64.28571428571429
1976,100301,"Jim Delaney",20,29,49,40.816326530612244
1976,100302,"Joaquim Rasgado Jr",2,4,6,33.333333333333336
1976,100303,"Henry Bunis",12,21,33,36.36363636363637
1976,100305,"Mark Farrell",1,1,2,50
1976,100306,"Michael Wayman",3,3,6,50
1976,100309,"Raul Ramirez",96,33,129,74.4186046511628
1976,100313,"Keith Richardson",2,4,6,33.333333333333336
1976,100315,"Hank Pfister",8,12,20,40
1976,100316,"Scott Carnahan",2,2,4,50
1976,100317,"Stephen Warboys",1,1,2,50
1976,100320,"Mark Meyers",1,2,3,33.333333333333336
1976,100321,"Vijay Amritraj",29,21,50,58
1976,100322,"Emilio Montano",4,8,12,33.333333333333336
1976,100324,"John Whitlinger",17,29,46,36.95652173913044
1976,100325,"Ulrich Pinner",13,12,25,52
1976,100326,"Russell Simpson",8,16,24,33.333333333333336
1976,100327,"Willem Prinsloo",3,1,4,75
1976,100331,"Jean Louis Haillet",8,10,18,44.44444444444444
1976,100332,"Balazs Taroczy",37,20,57,64.91228070175438
1976,100337,"Mark Edmondson",42,29,71,59.15492957746479
1976,100339,"Victor Amaya",13,23,36,36.111111111111114
1976,100342,"Vitas Gerulaitis",33,21,54,61.111111111111114
1976,100343,"John Lloyd",17,21,38,44.73684210526316
1976,100344,"Eric Friedler",1,10,11,9.090909090909092
1976,100345,"Pat Dupre",6,14,20,30
1976,100346,"Paul Kronk",10,20,30,33.333333333333336
1976,100354,"Bernard Mitton",16,21,37,43.24324324324324
1976,100356,"Paul Mcnamee",2,8,10,20
1976,100359,"Richard Lewis",4,9,13,30.76923076923077
1976,100360,"Brian Teacher",11,12,23,47.82608695652174
1976,100362,"Peter Fleming",15,14,29,51.724137931034484
1976,100364,"Jonathan Smith",1,3,4,25
1976,100367,"Belus Prajoux",13,14,27,48.148148148148145
1976,100369,"Herve Gauvain",5,11,16,31.25
1976,100372,"Trey Waltke",15,21,36,41.666666666666664
1976,100374,"Javier Soler",6,4,10,60
1976,100376,"Buster C Mottram",33,16,49,67.34693877551021
1976,100377,"Colin Dowdeswell",14,26,40,35
1976,100378,"David Schneider",5,6,11,45.45454545454545
1976,100380,"Butch Walts",16,13,29,55.172413793103445
1976,100382,"Chris Kachel",5,14,19,26.31578947368421
1976,100394,"Angel Gimenez",8,7,15,53.333333333333336
1976,100395,"Victor Pecci",46,29,75,61.333333333333336
1976,100396,"Martin Robinson",3,14,17,17.647058823529413
1976,100406,"Greg Halder",1,1,2,50
1976,100407,"Dale Collings",1,1,2,50
1976,100411,"Pavel Slozil",1,5,6,16.666666666666668
1976,100413,"Ulrich Marten",1,7,8,12.5
1976,100417,"Hans Gildemeister",3,2,5,60
1976,100421,"Jan Norback",1,5,6,16.666666666666668
1976,100422,"Bruce Manson",3,6,9,33.333333333333336
1976,100428,"Gene Mayer",17,16,33,51.515151515151516
1976,100429,"Miguel Mir",1,4,5,20
1976,100430,"David Carter",1,1,2,50
1976,100434,"Tomas Smid",5,7,12,41.666666666666664
1976,100436,"Nick Saviano",7,12,19,36.8421052631579
1976,100437,"Bjorn Borg",57,12,69,82.6086956521739
1976,100444,"Werner Zirngibl",10,12,22,45.45454545454545
1976,100452,"Bill Scanlon",15,17,32,46.875
1976,100456,"Ferdi Taygan",3,8,11,27.272727272727273
1976,100461,"Billy Martin",29,31,60,48.333333333333336
1976,100469,"Ashok Amritraj",2,7,9,22.22222222222222
1976,100474,"Chris Lewis",9,16,25,36
1976,100477,"Gianni Ocleppo",2,4,6,33.333333333333336
1976,100483,"Christophe Casa",1,1,2,50
1976,100545,"Deon Joubert",4,5,9,44.44444444444444
1976,100551,"Brad Drewett",4,3,7,57.142857142857146
1976,100577,"Rory Chappell",2,1,3,66.66666666666667
1976,100579,"Heinz Gunthardt",1,4,5,20
1976,100581,"John McEnroe",1,1,2,50
1976,100585,"Van Winitsky",1,2,3,33.333333333333336
1976,100586,"Eliot Teltscher",1,1,2,50
1976,100634,"Larry Gottfried",2,3,5,40
1976,106614,"Bengt Lundstedt",1,1,2,50
1976,106629,"Birger Andersson",6,14,20,30
1976,106641,"Bobby Webb",2,4,6,33.333333333333336
1976,106899,"Douglas Palm",4,9,13,30.76923076923077
1976,106923,"Eduardo Mandarino",1,4,5,20
1976,106945,"Enrique Caviglia",1,4,5,20
1976,107068,"Gavorielle Marcu",1,1,2,50
1976,107092,"Geza Varga",2,1,3,66.66666666666667
1976,107118,"Gordon Jones",1,1,2,50
1976,107123,"Graeme Thomson",1,2,3,33.333333333333336
1976,107235,"Ionel Santeiu",1,2,3,33.333333333333336
1976,107255,"Jacek Niedzwiedzki",1,2,3,33.333333333333336
1976,107277,"Jan Pisecky",1,1,2,50
1976,107279,"Jan Simbera",2,1,3,66.66666666666667
1976,107324,"Jeff Robinson",1,1,2,50
1976,107391,"John Muller",1,NA,NA,NA
1976,107425,"Jose Moreno",2,3,5,40
1976,107457,"Juan Ignacio Muntanola",7,11,18,38.888888888888886
1976,107463,"Juan Torralbo",1,1,2,50
1976,107728,"Massimo Di Domenico",1,3,4,25
1976,107744,"Matti Timonen",1,2,3,33.333333333333336
1976,107993,"Peter Pokorny",1,1,2,50
1976,108085,"Richard Hawkes",1,1,2,50
1976,108133,"Roberto Lombardi",1,2,3,33.333333333333336
1976,108154,"Roger Mckee",1,1,2,50
1976,108192,"Sachio Kato",1,2,3,33.333333333333336
1976,108304,"Stephen Myers",1,1,2,50
1976,108360,"Teimuraz Kakoulia",6,3,9,66.66666666666667
1976,108446,"Trevor Little",1,1,2,50
1976,108453,"Ulf Eriksson",1,3,4,25
1976,108519,"William Coghlan",1,1,2,50
1976,108525,"William Durham",1,1,2,50
1976,109771,"Jairo Velasco",22,26,48,45.833333333333336
1976,109809,"John Mills",1,1,2,50
1976,109831,"K Javan",1,1,2,50
1976,109867,"D Turner",1,1,2,50
1976,109885,"U Montona",1,1,2,50
1976,110098,"S Hegna",3,1,4,75
1976,110133,"S Johansson",1,1,2,50
1976,110135,"U Zerngibl",1,1,2,50
1976,110136,"P Moore",2,1,3,66.66666666666667
1976,110362,"S Sullivan",1,1,2,50
1976,125583,"Tito Vazquez",1,1,2,50
1976,202541,"John Andrews",2,2,4,50
1976,202705,"Danny Sullivan",1,NA,NA,NA
1977,100016,"Ken Rosewall",39,20,59,66.10169491525424
1977,100017,"Mal Anderson",1,2,3,33.333333333333336
1977,100020,"Alejandro Olmedo",1,1,2,50
1977,100022,"Roy Emerson",6,4,10,60
1977,100025,"Barry Phillips Moore",7,15,22,31.818181818181817
1977,100029,"Rod Laver",5,9,14,35.714285714285715
1977,100030,"Fred Stolle",1,1,2,50
1977,100035,"Ion Tiriac",15,20,35,42.857142857142854
1977,100037,"Nikola Pilic",11,14,25,44
1977,100038,"Jaime Pinto Bravo",5,5,10,50
1977,100040,"Bob Hewitt",29,25,54,53.7037037037037
1977,100047,"Bob Carmichael",1,18,19,5.2631578947368425
1977,100055,"Cliff Drysdale",17,17,34,50
1977,100056,"Harald Elschenbroich",1,2,3,33.333333333333336
1977,100057,"Pierre Barthes",2,3,5,40
1977,100058,"Roger Taylor",12,19,31,38.70967741935484
1977,100060,"Marty Riessen",18,19,37,48.648648648648646
1977,100062,"Francois Jauffret",20,13,33,60.60606060606061
1977,100067,"Frew Mcmillan",18,20,38,47.36842105263158
1977,100069,"Dennis Ralston",1,2,3,33.333333333333336
1977,100073,"Mark Cox",35,21,56,62.5
1977,100074,"Arthur Ashe",6,4,10,60
1977,100081,"Charlie Pasarell",13,21,34,38.23529411764706
1977,100083,"Nicola Spear",15,19,34,44.11764705882353
1977,100084,"Tom Okker",15,13,28,53.57142857142857
1977,100086,"Frantisek Pala",3,16,19,15.789473684210526
1977,100087,"John Newcombe",5,5,10,50
1977,100088,"Patricio Cornejo",14,14,28,50
1977,100090,"Dick Crealy",31,30,61,50.81967213114754
1977,100091,"Colin Dibley",52,33,85,61.1764705882353
1977,100092,"Alex Metreveli",7,6,13,53.84615384615385
1977,100098,"Ove Nils Bengtson",12,13,25,48
1977,100099,"Thomaz Koch",1,7,8,12.5
1977,100100,"Tony Roche",21,16,37,56.75675675675676
1977,100105,"Allan Stone",14,15,29,48.275862068965516
1977,100109,"Jun Kuki",3,11,14,21.428571428571427
1977,100113,"Jan Kodes",29,24,53,54.716981132075475
1977,100114,"Ray Ruffels",12,17,29,41.37931034482759
1977,100115,"Jaime Fillol",46,22,68,67.6470588235294
1977,100116,"Sherwood Stewart",20,27,47,42.5531914893617
1977,100117,"Butch Seewagen",7,9,16,43.75
1977,100118,"Ivan Molina",14,18,32,43.75
1977,100119,"Ilie Nastase",44,18,62,70.96774193548387
1977,100121,"Raymond Moore",39,31,70,55.714285714285715
1977,100122,"Julian Ganzabal",1,6,7,14.285714285714286
1977,100124,"Steve Turner",3,8,11,27.272727272727273
1977,100126,"Stan Smith",58,27,85,68.23529411764706
1977,100127,"Tom Gorman",28,22,50,56
1977,100128,"Cliff Richey",14,17,31,45.16129032258065
1977,100130,"Vladimir Zednik",9,13,22,40.90909090909091
1977,100131,"Guillermo Oropez",1,2,3,33.333333333333336
1977,100135,"Onny Parun",13,27,40,32.5
1977,100137,"Hans Jurgen Pohmann",1,5,6,16.666666666666668
1977,100141,"Zeljko Franulovic",33,22,55,60
1977,100144,"Robert Lutz",41,23,64,64.0625
1977,100146,"Jun Kamiwazumi",1,2,3,33.333333333333336
1977,100147,"Marcello Lara",3,8,11,27.272727272727273
1977,100148,"Ismail El Shafei",17,20,37,45.945945945945944
1977,100150,"Lito Alvarez",10,24,34,29.41176470588235
1977,100152,"David Lloyd",2,5,7,28.571428571428573
1977,100155,"Ramiro Benavides",5,14,19,26.31578947368421
1977,100158,"John Bartlett",1,10,11,9.090909090909092
1977,100160,"Georges Goven",5,11,16,31.25
1977,100161,"Jurgen Fassbender",21,21,42,50
1977,100162,"Brian Fairlie",26,25,51,50.98039215686274
1977,100163,"Tom Leonard",6,3,9,66.66666666666667
1977,100164,"Bill Lofgren",4,17,21,19.047619047619047
1977,100170,"Bernard Mignot",2,2,4,50
1977,100171,"John Yuill",16,25,41,39.02439024390244
1977,100173,"Andrew Pattison",34,31,65,52.30769230769231
1977,100174,"Manuel Orantes",63,22,85,74.11764705882354
1977,100175,"Zan Guerry",8,16,24,33.333333333333336
1977,100176,"Hans Kary",18,21,39,46.15384615384615
1977,100177,"Pavel Hutka",9,11,20,45
1977,100178,"Bob Giltinan",4,3,7,57.142857142857146
1977,100179,"Karl Meiler",34,22,56,60.714285714285715
1977,100180,"Bill Lloyd",8,12,20,40
1977,100182,"Mike Estep",3,7,10,30
1977,100184,"Lars Elvstrom",1,3,4,25
1977,100185,"Patrick Proisy",25,18,43,58.13953488372093
1977,100186,"Jeff Borowiak",47,24,71,66.19718309859155
1977,100191,"Doug Crawford",3,13,16,18.75
1977,100195,"Nicolas Kelaidis",1,1,2,50
1977,100196,"Haroon Rahim",7,7,14,50
1977,100197,"Alejandro Pierola",3,4,7,42.857142857142854
1977,100198,"Alvaro Betancur",9,19,28,32.142857142857146
1977,100199,"Patrice Dominguez",10,14,24,41.666666666666664
1977,100200,"Antonio Zugarelli",20,15,35,57.142857142857146
1977,100201,"Syd Ball",3,10,13,23.076923076923077
1977,100202,"George Amaya",2,3,5,40
1977,100203,"Phil Dent",59,29,88,67.04545454545455
1977,100205,"Paul Gerken",3,5,8,37.5
1977,100207,"Noel Phillips",1,1,2,50
1977,100208,"Dick R Bohrnstedt",9,15,24,37.5
1977,100210,"Steve Docherty",14,16,30,46.666666666666664
1977,100211,"Louk Sanders",6,6,12,50
1977,100214,"Adriano Panatta",24,17,41,58.53658536585366
1977,100215,"Fred Mcnair",13,26,39,33.333333333333336
1977,100219,"Geoff Masters",22,27,49,44.89795918367347
1977,100220,"Jiri Hrebec",25,21,46,54.34782608695652
1977,100221,"Carlos Kirmayr",7,10,17,41.1764705882353
1977,100226,"Mike Machette",5,20,25,20
1977,100227,"Alvin Gardiner",3,11,14,21.428571428571427
1977,100228,"Kjell Johansson",13,10,23,56.52173913043478
1977,100229,"Dick Stockton",56,23,79,70.88607594936708
1977,100231,"Erik Van Dillen",10,15,25,40
1977,100232,"Eddie Dibbs",77,28,105,73.33333333333333
1977,100233,"Ricardo Cano",18,24,42,42.857142857142854
1977,100235,"Antonio Munoz",8,17,25,32
1977,100236,"John James",16,23,39,41.02564102564103
1977,100238,"Rick Fisher",3,13,16,18.75
1977,100243,"Steve Krulevitz",14,21,35,40
1977,100244,"John Alexander",48,33,81,59.25925925925926
1977,100245,"Jeff Austin",2,5,7,28.571428571428573
1977,100247,"Rolf Thung",2,5,7,28.571428571428573
1977,100248,"Max Hurlimann",1,4,5,20
1977,100249,"Paolo Bertolucci",31,14,45,68.88888888888889
1977,100251,"Grover Raz Reid",2,4,6,33.333333333333336
1977,100252,"Tim Gullikson",50,22,72,69.44444444444444
1977,100253,"Tom Gullikson",27,29,56,48.214285714285715
1977,100255,"Roscoe Tanner",51,29,80,63.75
1977,100257,"Ross Case",20,24,44,45.45454545454545
1977,100258,"Jorge Andrew",6,18,24,25
1977,100259,"Peter Feigl",4,7,11,36.36363636363637
1977,100261,"Brian Gottfried",107,22,129,82.94573643410853
1977,100262,"Rolf Norberg",8,17,25,32
1977,100264,"Lajos Levai",1,2,3,33.333333333333336
1977,100265,"Cliff Letcher",14,19,33,42.42424242424242
1977,100266,"John Feaver",21,27,48,43.75
1977,100270,"Anand Amritraj",10,16,26,38.46153846153846
1977,100271,"Jean Francois Caujolle",17,20,37,45.945945945945944
1977,100272,"Sandy Mayer",39,14,53,73.58490566037736
1977,100273,"Kim Warwick",35,29,64,54.6875
1977,100274,"Eric Deblicker",12,13,25,48
1977,100276,"Terry Moor",29,23,52,55.76923076923077
1977,100278,"Frank Gebert",20,23,43,46.51162790697674
1977,100279,"Mike Cahill",10,18,28,35.714285714285715
1977,100280,"Wojtek Fibak",65,30,95,68.42105263157895
1977,100281,"Sashi Menon",11,27,38,28.94736842105263
1977,100282,"Guillermo Vilas",128,15,143,89.5104895104895
1977,100284,"Jimmy Connors",71,16,87,81.60919540229885
1977,100285,"Rod Frawley",3,10,13,23.076923076923077
1977,100286,"Harold Solomon",65,27,92,70.65217391304348
1977,100287,"Robin Drysdale",4,12,16,25
1977,100288,"Tenny Svensson",4,4,8,50
1977,100289,"Byron Bertram",21,27,48,43.75
1977,100292,"Alvaro Fillol",6,13,19,31.57894736842105
1977,100293,"John Marks",4,13,17,23.529411764705884
1977,100297,"Corrado Barazzutti",31,14,45,68.88888888888889
1977,100298,"George Hardie",13,21,34,38.23529411764706
1977,100299,"James Chico Hagey",5,23,28,17.857142857142858
1977,100300,"Jose Higueras",42,23,65,64.61538461538461
1977,100301,"Jim Delaney",16,27,43,37.2093023255814
1977,100303,"Henry Bunis",10,20,30,33.333333333333336
1977,100305,"Mark Farrell",1,1,2,50
1977,100306,"Michael Wayman",1,6,7,14.285714285714286
1977,100309,"Raul Ramirez",65,25,90,72.22222222222223
1977,100312,"Chiraid Mukherjea",1,1,2,50
1977,100313,"Keith Richardson",6,13,19,31.57894736842105
1977,100314,"Bernard Fritz",3,6,9,33.333333333333336
1977,100315,"Hank Pfister",37,27,64,57.8125
1977,100319,"Rick Fagel",9,15,24,37.5
1977,100320,"Mark Meyers",1,4,5,20
1977,100321,"Vijay Amritraj",25,22,47,53.191489361702125
1977,100322,"Emilio Montano",4,12,16,25
1977,100324,"John Whitlinger",7,17,24,29.166666666666668
1977,100325,"Ulrich Pinner",8,14,22,36.36363636363637
1977,100326,"Russell Simpson",6,15,21,28.571428571428573
1977,100327,"Willem Prinsloo",4,15,19,21.05263157894737
1977,100331,"Jean Louis Haillet",9,16,25,36
1977,100332,"Balazs Taroczy",38,23,61,62.295081967213115
1977,100334,"Ernie Ewert",2,2,4,50
1977,100337,"Mark Edmondson",16,24,40,40
1977,100339,"Victor Amaya",18,20,38,47.36842105263158
1977,100342,"Vitas Gerulaitis",60,15,75,80
1977,100343,"John Lloyd",30,27,57,52.63157894736842
1977,100344,"Eric Friedler",4,12,16,25
1977,100345,"Pat Dupre",11,22,33,33.333333333333336
1977,100346,"Paul Kronk",7,19,26,26.923076923076923
1977,100347,"Peter Kronk",1,1,2,50
1977,100348,"Gerard Toulon",2,3,5,40
1977,100354,"Bernard Mitton",23,32,55,41.81818181818182
1977,100356,"Paul Mcnamee",14,18,32,43.75
1977,100358,"Mike Fishbach",9,8,17,52.94117647058823
1977,100359,"Richard Lewis",27,30,57,47.36842105263158
1977,100360,"Brian Teacher",31,31,62,50
1977,100362,"Peter Fleming",31,28,59,52.54237288135593
1977,100363,"Jiri Granat",10,10,20,50
1977,100364,"Jonathan Smith",3,5,8,37.5
1977,100367,"Belus Prajoux",16,20,36,44.44444444444444
1977,100369,"Herve Gauvain",2,3,5,40
1977,100372,"Trey Waltke",18,25,43,41.86046511627907
1977,100373,"Christopher Sylvan",3,4,7,42.857142857142854
1977,100374,"Javier Soler",12,20,32,37.5
1977,100376,"Buster C Mottram",49,23,72,68.05555555555556
1977,100377,"Colin Dowdeswell",9,13,22,40.90909090909091
1977,100378,"David Schneider",3,17,20,15
1977,100380,"Butch Walts",21,19,40,52.5
1977,100382,"Chris Kachel",7,16,23,30.434782608695652
1977,100383,"Peter Mcnamara",3,8,11,27.272727272727273
1977,100394,"Angel Gimenez",1,1,2,50
1977,100395,"Victor Pecci",38,26,64,59.375
1977,100397,"Terry Rocavert",3,6,9,33.333333333333336
1977,100400,"Hubertus Hoyt",1,6,7,14.285714285714286
1977,100402,"Francisco Gonzalez",4,6,10,40
1977,100403,"Rolf Gehring",9,9,18,50
1977,100406,"Greg Halder",3,7,10,30
1977,100407,"Dale Collings",1,4,5,20
1977,100413,"Ulrich Marten",3,3,6,50
1977,100417,"Hans Gildemeister",35,23,58,60.3448275862069
1977,100421,"Jan Norback",11,21,32,34.375
1977,100422,"Bruce Manson",7,15,22,31.818181818181817
1977,100428,"Gene Mayer",17,27,44,38.63636363636363
1977,100430,"David Carter",2,3,5,40
1977,100431,"Mansour Bahrami",1,2,3,33.333333333333336
1977,100434,"Tomas Smid",16,18,34,47.05882352941177
1977,100436,"Nick Saviano",13,18,31,41.935483870967744
1977,100437,"Bjorn Borg",76,8,84,90.47619047619048
1977,100443,"Christophe Freyss",4,6,10,40
1977,100444,"Werner Zirngibl",7,18,25,28
1977,100448,"Bruce Foxworth",2,1,3,66.66666666666667
1977,100452,"Bill Scanlon",36,30,66,54.54545454545455
1977,100461,"Billy Martin",28,29,57,49.12280701754386
1977,100468,"Dominique Bedel",2,3,5,40
1977,100473,"Glenn Petrovic",1,1,2,50
1977,100474,"Chris Lewis",17,11,28,60.714285714285715
1977,100475,"Matt Mitchell",4,7,11,36.36363636363637
1977,100477,"Gianni Ocleppo",2,6,8,25
1977,100479,"Reinhart Probst",1,1,2,50
1977,100481,"Roberto Vizcaino",2,2,4,50
1977,100483,"Christophe Casa",3,9,12,25
1977,100486,"Christophe Roger Vasselin",9,7,16,56.25
1977,100496,"Charles Buzz Strode",1,1,2,50
1977,100498,"Klaus Eberhard",2,4,6,33.333333333333336
1977,100506,"Howard Schoenfield",1,10,11,9.090909090909092
1977,100522,"Chris Dunk",1,1,2,50
1977,100525,"Gilles Moretton",1,4,5,20
1977,100526,"Ricardo Ycaza",7,14,21,33.333333333333336
1977,100532,"Johan Kriek",1,2,3,33.333333333333336
1977,100535,"Tony Giammalva",1,3,4,25
1977,100536,"Fernando Luna",1,1,2,50
1977,100543,"Peter Elter",6,10,16,37.5
1977,100545,"Deon Joubert",4,16,20,20
1977,100551,"Brad Drewett",1,9,10,10
1977,100555,"Jose Luis Clerc",1,3,4,25
1977,100561,"Peter Smylie",1,1,2,50
1977,100579,"Heinz Gunthardt",3,6,9,33.333333333333336
1977,100581,"John McEnroe",28,14,42,66.66666666666667
1977,100585,"Van Winitsky",8,7,15,53.333333333333336
1977,100586,"Eliot Teltscher",9,14,23,39.130434782608695
1977,100605,"Charlie Fancutt",4,7,11,36.36363636363637
1977,100631,"Tim Wilkison",21,27,48,43.75
1977,100634,"Larry Gottfried",2,6,8,25
1977,100673,"Robbie Venter",2,1,3,66.66666666666667
1977,103993,"Chris Lewis",1,1,2,50
1977,106505,"Ali Madani",1,3,4,25
1977,106510,"Aly El Dawoudi",1,1,2,50
1977,106629,"Birger Andersson",3,8,11,27.272727272727273
1977,106702,"Carlos Lando",1,4,5,20
1977,106899,"Douglas Palm",4,16,20,20
1977,107000,"Fernando Dalla Fontana",1,4,5,20
1977,107078,"George Rudman",1,1,2,50
1977,107123,"Graeme Thomson",1,3,4,25
1977,107255,"Jacek Niedzwiedzki",5,4,9,55.55555555555556
1977,107284,"Janos Benyik",2,1,3,66.66666666666667
1977,107385,"John Holladay",2,3,5,40
1977,107398,"John Trickey",2,4,6,33.333333333333336
1977,107425,"Jose Moreno",2,5,7,28.571428571428573
1977,107457,"Juan Ignacio Muntanola",2,4,6,33.333333333333336
1977,107892,"Olle Palmer",1,3,4,25
1977,107895,"Orlando Agudelo",1,1,2,50
1977,107985,"Peter Langsford",1,1,2,50
1977,108360,"Teimuraz Kakoulia",2,2,4,50
1977,108398,"Tim Clements",1,1,2,50
1977,108453,"Ulf Eriksson",2,3,5,40
1977,108505,"Wayne Pascoe",1,1,2,50
1977,109771,"Jairo Velasco",3,13,16,18.75
1977,109806,"David Brown",1,1,2,50
1977,109810,"Dave Simmonds",1,1,2,50
1977,110015,"Doug Verdieck",1,1,2,50
1977,110114,"D Sullivan",2,1,3,66.66666666666667
1977,110260,"R Bortulan",1,1,2,50
1977,110263,"M Borgener",1,1,2,50
1977,110389,"M Laimina",1,1,2,50
1977,111107,"Teimuraz Kakulia",1,1,2,50
1977,199999,"U Unknown",2,5,7,28.571428571428573
1978,100016,"Ken Rosewall",19,19,38,50
1978,100017,"Mal Anderson",1,1,2,50
1978,100028,"Manuel Santana",1,1,2,50
1978,100029,"Rod Laver",2,2,4,50
1978,100035,"Ion Tiriac",2,10,12,16.666666666666668
1978,100037,"Nikola Pilic",2,7,9,22.22222222222222
1978,100040,"Bob Hewitt",6,21,27,22.22222222222222
1978,100047,"Bob Carmichael",4,7,11,36.36363636363637
1978,100055,"Cliff Drysdale",14,13,27,51.851851851851855
1978,100056,"Harald Elschenbroich",4,1,5,80
1978,100058,"Roger Taylor",6,12,18,33.333333333333336
1978,100060,"Marty Riessen",11,11,22,50
1978,100062,"Francois Jauffret",6,11,17,35.294117647058826
1978,100067,"Frew Mcmillan",10,18,28,35.714285714285715
1978,100073,"Mark Cox",15,16,31,48.38709677419355
1978,100074,"Arthur Ashe",66,25,91,72.52747252747253
1978,100080,"Szabolcz Baranyi",2,1,3,66.66666666666667
1978,100081,"Charlie Pasarell",4,10,14,28.571428571428573
1978,100082,"Roger Dowdeswell",2,1,3,66.66666666666667
1978,100083,"Nicola Spear",1,4,5,20
1978,100084,"Tom Okker",20,20,40,50
1978,100086,"Frantisek Pala",1,1,2,50
1978,100087,"John Newcombe",30,25,55,54.54545454545455
1978,100088,"Patricio Cornejo",6,16,22,27.272727272727273
1978,100090,"Dick Crealy",19,33,52,36.53846153846154
1978,100091,"Colin Dibley",18,29,47,38.297872340425535
1978,100092,"Alex Metreveli",1,1,2,50
1978,100098,"Ove Nils Bengtson",14,15,29,48.275862068965516
1978,100100,"Tony Roche",18,13,31,58.064516129032256
1978,100105,"Allan Stone",13,9,22,59.09090909090909
1978,100109,"Jun Kuki",6,3,9,66.66666666666667
1978,100113,"Jan Kodes",13,18,31,41.935483870967744
1978,100114,"Ray Ruffels",3,6,9,33.333333333333336
1978,100115,"Jaime Fillol",33,29,62,53.225806451612904
1978,100116,"Sherwood Stewart",24,19,43,55.81395348837209
1978,100117,"Butch Seewagen",2,4,6,33.333333333333336
1978,100118,"Ivan Molina",16,19,35,45.714285714285715
1978,100119,"Ilie Nastase",45,21,66,68.18181818181819
1978,100121,"Raymond Moore",14,25,39,35.8974358974359
1978,100126,"Stan Smith",37,19,56,66.07142857142857
1978,100127,"Tom Gorman",15,10,25,60
1978,100128,"Cliff Richey",13,12,25,52
1978,100129,"Jean Baptiste Chanfreau",2,3,5,40
1978,100130,"Vladimir Zednik",22,22,44,50
1978,100135,"Onny Parun",1,14,15,6.666666666666667
1978,100137,"Hans Jurgen Pohmann",3,4,7,42.857142857142854
1978,100141,"Zeljko Franulovic",37,28,65,56.92307692307692
1978,100144,"Robert Lutz",30,18,48,62.5
1978,100146,"Jun Kamiwazumi",4,3,7,57.142857142857146
1978,100147,"Marcello Lara",6,17,23,26.08695652173913
1978,100148,"Ismail El Shafei",12,23,35,34.285714285714285
1978,100150,"Lito Alvarez",6,15,21,28.571428571428573
1978,100152,"David Lloyd",1,4,5,20
1978,100155,"Ramiro Benavides",4,11,15,26.666666666666668
1978,100158,"John Bartlett",1,4,5,20
1978,100160,"Georges Goven",6,15,21,28.571428571428573
1978,100161,"Jurgen Fassbender",11,14,25,44
1978,100162,"Brian Fairlie",9,13,22,40.90909090909091
1978,100163,"Tom Leonard",11,15,26,42.30769230769231
1978,100171,"John Yuill",11,21,32,34.375
1978,100173,"Andrew Pattison",13,15,28,46.42857142857143
1978,100174,"Manuel Orantes",47,18,65,72.3076923076923
1978,100175,"Zan Guerry",2,7,9,22.22222222222222
1978,100176,"Hans Kary",7,19,26,26.923076923076923
1978,100177,"Pavel Hutka",9,11,20,45
1978,100178,"Bob Giltinan",7,16,23,30.434782608695652
1978,100179,"Karl Meiler",8,12,20,40
1978,100181,"Larry Turville",1,1,2,50
1978,100185,"Patrick Proisy",12,12,24,50
1978,100186,"Jeff Borowiak",16,25,41,39.02439024390244
1978,100197,"Alejandro Pierola",1,3,4,25
1978,100198,"Alvaro Betancur",5,15,20,25
1978,100199,"Patrice Dominguez",12,13,25,48
1978,100200,"Antonio Zugarelli",10,17,27,37.03703703703704
1978,100201,"Syd Ball",2,6,8,25
1978,100203,"Phil Dent",28,28,56,50
1978,100204,"Pancho Walthall",2,2,4,50
1978,100207,"Noel Phillips",2,4,6,33.333333333333336
1978,100208,"Dick R Bohrnstedt",2,10,12,16.666666666666668
1978,100210,"Steve Docherty",15,22,37,40.54054054054054
1978,100211,"Louk Sanders",10,19,29,34.48275862068966
1978,100214,"Adriano Panatta",48,24,72,66.66666666666667
1978,100215,"Fred Mcnair",3,8,11,27.272727272727273
1978,100219,"Geoff Masters",23,21,44,52.27272727272727
1978,100220,"Jiri Hrebec",9,16,25,36
1978,100221,"Carlos Kirmayr",11,16,27,40.74074074074074
1978,100226,"Mike Machette",2,6,8,25
1978,100227,"Alvin Gardiner",6,8,14,42.857142857142854
1978,100228,"Kjell Johansson",18,9,27,66.66666666666667
1978,100229,"Dick Stockton",46,27,73,63.013698630136986
1978,100231,"Erik Van Dillen",12,20,32,37.5
1978,100232,"Eddie Dibbs",84,28,112,75
1978,100233,"Ricardo Cano",10,13,23,43.47826086956522
1978,100235,"Antonio Munoz",13,18,31,41.935483870967744
1978,100236,"John James",20,27,47,42.5531914893617
1978,100238,"Rick Fisher",8,14,22,36.36363636363637
1978,100240,"Joao Soares",2,2,4,50
1978,100243,"Steve Krulevitz",6,15,21,28.571428571428573
1978,100244,"John Alexander",50,31,81,61.72839506172839
1978,100247,"Rolf Thung",1,4,5,20
1978,100249,"Paolo Bertolucci",25,20,45,55.55555555555556
1978,100250,"Woody Blocher",2,5,7,28.571428571428573
1978,100252,"Tim Gullikson",47,25,72,65.27777777777777
1978,100253,"Tom Gullikson",35,25,60,58.333333333333336
1978,100255,"Roscoe Tanner",59,24,83,71.08433734939759
1978,100257,"Ross Case",15,20,35,42.857142857142854
1978,100258,"Jorge Andrew",6,6,12,50
1978,100259,"Peter Feigl",22,16,38,57.89473684210526
1978,100261,"Brian Gottfried",72,25,97,74.22680412371135
1978,100265,"Cliff Letcher",7,21,28,25
1978,100266,"John Feaver",8,19,27,29.62962962962963
1978,100270,"Anand Amritraj",12,12,24,50
1978,100271,"Jean Francois Caujolle",1,8,9,11.11111111111111
1978,100272,"Sandy Mayer",41,20,61,67.21311475409836
1978,100273,"Kim Warwick",31,24,55,56.36363636363637
1978,100274,"Eric Deblicker",13,14,27,48.148148148148145
1978,100276,"Terry Moor",37,33,70,52.857142857142854
1978,100279,"Mike Cahill",18,21,39,46.15384615384615
1978,100280,"Wojtek Fibak",60,32,92,65.21739130434783
1978,100281,"Sashi Menon",10,22,32,31.25
1978,100282,"Guillermo Vilas",61,8,69,88.40579710144928
1978,100283,"Andre Zietsmann",1,1,2,50
1978,100284,"Jimmy Connors",68,7,75,90.66666666666667
1978,100285,"Rod Frawley",7,15,22,31.818181818181817
1978,100286,"Harold Solomon",70,33,103,67.96116504854369
1978,100287,"Robin Drysdale",13,25,38,34.21052631578947
1978,100288,"Tenny Svensson",4,10,14,28.571428571428573
1978,100289,"Byron Bertram",10,11,21,47.61904761904762
1978,100292,"Alvaro Fillol",4,16,20,20
1978,100293,"John Marks",9,17,26,34.61538461538461
1978,100294,"Rejean Genois",4,4,8,50
1978,100297,"Corrado Barazzutti",54,28,82,65.85365853658537
1978,100298,"George Hardie",16,29,45,35.55555555555556
1978,100300,"Jose Higueras",62,19,81,76.54320987654322
1978,100309,"Raul Ramirez",70,29,99,70.70707070707071
1978,100313,"Keith Richardson",3,10,13,23.076923076923077
1978,100314,"Bernard Fritz",8,13,21,38.095238095238095
1978,100315,"Hank Pfister",43,27,70,61.42857142857143
1978,100316,"Scott Carnahan",2,5,7,28.571428571428573
1978,100319,"Rick Fagel",11,18,29,37.93103448275862
1978,100321,"Vijay Amritraj",16,14,30,53.333333333333336
1978,100322,"Emilio Montano",1,3,4,25
1978,100325,"Ulrich Pinner",24,13,37,64.86486486486487
1978,100326,"Russell Simpson",6,11,17,35.294117647058826
1978,100327,"Willem Prinsloo",3,5,8,37.5
1978,100331,"Jean Louis Haillet",4,8,12,33.333333333333336
1978,100332,"Balazs Taroczy",45,18,63,71.42857142857143
1978,100337,"Mark Edmondson",16,17,33,48.484848484848484
1978,100339,"Victor Amaya",28,20,48,58.333333333333336
1978,100342,"Vitas Gerulaitis",47,15,62,75.80645161290323
1978,100343,"John Lloyd",25,25,50,50
1978,100344,"Eric Friedler",4,5,9,44.44444444444444
1978,100345,"Pat Dupre",45,31,76,59.21052631578947
1978,100346,"Paul Kronk",12,16,28,42.857142857142854
1978,100354,"Bernard Mitton",36,31,67,53.73134328358209
1978,100356,"Paul Mcnamee",17,24,41,41.46341463414634
1978,100358,"Mike Fishbach",4,21,25,16
1978,100359,"Richard Lewis",3,17,20,15
1978,100360,"Brian Teacher",38,23,61,62.295081967213115
1978,100362,"Peter Fleming",43,31,74,58.108108108108105
1978,100363,"Jiri Granat",11,22,33,33.333333333333336
1978,100364,"Jonathan Smith",3,8,11,27.272727272727273
1978,100367,"Belus Prajoux",12,17,29,41.37931034482759
1978,100372,"Trey Waltke",7,15,22,31.818181818181817
1978,100374,"Javier Soler",3,12,15,20
1978,100376,"Buster C Mottram",33,19,52,63.46153846153846
1978,100377,"Colin Dowdeswell",18,21,39,46.15384615384615
1978,100378,"David Schneider",5,10,15,33.333333333333336
1978,100380,"Butch Walts",14,21,35,40
1978,100382,"Chris Kachel",1,9,10,10
1978,100383,"Peter Mcnamara",14,15,29,48.275862068965516
1978,100387,"Jiri Prucha",1,2,3,33.333333333333336
1978,100388,"Peter Pearson",4,12,16,25
1978,100392,"Richard Meyer",1,3,4,25
1978,100394,"Angel Gimenez",12,10,22,54.54545454545455
1978,100395,"Victor Pecci",30,24,54,55.55555555555556
1978,100397,"Terry Rocavert",11,18,29,37.93103448275862
1978,100400,"Hubertus Hoyt",1,5,6,16.666666666666668
1978,100402,"Francisco Gonzalez",8,10,18,44.44444444444444
1978,100403,"Rolf Gehring",16,13,29,55.172413793103445
1978,100405,"Fernando Maynetto",3,2,5,60
1978,100406,"Greg Halder",3,12,15,20
1978,100407,"Dale Collings",3,5,8,37.5
1978,100410,"Tim Garcia",1,5,6,16.666666666666668
1978,100411,"Pavel Slozil",5,5,10,50
1978,100412,"Bruce Nichols",1,3,4,25
1978,100417,"Hans Gildemeister",27,19,46,58.69565217391305
1978,100421,"Jan Norback",3,8,11,27.272727272727273
1978,100422,"Bruce Manson",12,17,29,41.37931034482759
1978,100428,"Gene Mayer",25,18,43,58.13953488372093
1978,100429,"Miguel Mir",2,2,4,50
1978,100430,"David Carter",13,20,33,39.39393939393939
1978,100434,"Tomas Smid",36,25,61,59.01639344262295
1978,100436,"Nick Saviano",34,33,67,50.74626865671642
1978,100437,"Bjorn Borg",70,9,79,88.60759493670886
1978,100442,"Gianni Marchetti",1,1,2,50
1978,100443,"Christophe Freyss",9,17,26,34.61538461538461
1978,100444,"Werner Zirngibl",8,12,20,40
1978,100445,"Steve Denton",1,3,4,25
1978,100446,"John Sadri",6,8,14,42.857142857142854
1978,100449,"Stanislav Birner",6,15,21,28.571428571428573
1978,100450,"Leo Palin",1,3,4,25
1978,100451,"Tony Graham",2,7,9,22.22222222222222
1978,100452,"Bill Scanlon",14,21,35,40
1978,100453,"Jose Luis Damiani",4,3,7,57.142857142857146
1978,100456,"Ferdi Taygan",5,13,18,27.77777777777778
1978,100461,"Billy Martin",9,23,32,28.125
1978,100468,"Dominique Bedel",1,4,5,20
1978,100469,"Ashok Amritraj",1,2,3,33.333333333333336
1978,100474,"Chris Lewis",34,25,59,57.6271186440678
1978,100477,"Gianni Ocleppo",11,17,28,39.285714285714285
1978,100486,"Christophe Roger Vasselin",10,19,29,34.48275862068966
1978,100492,"John Austin",8,8,16,50
1978,100498,"Klaus Eberhard",6,7,13,46.15384615384615
1978,100500,"Rohun Beven",1,3,4,25
1978,100506,"Howard Schoenfield",1,6,7,14.285714285714286
1978,100516,"Andrew Jarrett",4,9,13,30.76923076923077
1978,100523,"Erick Iskersky",6,7,13,46.15384615384615
1978,100525,"Gilles Moretton",5,14,19,26.31578947368421
1978,100526,"Ricardo Ycaza",12,16,28,42.857142857142854
1978,100529,"Kevin Curren",1,2,3,33.333333333333336
1978,100530,"Andreas Maurer",6,10,16,37.5
1978,100532,"Johan Kriek",22,11,33,66.66666666666667
1978,100533,"Paul Avis",1,2,3,33.333333333333336
1978,100536,"Fernando Luna",2,2,4,50
1978,100543,"Peter Elter",9,9,18,50
1978,100545,"Deon Joubert",4,7,11,36.36363636363637
1978,100551,"Brad Drewett",5,8,13,38.46153846153846
1978,100555,"Jose Luis Clerc",50,17,67,74.6268656716418
1978,100557,"Jai Dilouie",1,2,3,33.333333333333336
1978,100564,"Cary Stansbury",1,4,5,20
1978,100579,"Heinz Gunthardt",25,25,50,50
1978,100581,"John McEnroe",77,19,96,80.20833333333333
1978,100585,"Van Winitsky",15,25,40,37.5
1978,100586,"Eliot Teltscher",24,18,42,57.142857142857146
1978,100592,"Robert Vant Hof",1,4,5,20
1978,100599,"Bernard Boileau",1,1,2,50
1978,100600,"Pascal Portes",10,16,26,38.46153846153846
1978,100605,"Charlie Fancutt",1,3,4,25
1978,100631,"Tim Wilkison",10,13,23,43.47826086956522
1978,100638,"David Mustard",1,1,2,50
1978,100640,"Stefan Simonsson",1,1,2,50
1978,100656,"Ivan Lendl",9,7,16,56.25
1978,100667,"Per Hjertquist",3,5,8,37.5
1978,100676,"Yannick Noah",23,14,37,62.16216216216216
1978,100700,"Heinz Gildemeister",3,3,6,50
1978,100752,"Ramesh Krishnan",6,6,12,50
1978,106453,"Akinori Naguro",2,2,4,50
1978,106629,"Birger Andersson",2,3,5,40
1978,106641,"Bobby Webb",1,1,2,50
1978,106651,"Brad Rowe",1,2,3,33.333333333333336
1978,106899,"Douglas Palm",3,9,12,25
1978,107000,"Fernando Dalla Fontana",1,3,4,25
1978,107009,"Fernando Vasquez",1,1,2,50
1978,107015,"Flavio Mazzocchi",1,1,2,50
1978,107215,"Hugo Varela",1,1,2,50
1978,107279,"Jan Simbera",1,2,3,33.333333333333336
1978,107284,"Janos Benyik",1,3,4,25
1978,107302,"Jay Royappa",2,3,5,40
1978,107357,"Joe Meyers",2,4,6,33.333333333333336
1978,108053,"Ray Kelly",1,3,4,25
1978,108131,"Roberto Chavez",2,3,5,40
1978,108349,"Takehiko Nishiwaki",2,2,4,50
1978,108453,"Ulf Eriksson",2,3,5,40
1978,108533,"Wouter Fok",1,1,2,50
1978,109723,"Richard Laver",2,1,3,66.66666666666667
1978,109771,"Jairo Velasco",5,5,10,50
1978,109814,"Donald Dell",1,1,2,50
1978,109871,"Harry Fritz",1,1,2,50
1978,110207,"L Maeso",1,1,2,50
1978,110344,"B Newman",1,1,2,50
1978,130938,"John Austin",2,5,7,28.571428571428573
1978,202695,"Igor Tihonenko",1,1,2,50
1979,100016,"Ken Rosewall",4,5,9,44.44444444444444
1979,100035,"Ion Tiriac",1,3,4,25
1979,100038,"Jaime Pinto Bravo",1,1,2,50
1979,100047,"Bob Carmichael",5,10,15,33.333333333333336
1979,100055,"Cliff Drysdale",5,12,17,29.41176470588235
1979,100056,"Harald Elschenbroich",1,1,2,50
1979,100058,"Roger Taylor",1,2,3,33.333333333333336
1979,100060,"Marty Riessen",34,23,57,59.64912280701754
1979,100062,"Francois Jauffret",1,4,5,20
1979,100067,"Frew Mcmillan",4,8,12,33.333333333333336
1979,100073,"Mark Cox",17,16,33,51.515151515151516
1979,100074,"Arthur Ashe",30,13,43,69.76744186046511
1979,100081,"Charlie Pasarell",1,7,8,12.5
1979,100083,"Nicola Spear",1,3,4,25
1979,100084,"Tom Okker",20,18,38,52.63157894736842
1979,100087,"John Newcombe",4,3,7,57.142857142857146
1979,100090,"Dick Crealy",1,10,11,9.090909090909092
1979,100091,"Colin Dibley",20,22,42,47.61904761904762
1979,100097,"Nicholas Kalogeropoulos",1,1,2,50
1979,100098,"Ove Nils Bengtson",4,12,16,25
1979,100099,"Thomaz Koch",4,7,11,36.36363636363637
1979,100100,"Tony Roche",6,4,10,60
1979,100105,"Allan Stone",4,4,8,50
1979,100109,"Jun Kuki",1,2,3,33.333333333333336
1979,100113,"Jan Kodes",16,16,32,50
1979,100115,"Jaime Fillol",21,28,49,42.857142857142854
1979,100116,"Sherwood Stewart",11,25,36,30.555555555555557
1979,100118,"Ivan Molina",11,15,26,42.30769230769231
1979,100119,"Ilie Nastase",28,25,53,52.83018867924528
1979,100121,"Raymond Moore",20,27,47,42.5531914893617
1979,100123,"Patrick Hombergen",1,1,2,50
1979,100126,"Stan Smith",43,19,62,69.35483870967742
1979,100127,"Tom Gorman",31,25,56,55.357142857142854
1979,100129,"Jean Baptiste Chanfreau",1,2,3,33.333333333333336
1979,100130,"Vladimir Zednik",1,7,8,12.5
1979,100135,"Onny Parun",3,15,18,16.666666666666668
1979,100137,"Hans Jurgen Pohmann",1,1,2,50
1979,100141,"Zeljko Franulovic",21,24,45,46.666666666666664
1979,100144,"Robert Lutz",25,15,40,62.5
1979,100146,"Jun Kamiwazumi",3,1,4,75
1979,100148,"Ismail El Shafei",8,11,19,42.10526315789474
1979,100155,"Ramiro Benavides",4,9,13,30.76923076923077
1979,100158,"John Bartlett",1,3,4,25
1979,100160,"Georges Goven",8,11,19,42.10526315789474
1979,100161,"Jurgen Fassbender",4,5,9,44.44444444444444
1979,100162,"Brian Fairlie",2,5,7,28.571428571428573
1979,100163,"Tom Leonard",2,7,9,22.22222222222222
1979,100166,"Gene Stuart Malin",7,13,20,35
1979,100171,"John Yuill",7,13,20,35
1979,100173,"Andrew Pattison",26,24,50,52
1979,100174,"Manuel Orantes",34,23,57,59.64912280701754
1979,100175,"Zan Guerry",1,3,4,25
1979,100176,"Hans Kary",9,13,22,40.90909090909091
1979,100177,"Pavel Hutka",5,11,16,31.25
1979,100178,"Bob Giltinan",2,4,6,33.333333333333336
1979,100179,"Karl Meiler",8,9,17,47.05882352941177
1979,100185,"Patrick Proisy",14,13,27,51.851851851851855
1979,100186,"Jeff Borowiak",5,13,18,27.77777777777778
1979,100197,"Alejandro Pierola",4,8,12,33.333333333333336
1979,100198,"Alvaro Betancur",1,1,2,50
1979,100199,"Patrice Dominguez",17,14,31,54.83870967741935
1979,100200,"Antonio Zugarelli",6,14,20,30
1979,100201,"Syd Ball",3,5,8,37.5
1979,100202,"George Amaya",1,2,3,33.333333333333336
1979,100203,"Phil Dent",28,23,51,54.90196078431372
1979,100207,"Noel Phillips",5,12,17,29.41176470588235
1979,100210,"Steve Docherty",7,12,19,36.8421052631579
1979,100211,"Louk Sanders",11,16,27,40.74074074074074
1979,100214,"Adriano Panatta",28,20,48,58.333333333333336
1979,100215,"Fred Mcnair",3,12,15,20
1979,100216,"Charles Owens",1,7,8,12.5
1979,100219,"Geoff Masters",21,23,44,47.72727272727273
1979,100220,"Jiri Hrebec",7,13,20,35
1979,100221,"Carlos Kirmayr",24,19,43,55.81395348837209
1979,100224,"Peter Campbell",1,7,8,12.5
1979,100227,"Alvin Gardiner",4,21,25,16
1979,100228,"Kjell Johansson",4,8,12,33.333333333333336
1979,100229,"Dick Stockton",20,21,41,48.78048780487805
1979,100230,"Welry Fritz",1,3,4,25
1979,100231,"Erik Van Dillen",7,12,19,36.8421052631579
1979,100232,"Eddie Dibbs",64,23,87,73.5632183908046
1979,100233,"Ricardo Cano",5,12,17,29.41176470588235
1979,100235,"Antonio Munoz",4,13,17,23.529411764705884
1979,100236,"John James",19,22,41,46.34146341463415
1979,100238,"Rick Fisher",6,12,18,33.333333333333336
1979,100240,"Joao Soares",4,9,13,30.76923076923077
1979,100241,"Joel Bailey",2,8,10,20
1979,100243,"Steve Krulevitz",6,13,19,31.57894736842105
1979,100244,"John Alexander",43,28,71,60.563380281690144
1979,100249,"Paolo Bertolucci",8,10,18,44.44444444444444
1979,100252,"Tim Gullikson",44,26,70,62.857142857142854
1979,100253,"Tom Gullikson",19,27,46,41.30434782608695
1979,100255,"Roscoe Tanner",61,19,80,76.25
1979,100257,"Ross Case",24,26,50,48
1979,100258,"Jorge Andrew",3,24,27,11.11111111111111
1979,100259,"Peter Feigl",26,22,48,54.166666666666664
1979,100261,"Brian Gottfried",54,23,77,70.12987012987013
1979,100265,"Cliff Letcher",5,10,15,33.333333333333336
1979,100266,"John Feaver",2,9,11,18.181818181818183
1979,100270,"Anand Amritraj",7,13,20,35
1979,100271,"Jean Francois Caujolle",14,12,26,53.84615384615385
1979,100272,"Sandy Mayer",15,12,27,55.55555555555556
1979,100273,"Kim Warwick",37,27,64,57.8125
1979,100274,"Eric Deblicker",9,11,20,45
1979,100276,"Terry Moor",35,26,61,57.377049180327866
1979,100279,"Mike Cahill",18,25,43,41.86046511627907
1979,100280,"Wojtek Fibak",59,22,81,72.8395061728395
1979,100281,"Sashi Menon",6,15,21,28.571428571428573
1979,100282,"Guillermo Vilas",70,22,92,76.08695652173913
1979,100284,"Jimmy Connors",79,13,92,85.8695652173913
1979,100285,"Rod Frawley",11,15,26,42.30769230769231
1979,100286,"Harold Solomon",65,23,88,73.86363636363636
1979,100287,"Robin Drysdale",3,11,14,21.428571428571427
1979,100288,"Tenny Svensson",2,9,11,18.181818181818183
1979,100289,"Byron Bertram",1,2,3,33.333333333333336
1979,100292,"Alvaro Fillol",4,11,15,26.666666666666668
1979,100293,"John Marks",4,26,30,13.333333333333334
1979,100294,"Rejean Genois",1,8,9,11.11111111111111
1979,100296,"Chris Gunning",3,5,8,37.5
1979,100297,"Corrado Barazzutti",39,23,62,62.903225806451616
1979,100298,"George Hardie",11,19,30,36.666666666666664
1979,100300,"Jose Higueras",61,22,83,73.49397590361446
1979,100301,"Jim Delaney",2,9,11,18.181818181818183
1979,100308,"Robert Trogolo",2,1,3,66.66666666666667
1979,100309,"Raul Ramirez",32,25,57,56.14035087719298
1979,100313,"Keith Richardson",7,16,23,30.434782608695652
1979,100314,"Bernard Fritz",3,9,12,25
1979,100315,"Hank Pfister",33,27,60,55
1979,100318,"Roger Guedes",4,9,13,30.76923076923077
1979,100319,"Rick Fagel",7,19,26,26.923076923076923
1979,100321,"Vijay Amritraj",34,23,57,59.64912280701754
1979,100322,"Emilio Montano",8,12,20,40
1979,100325,"Ulrich Pinner",27,12,39,69.23076923076923
1979,100326,"Russell Simpson",9,17,26,34.61538461538461
1979,100327,"Willem Prinsloo",1,9,10,10
1979,100330,"David Imonitie",2,1,3,66.66666666666667
1979,100331,"Jean Louis Haillet",15,12,27,55.55555555555556
1979,100332,"Balazs Taroczy",41,22,63,65.07936507936508
1979,100333,"Shigeyuki Nishio",2,2,4,50
1979,100334,"Ernie Ewert",3,5,8,37.5
1979,100337,"Mark Edmondson",26,26,52,50
1979,100339,"Victor Amaya",44,24,68,64.70588235294117
1979,100342,"Vitas Gerulaitis",71,22,93,76.34408602150538
1979,100343,"John Lloyd",12,22,34,35.294117647058826
1979,100344,"Eric Friedler",5,7,12,41.666666666666664
1979,100345,"Pat Dupre",47,30,77,61.03896103896104
1979,100346,"Paul Kronk",10,20,30,33.333333333333336
1979,100353,"Bruce Kleege",4,11,15,26.666666666666668
1979,100354,"Bernard Mitton",29,26,55,52.72727272727273
1979,100355,"Victor Eke",1,3,4,25
1979,100356,"Paul Mcnamee",13,13,26,50
1979,100357,"Bhanu Nunna",1,2,3,33.333333333333336
1979,100359,"Richard Lewis",9,8,17,52.94117647058823
1979,100360,"Brian Teacher",19,18,37,51.351351351351354
1979,100362,"Peter Fleming",45,26,71,63.38028169014085
1979,100363,"Jiri Granat",3,4,7,42.857142857142854
1979,100364,"Jonathan Smith",1,3,4,25
1979,100367,"Belus Prajoux",1,5,6,16.666666666666668
1979,100368,"Haroon Ismail",4,14,18,22.22222222222222
1979,100369,"Herve Gauvain",1,3,4,25
1979,100372,"Trey Waltke",6,15,21,28.571428571428573
1979,100374,"Javier Soler",3,8,11,27.272727272727273
1979,100375,"John Hayes",1,1,2,50
1979,100376,"Buster C Mottram",34,21,55,61.81818181818182
1979,100377,"Colin Dowdeswell",12,16,28,42.857142857142854
1979,100378,"David Schneider",14,28,42,33.333333333333336
1979,100380,"Butch Walts",40,22,62,64.51612903225806
1979,100382,"Chris Kachel",11,13,24,45.833333333333336
1979,100383,"Peter Mcnamara",39,25,64,60.9375
1979,100384,"Alejandro Cortes",5,6,11,45.45454545454545
1979,100387,"Jiri Prucha",1,2,3,33.333333333333336
1979,100388,"Peter Pearson",2,1,3,66.66666666666667
1979,100392,"Richard Meyer",8,14,22,36.36363636363637
1979,100394,"Angel Gimenez",8,21,29,27.586206896551722
1979,100395,"Victor Pecci",56,19,75,74.66666666666667
1979,100397,"Terry Rocavert",9,14,23,39.130434782608695
1979,100400,"Hubertus Hoyt",1,5,6,16.666666666666668
1979,100402,"Francisco Gonzalez",21,26,47,44.680851063829785
1979,100403,"Rolf Gehring",16,15,31,51.61290322580645
1979,100407,"Dale Collings",6,13,19,31.57894736842105
1979,100409,"Randy Crawford",4,13,17,23.529411764705884
1979,100410,"Tim Garcia",1,9,10,10
1979,100411,"Pavel Slozil",19,18,37,51.351351351351354
1979,100412,"Bruce Nichols",1,5,6,16.666666666666668
1979,100413,"Ulrich Marten",2,5,7,28.571428571428573
1979,100415,"Michael Grant",5,9,14,35.714285714285715
1979,100416,"Bill Maze",7,8,15,46.666666666666664
1979,100417,"Hans Gildemeister",30,12,42,71.42857142857143
1979,100421,"Jan Norback",6,13,19,31.57894736842105
1979,100422,"Bruce Manson",24,27,51,47.05882352941177
1979,100428,"Gene Mayer",54,25,79,68.35443037974683
1979,100429,"Miguel Mir",1,6,7,14.285714285714286
1979,100430,"David Carter",8,16,24,33.333333333333336
1979,100434,"Tomas Smid",50,25,75,66.66666666666667
1979,100436,"Nick Saviano",24,26,50,48
1979,100437,"Bjorn Borg",82,7,89,92.13483146067416
1979,100438,"Carlos Gattiker",1,7,8,12.5
1979,100440,"Eddie Edwards",2,3,5,40
1979,100443,"Christophe Freyss",10,15,25,40
1979,100444,"Werner Zirngibl",8,12,20,40
1979,100445,"Steve Denton",2,7,9,22.22222222222222
1979,100446,"John Sadri",29,24,53,54.716981132075475
1979,100447,"Juan Nunez",3,5,8,37.5
1979,100448,"Bruce Foxworth",1,1,2,50
1979,100449,"Stanislav Birner",7,8,15,46.666666666666664
1979,100450,"Leo Palin",5,8,13,38.46153846153846
1979,100451,"Tony Graham",4,6,10,40
1979,100452,"Bill Scanlon",27,19,46,58.69565217391305
1979,100453,"Jose Luis Damiani",3,12,15,20
1979,100456,"Ferdi Taygan",22,26,48,45.833333333333336
1979,100460,"Jose Lopez Maeso",1,5,6,16.666666666666668
1979,100461,"Billy Martin",14,14,28,50
1979,100464,"Warren Maher",7,10,17,41.1764705882353
1979,100465,"Mike Shore",2,4,6,33.333333333333336
1979,100467,"Mark Turpin",1,6,7,14.285714285714286
1979,100468,"Dominique Bedel",9,9,18,50
1979,100469,"Ashok Amritraj",1,2,3,33.333333333333336
1979,100473,"Glenn Petrovic",1,1,2,50
1979,100474,"Chris Lewis",10,18,28,35.714285714285715
1979,100475,"Matt Mitchell",9,17,26,34.61538461538461
1979,100477,"Gianni Ocleppo",14,10,24,58.333333333333336
1979,100479,"Reinhart Probst",5,4,9,55.55555555555556
1979,100481,"Roberto Vizcaino",1,2,3,33.333333333333336
1979,100486,"Christophe Roger Vasselin",5,15,20,25
1979,100488,"Chris Delaney",9,6,15,60
1979,100489,"Larry Stefanki",1,1,2,50
1979,100492,"John Austin",2,7,9,22.22222222222222
1979,100498,"Klaus Eberhard",9,10,19,47.36842105263158
1979,100502,"Vincent Van Patten",19,12,31,61.29032258064516
1979,100506,"Howard Schoenfield",2,10,12,16.666666666666668
1979,100510,"Franco Merlone",1,1,2,50
1979,100515,"Shlomo Glickstein",4,5,9,44.44444444444444
1979,100516,"Andrew Jarrett",7,11,18,38.888888888888886
1979,100518,"Ricardo Acuna",3,2,5,60
1979,100523,"Erick Iskersky",1,9,10,10
1979,100525,"Gilles Moretton",7,10,17,41.1764705882353
1979,100526,"Ricardo Ycaza",5,13,18,27.77777777777778
1979,100529,"Kevin Curren",7,14,21,33.333333333333336
1979,100530,"Andreas Maurer",11,14,25,44
1979,100532,"Johan Kriek",33,22,55,60
1979,100536,"Fernando Luna",5,9,14,35.714285714285715
1979,100543,"Peter Elter",12,16,28,42.857142857142854
1979,100545,"Deon Joubert",12,22,34,35.294117647058826
1979,100546,"Eric Fromm",2,9,11,18.181818181818183
1979,100550,"Brad Guan",1,1,2,50
1979,100551,"Brad Drewett",21,21,42,50
1979,100555,"Jose Luis Clerc",56,23,79,70.88607594936708
1979,100557,"Jai Dilouie",2,4,6,33.333333333333336
1979,100565,"Lloyd Bourne",1,3,4,25
1979,100569,"Toru Yonezawa",1,1,2,50
1979,100574,"Peter Rennert",5,6,11,45.45454545454545
1979,100577,"Rory Chappell",2,2,4,50
1979,100579,"Heinz Gunthardt",30,23,53,56.60377358490566
1979,100581,"John McEnroe",88,14,102,86.27450980392157
1979,100585,"Van Winitsky",6,14,20,30
1979,100586,"Eliot Teltscher",42,25,67,62.6865671641791
1979,100592,"Robert Vant Hof",1,4,5,20
1979,100597,"Jay Lapidus",6,6,12,50
1979,100598,"Wolfgang Popp",4,6,10,40
1979,100599,"Bernard Boileau",3,2,5,60
1979,100600,"Pascal Portes",19,18,37,51.351351351351354
1979,100603,"Roland Stadler",1,2,3,33.333333333333336
1979,100605,"Charlie Fancutt",3,5,8,37.5
1979,100611,"Mel Purcell",2,4,6,33.333333333333336
1979,100616,"Andy Kohlberg",1,7,8,12.5
1979,100631,"Tim Wilkison",26,26,52,50
1979,100638,"David Mustard",1,1,2,50
1979,100640,"Stefan Simonsson",8,8,16,50
1979,100652,"Cassio Motta",4,8,12,33.333333333333336
1979,100653,"Andres Gomez",11,8,19,57.89473684210526
1979,100655,"Fritz Buehning",12,12,24,50
1979,100656,"Ivan Lendl",35,17,52,67.3076923076923
1979,100661,"Damir Keretic",1,2,3,33.333333333333336
1979,100667,"Per Hjertquist",9,6,15,60
1979,100676,"Yannick Noah",34,14,48,70.83333333333333
1979,100692,"Greg Amaya",1,2,3,33.333333333333336
1979,100700,"Heinz Gildemeister",1,2,3,33.333333333333336
1979,100711,"Pedro Rebolledo",3,2,5,60
1979,100713,"John Fitzgerald",1,4,5,20
1979,100726,"Greg Whitecross",2,4,6,33.333333333333336
1979,100727,"Raul Antonio Viver",3,1,4,75
1979,100735,"Stevenson Clarke",2,1,3,66.66666666666667
1979,100749,"Dave Siegler",2,3,5,40
1979,100752,"Ramesh Krishnan",9,13,22,40.90909090909091
1979,100762,"Freddie Sauer",1,1,2,50
1979,100764,"Gabriel Urpi",5,5,10,50
1979,100821,"Hans Simonsson",1,2,3,33.333333333333336
1979,100829,"Jan Gunnarsson",1,4,5,20
1979,100868,"Craig A Miller",1,1,2,50
1979,100962,"Thomas Hogstedt",1,1,2,50
1979,106621,"Bidynt Goswami",1,1,2,50
1979,106651,"Brad Rowe",1,1,2,50
1979,106715,"Chaim Arlozorov",1,1,2,50
1979,107000,"Fernando Dalla Fontana",2,8,10,20
1979,107379,"John Chris Lewis",3,6,9,33.333333333333336
1979,107381,"John Eagleton",1,1,2,50
1979,107398,"John Trickey",1,2,3,33.333333333333336
1979,107544,"Larry Loeb",1,1,2,50
1979,107621,"Manuel Diaz",1,1,2,50
1979,107729,"Massimo Rivaroli",1,2,3,33.333333333333336
1979,107761,"Max Wunschig",1,3,4,25
1979,107809,"Mike Harrington",3,2,5,60
1979,107850,"Nial Brash",1,2,3,33.333333333333336
1979,107864,"Nobuya Tamura",1,1,2,50
1979,108162,"Roland Steigler",1,2,3,33.333333333333336
1979,108368,"Tetsu Kuramitsu",1,1,2,50
1979,108453,"Ulf Eriksson",3,6,9,33.333333333333336
1979,108501,"Warrick Jones",1,1,2,50
1979,109771,"Jairo Velasco",10,10,20,50
1979,110454,"Jose Andrade",1,1,2,50
1979,130938,"John Austin",4,9,13,30.76923076923077
1980,100016,"Ken Rosewall",3,3,6,50
1980,100055,"Cliff Drysdale",1,2,3,33.333333333333336
1980,100060,"Marty Riessen",10,13,23,43.47826086956522
1980,100069,"Dennis Ralston",3,2,5,60
1980,100073,"Mark Cox",11,13,24,45.833333333333336
1980,100084,"Tom Okker",11,13,24,45.833333333333336
1980,100090,"Dick Crealy",3,2,5,60
1980,100091,"Colin Dibley",18,24,42,42.857142857142854
1980,100099,"Thomaz Koch",7,9,16,43.75
1980,100100,"Tony Roche",3,2,5,60
1980,100113,"Jan Kodes",5,14,19,26.31578947368421
1980,100114,"Ray Ruffels",1,1,2,50
1980,100115,"Jaime Fillol",10,23,33,30.303030303030305
1980,100116,"Sherwood Stewart",15,18,33,45.45454545454545
1980,100119,"Ilie Nastase",19,24,43,44.18604651162791
1980,100121,"Raymond Moore",15,21,36,41.666666666666664
1980,100126,"Stan Smith",32,20,52,61.53846153846154
1980,100127,"Tom Gorman",6,13,19,31.57894736842105
1980,100135,"Onny Parun",15,19,34,44.11764705882353
1980,100141,"Zeljko Franulovic",21,20,41,51.21951219512195
1980,100142,"Peter Szoke",1,1,2,50
1980,100144,"Robert Lutz",38,18,56,67.85714285714286
1980,100146,"Jun Kamiwazumi",2,2,4,50
1980,100148,"Ismail El Shafei",3,6,9,33.333333333333336
1980,100152,"David Lloyd",2,1,3,66.66666666666667
1980,100155,"Ramiro Benavides",5,9,14,35.714285714285715
1980,100160,"Georges Goven",1,8,9,11.11111111111111
1980,100163,"Tom Leonard",6,6,12,50
1980,100166,"Gene Stuart Malin",3,10,13,23.076923076923077
1980,100171,"John Yuill",5,12,17,29.41176470588235
1980,100173,"Andrew Pattison",23,24,47,48.93617021276596
1980,100174,"Manuel Orantes",15,9,24,62.5
1980,100175,"Zan Guerry",1,2,3,33.333333333333336
1980,100176,"Hans Kary",8,10,18,44.44444444444444
1980,100177,"Pavel Hutka",6,9,15,40
1980,100182,"Mike Estep",1,2,3,33.333333333333336
1980,100185,"Patrick Proisy",11,16,27,40.74074074074074
1980,100186,"Jeff Borowiak",5,5,10,50
1980,100197,"Alejandro Pierola",2,12,14,14.285714285714286
1980,100198,"Alvaro Betancur",6,15,21,28.571428571428573
1980,100199,"Patrice Dominguez",9,11,20,45
1980,100200,"Antonio Zugarelli",5,8,13,38.46153846153846
1980,100201,"Syd Ball",12,14,26,46.15384615384615
1980,100202,"George Amaya",1,2,3,33.333333333333336
1980,100203,"Phil Dent",29,20,49,59.183673469387756
1980,100210,"Steve Docherty",7,10,17,41.1764705882353
1980,100211,"Louk Sanders",13,15,28,46.42857142857143
1980,100214,"Adriano Panatta",29,15,44,65.9090909090909
1980,100215,"Fred Mcnair",1,8,9,11.11111111111111
1980,100216,"Charles Owens",3,9,12,25
1980,100219,"Geoff Masters",13,29,42,30.952380952380953
1980,100220,"Jiri Hrebec",8,12,20,40
1980,100221,"Carlos Kirmayr",18,13,31,58.064516129032256
1980,100224,"Peter Campbell",2,3,5,40
1980,100227,"Alvin Gardiner",2,5,7,28.571428571428573
1980,100228,"Kjell Johansson",11,12,23,47.82608695652174
1980,100229,"Dick Stockton",11,16,27,40.74074074074074
1980,100230,"Welry Fritz",5,6,11,45.45454545454545
1980,100231,"Erik Van Dillen",8,17,25,32
1980,100232,"Eddie Dibbs",50,21,71,70.4225352112676
1980,100233,"Ricardo Cano",3,9,12,25
1980,100235,"Antonio Munoz",1,2,3,33.333333333333336
1980,100236,"John James",12,26,38,31.57894736842105
1980,100238,"Rick Fisher",6,11,17,35.294117647058826
1980,100240,"Joao Soares",5,15,20,25
1980,100241,"Joel Bailey",4,7,11,36.36363636363637
1980,100243,"Steve Krulevitz",19,23,42,45.23809523809524
1980,100244,"John Alexander",11,20,31,35.483870967741936
1980,100249,"Paolo Bertolucci",16,13,29,55.172413793103445
1980,100252,"Tim Gullikson",29,25,54,53.7037037037037
1980,100253,"Tom Gullikson",16,21,37,43.24324324324324
1980,100255,"Roscoe Tanner",42,16,58,72.41379310344827
1980,100257,"Ross Case",11,21,32,34.375
1980,100259,"Peter Feigl",26,21,47,55.319148936170215
1980,100261,"Brian Gottfried",68,23,91,74.72527472527473
1980,100265,"Cliff Letcher",6,10,16,37.5
1980,100266,"John Feaver",1,11,12,8.333333333333334
1980,100268,"Denis Naegelen",2,3,5,40
1980,100270,"Anand Amritraj",6,10,16,37.5
1980,100271,"Jean Francois Caujolle",10,14,24,41.666666666666664
1980,100272,"Sandy Mayer",17,18,35,48.57142857142857
1980,100273,"Kim Warwick",40,25,65,61.53846153846154
1980,100274,"Eric Deblicker",3,8,11,27.272727272727273
1980,100276,"Terry Moor",35,26,61,57.377049180327866
1980,100279,"Mike Cahill",11,19,30,36.666666666666664
1980,100280,"Wojtek Fibak",59,25,84,70.23809523809524
1980,100281,"Sashi Menon",15,19,34,44.11764705882353
1980,100282,"Guillermo Vilas",67,18,85,78.82352941176471
1980,100284,"Jimmy Connors",73,15,88,82.95454545454545
1980,100285,"Rod Frawley",29,25,54,53.7037037037037
1980,100286,"Harold Solomon",65,23,88,73.86363636363636
1980,100287,"Robin Drysdale",3,5,8,37.5
1980,100288,"Tenny Svensson",5,4,9,55.55555555555556
1980,100289,"Byron Bertram",7,15,22,31.818181818181817
1980,100292,"Alvaro Fillol",6,10,16,37.5
1980,100293,"John Marks",2,3,5,40
1980,100297,"Corrado Barazzutti",33,17,50,66
1980,100298,"George Hardie",18,29,47,38.297872340425535
1980,100300,"Jose Higueras",17,14,31,54.83870967741935
1980,100301,"Jim Delaney",2,5,7,28.571428571428573
1980,100308,"Robert Trogolo",7,13,20,35
1980,100309,"Raul Ramirez",29,19,48,60.416666666666664
1980,100314,"Bernard Fritz",5,12,17,29.41176470588235
1980,100315,"Hank Pfister",22,25,47,46.808510638297875
1980,100319,"Rick Fagel",9,17,26,34.61538461538461
1980,100321,"Vijay Amritraj",49,24,73,67.12328767123287
1980,100322,"Emilio Montano",1,10,11,9.090909090909092
1980,100324,"John Whitlinger",3,5,8,37.5
1980,100325,"Ulrich Pinner",5,13,18,27.77777777777778
1980,100326,"Russell Simpson",20,22,42,47.61904761904762
1980,100328,"Rand Evett",2,2,4,50
1980,100331,"Jean Louis Haillet",3,7,10,30
1980,100332,"Balazs Taroczy",46,16,62,74.19354838709677
1980,100333,"Shigeyuki Nishio",1,1,2,50
1980,100334,"Ernie Ewert",3,4,7,42.857142857142854
1980,100336,"Guillermo Aubone",2,11,13,15.384615384615385
1980,100337,"Mark Edmondson",19,23,42,45.23809523809524
1980,100339,"Victor Amaya",39,21,60,65
1980,100342,"Vitas Gerulaitis",51,18,69,73.91304347826087
1980,100343,"John Lloyd",3,11,14,21.428571428571427
1980,100344,"Eric Friedler",2,2,4,50
1980,100345,"Pat Dupre",18,17,35,51.42857142857143
1980,100346,"Paul Kronk",15,19,34,44.11764705882353
1980,100353,"Bruce Kleege",2,7,9,22.22222222222222
1980,100354,"Bernard Mitton",28,29,57,49.12280701754386
1980,100356,"Paul Mcnamee",45,30,75,60
1980,100359,"Richard Lewis",1,9,10,10
1980,100360,"Brian Teacher",63,26,89,70.78651685393258
1980,100361,"Willie Davies",1,1,2,50
1980,100362,"Peter Fleming",21,19,40,52.5
1980,100363,"Jiri Granat",1,1,2,50
1980,100364,"Jonathan Smith",4,5,9,44.44444444444444
1980,100367,"Belus Prajoux",8,14,22,36.36363636363637
1980,100368,"Haroon Ismail",8,9,17,47.05882352941177
1980,100372,"Trey Waltke",27,22,49,55.10204081632653
1980,100374,"Javier Soler",1,1,2,50
1980,100375,"John Hayes",7,7,14,50
1980,100376,"Buster C Mottram",25,18,43,58.13953488372093
1980,100377,"Colin Dowdeswell",1,14,15,6.666666666666667
1980,100380,"Butch Walts",22,23,45,48.888888888888886
1980,100382,"Chris Kachel",2,13,15,13.333333333333334
1980,100383,"Peter Mcnamara",40,23,63,63.492063492063494
1980,100384,"Alejandro Cortes",5,10,15,33.333333333333336
1980,100385,"Filip Krajcik",1,4,5,20
1980,100392,"Richard Meyer",12,14,26,46.15384615384615
1980,100393,"Marcos Hocevar",13,9,22,59.09090909090909
1980,100394,"Angel Gimenez",17,14,31,54.83870967741935
1980,100395,"Victor Pecci",37,20,57,64.91228070175438
1980,100397,"Terry Rocavert",14,21,35,40
1980,100398,"Julio Goes",1,2,3,33.333333333333336
1980,100401,"Sean Sorensen",2,9,11,18.181818181818183
1980,100402,"Francisco Gonzalez",12,20,32,37.5
1980,100403,"Rolf Gehring",23,18,41,56.09756097560975
1980,100405,"Fernando Maynetto",5,6,11,45.45454545454545
1980,100406,"Greg Halder",1,3,4,25
1980,100407,"Dale Collings",6,7,13,46.15384615384615
1980,100409,"Randy Crawford",2,1,3,66.66666666666667
1980,100410,"Tim Garcia",1,7,8,12.5
1980,100411,"Pavel Slozil",10,10,20,50
1980,100412,"Bruce Nichols",1,4,5,20
1980,100413,"Ulrich Marten",8,13,21,38.095238095238095
1980,100415,"Michael Grant",10,19,29,34.48275862068966
1980,100416,"Bill Maze",3,11,14,21.428571428571427
1980,100417,"Hans Gildemeister",23,15,38,60.526315789473685
1980,100421,"Jan Norback",8,11,19,42.10526315789474
1980,100422,"Bruce Manson",24,25,49,48.97959183673469
1980,100428,"Gene Mayer",72,16,88,81.81818181818181
1980,100429,"Miguel Mir",1,8,9,11.11111111111111
1980,100430,"David Carter",16,23,39,41.02564102564103
1980,100434,"Tomas Smid",45,21,66,68.18181818181819
1980,100435,"Regis Brunet",1,2,3,33.333333333333336
1980,100436,"Nick Saviano",19,24,43,44.18604651162791
1980,100437,"Bjorn Borg",68,7,75,90.66666666666667
1980,100438,"Carlos Gattiker",1,13,14,7.142857142857143
1980,100440,"Eddie Edwards",7,9,16,43.75
1980,100443,"Christophe Freyss",19,19,38,50
1980,100444,"Werner Zirngibl",4,8,12,33.333333333333336
1980,100446,"John Sadri",47,25,72,65.27777777777777
1980,100447,"Juan Nunez",4,4,8,50
1980,100448,"Bruce Foxworth",2,3,5,40
1980,100449,"Stanislav Birner",12,22,34,35.294117647058826
1980,100450,"Leo Palin",6,15,21,28.571428571428573
1980,100451,"Tony Graham",4,13,17,23.529411764705884
1980,100452,"Bill Scanlon",37,29,66,56.06060606060606
1980,100453,"Jose Luis Damiani",8,7,15,53.333333333333336
1980,100455,"Tony Lloyd",2,1,3,66.66666666666667
1980,100456,"Ferdi Taygan",23,29,52,44.23076923076923
1980,100460,"Jose Lopez Maeso",5,5,10,50
1980,100461,"Billy Martin",16,24,40,40
1980,100464,"Warren Maher",6,17,23,26.08695652173913
1980,100465,"Mike Shore",1,5,6,16.666666666666668
1980,100468,"Dominique Bedel",13,19,32,40.625
1980,100474,"Chris Lewis",24,24,48,50
1980,100475,"Matt Mitchell",5,13,18,27.77777777777778
1980,100477,"Gianni Ocleppo",19,18,37,51.351351351351354
1980,100479,"Reinhart Probst",2,1,3,66.66666666666667
1980,100481,"Roberto Vizcaino",9,13,22,40.90909090909091
1980,100483,"Christophe Casa",7,15,22,31.818181818181817
1980,100485,"Tsuyoshi Fukui",2,2,4,50
1980,100486,"Christophe Roger Vasselin",19,13,32,59.375
1980,100488,"Chris Delaney",15,22,37,40.54054054054054
1980,100492,"John Austin",12,13,25,48
1980,100495,"Wayne Hampson",5,6,11,45.45454545454545
1980,100497,"Markus Gunthardt",1,8,9,11.11111111111111
1980,100498,"Klaus Eberhard",11,14,25,44
1980,100499,"Chris Mayotte",14,19,33,42.42424242424242
1980,100500,"Rohun Beven",1,4,5,20
1980,100501,"Gregoire Rafaitin",1,4,5,20
1980,100502,"Vincent Van Patten",23,21,44,52.27272727272727
1980,100505,"Famiano Meneschincheri",2,3,5,40
1980,100506,"Howard Schoenfield",7,11,18,38.888888888888886
1980,100510,"Franco Merlone",3,2,5,60
1980,100515,"Shlomo Glickstein",37,30,67,55.223880597014926
1980,100516,"Andrew Jarrett",2,8,10,20
1980,100517,"Matt Doyle",1,3,4,25
1980,100518,"Ricardo Acuna",2,3,5,40
1980,100519,"Scott Mccain",1,2,3,33.333333333333336
1980,100525,"Gilles Moretton",8,16,24,33.333333333333336
1980,100526,"Ricardo Ycaza",15,14,29,51.724137931034484
1980,100529,"Kevin Curren",16,13,29,55.172413793103445
1980,100530,"Andreas Maurer",5,10,15,33.333333333333336
1980,100532,"Johan Kriek",39,24,63,61.904761904761905
1980,100535,"Tony Giammalva",13,12,25,52
1980,100536,"Fernando Luna",19,13,32,59.375
1980,100543,"Peter Elter",14,13,27,51.851851851851855
1980,100545,"Deon Joubert",7,12,19,36.8421052631579
1980,100546,"Eric Fromm",4,7,11,36.36363636363637
1980,100551,"Brad Drewett",16,22,38,42.10526315789474
1980,100555,"Jose Luis Clerc",69,22,91,75.82417582417582
1980,100557,"Jai Dilouie",1,1,2,50
1980,100562,"Tom Cain",4,9,13,30.76923076923077
1980,100564,"Cary Stansbury",1,4,5,20
1980,100565,"Lloyd Bourne",1,2,3,33.333333333333336
1980,100567,"Chip Hooper",1,2,3,33.333333333333336
1980,100572,"Ney Keller",1,1,2,50
1980,100574,"Peter Rennert",18,16,34,52.94117647058823
1980,100577,"Rory Chappell",1,2,3,33.333333333333336
1980,100579,"Heinz Gunthardt",37,21,58,63.793103448275865
1980,100581,"John McEnroe",83,17,100,83
1980,100584,"Peter Lamb",1,2,3,33.333333333333336
1980,100585,"Van Winitsky",14,18,32,43.75
1980,100586,"Eliot Teltscher",72,27,99,72.72727272727273
1980,100592,"Robert Vant Hof",13,14,27,48.148148148148145
1980,100596,"Bill Cowan",1,1,2,50
1980,100597,"Jay Lapidus",2,7,9,22.22222222222222
1980,100598,"Wolfgang Popp",8,11,19,42.10526315789474
1980,100599,"Bernard Boileau",3,6,9,33.333333333333336
1980,100600,"Pascal Portes",26,25,51,50.98039215686274
1980,100603,"Roland Stadler",6,4,10,60
1980,100605,"Charlie Fancutt",1,5,6,16.666666666666668
1980,100608,"John Benson",1,3,4,25
1980,100611,"Mel Purcell",20,13,33,60.60606060606061
1980,100616,"Andy Kohlberg",3,7,10,30
1980,100630,"Gustavo Guerrero",3,4,7,42.857142857142854
1980,100631,"Tim Wilkison",24,25,49,48.97959183673469
1980,100639,"Blaine Willenborg",3,6,9,33.333333333333336
1980,100640,"Stefan Simonsson",12,20,32,37.5
1980,100653,"Andres Gomez",36,24,60,60
1980,100655,"Fritz Buehning",27,26,53,50.943396226415096
1980,100656,"Ivan Lendl",104,28,132,78.78787878787878
1980,100659,"Helmar Stiegler",1,7,8,12.5
1980,100661,"Damir Keretic",3,7,10,30
1980,100663,"Marcel Freeman",1,6,7,14.285714285714286
1980,100667,"Per Hjertquist",21,16,37,56.75675675675676
1980,100676,"Yannick Noah",29,16,45,64.44444444444444
1980,100678,"Bill Gilmour",1,2,3,33.333333333333336
1980,100682,"Ernie Fernandez",1,3,4,25
1980,100689,"Tim Mayotte",4,4,8,50
1980,100690,"Marco Armellini",2,1,3,66.66666666666667
1980,100699,"Chris Johnstone",4,9,13,30.76923076923077
1980,100700,"Heinz Gildemeister",5,4,9,55.55555555555556
1980,100701,"Marko Ostoja",4,7,11,36.36363636363637
1980,100704,"Billy Nealon",1,4,5,20
1980,100711,"Pedro Rebolledo",4,2,6,66.66666666666667
1980,100712,"Tres Cushing",1,1,2,50
1980,100713,"John Fitzgerald",4,8,12,33.333333333333336
1980,100726,"Greg Whitecross",2,10,12,16.666666666666668
1980,100730,"Florin Segarceanu",1,3,4,25
1980,100744,"Peter Doohan",1,2,3,33.333333333333336
1980,100752,"Ramesh Krishnan",17,13,30,56.666666666666664
1980,100753,"Juan Carlos Ayala",1,1,2,50
1980,100757,"Anders Jarryd",1,1,2,50
1980,100764,"Gabriel Urpi",7,8,15,46.666666666666664
1980,100765,"Rodney Harmon",2,3,5,40
1980,100768,"Nick Brown",1,1,2,50
1980,100769,"Mario Martinez",21,10,31,67.74193548387096
1980,100772,"Kelly Evernden",1,1,2,50
1980,100781,"Bernhard Pils",1,3,4,25
1980,100782,"Pablo Arraya",1,2,3,33.333333333333336
1980,100803,"Stefan Svensson",1,2,3,33.333333333333336
1980,100821,"Hans Simonsson",5,7,12,41.666666666666664
1980,100829,"Jan Gunnarsson",1,5,6,16.666666666666668
1980,100844,"Jerome Potier",2,3,5,40
1980,100866,"Shahar Perkiss",1,1,2,50
1980,100868,"Craig A Miller",1,2,3,33.333333333333336
1980,100878,"Christoph Zipf",2,3,5,40
1980,100905,"Sammy Giammalva Jr",7,4,11,63.63636363636363
1980,100923,"Wally Masur",1,1,2,50
1980,100942,"Thierry Tulasne",9,13,22,40.90909090909091
1980,101061,"Jimmy Arias",3,5,8,37.5
1980,101062,"Mats Wilander",1,4,5,20
1980,106531,"Andrei Dirzu",2,1,3,66.66666666666667
1980,106629,"Birger Andersson",3,2,5,60
1980,106662,"Brian Benson",1,1,2,50
1980,106892,"Donald Watt",2,1,3,66.66666666666667
1980,106911,"Eddie Myers",1,1,2,50
1980,106913,"Edgar Schurmann",1,2,3,33.333333333333336
1980,106962,"Ernesto Vazquez",1,1,2,50
1980,107328,"Jeremy Cohen",2,4,6,33.333333333333336
1980,107391,"John Muller",1,1,2,50
1980,107463,"Juan Torralbo",1,1,2,50
1980,107527,"Konstantin Pugayev",3,1,4,75
1980,107557,"Lawrence Hall",2,1,3,66.66666666666667
1980,107649,"Marco Alciati",2,5,7,28.571428571428573
1980,107699,"Mark Lewis",1,1,2,50
1980,107761,"Max Wunschig",1,1,2,50
1980,107981,"Peter Hampton",1,1,2,50
1980,107997,"Phil Davies",1,2,3,33.333333333333336
1980,108096,"Rick Rozen",1,1,2,50
1980,108162,"Roland Steigler",1,1,2,50
1980,108304,"Stephen Myers",1,1,2,50
1980,108335,"Supoj Meesawad",1,1,2,50
1980,108385,"Thomas Emmrich",1,1,2,50
1980,108398,"Tim Clements",1,1,2,50
1980,108453,"Ulf Eriksson",1,1,2,50
1980,108459,"Vadim Borisov",4,1,5,80
1980,108505,"Wayne Pascoe",4,6,10,40
1980,109771,"Jairo Velasco",11,13,24,45.833333333333336
1980,109870,"Gary Penberthy",1,1,2,50
1980,110164,"Max Franklin",1,1,2,50
1980,110243,"X Zhao",1,1,2,50
1980,130938,"John Austin",2,4,6,33.333333333333336
1980,202950,"Michael Appleton",1,1,2,50
1980,208995,"S Fine",1,1,2,50
1980,208996,"A Galbraith",1,1,2,50
1981,100017,"Mal Anderson",1,1,2,50
1981,100060,"Marty Riessen",1,4,5,20
1981,100084,"Tom Okker",1,5,6,16.666666666666668
1981,100090,"Dick Crealy",1,1,2,50
1981,100091,"Colin Dibley",3,7,10,30
1981,100109,"Jun Kuki",2,1,3,66.66666666666667
1981,100113,"Jan Kodes",1,7,8,12.5
1981,100115,"Jaime Fillol",18,19,37,48.648648648648646
1981,100116,"Sherwood Stewart",4,14,18,22.22222222222222
1981,100119,"Ilie Nastase",26,27,53,49.056603773584904
1981,100121,"Raymond Moore",8,14,22,36.36363636363637
1981,100126,"Stan Smith",28,18,46,60.869565217391305
1981,100135,"Onny Parun",5,13,18,27.77777777777778
1981,100141,"Zeljko Franulovic",7,9,16,43.75
1981,100144,"Robert Lutz",11,17,28,39.285714285714285
1981,100148,"Ismail El Shafei",3,4,7,42.857142857142854
1981,100155,"Ramiro Benavides",4,7,11,36.36363636363637
1981,100163,"Tom Leonard",2,1,3,66.66666666666667
1981,100173,"Andrew Pattison",15,20,35,42.857142857142854
1981,100174,"Manuel Orantes",29,18,47,61.702127659574465
1981,100176,"Hans Kary",5,10,15,33.333333333333336
1981,100177,"Pavel Hutka",3,6,9,33.333333333333336
1981,100179,"Karl Meiler",3,6,9,33.333333333333336
1981,100182,"Mike Estep",4,12,16,25
1981,100185,"Patrick Proisy",3,6,9,33.333333333333336
1981,100186,"Jeff Borowiak",18,19,37,48.648648648648646
1981,100197,"Alejandro Pierola",3,6,9,33.333333333333336
1981,100198,"Alvaro Betancur",1,1,2,50
1981,100199,"Patrice Dominguez",2,2,4,50
1981,100200,"Antonio Zugarelli",2,4,6,33.333333333333336
1981,100201,"Syd Ball",8,12,20,40
1981,100203,"Phil Dent",26,21,47,55.319148936170215
1981,100210,"Steve Docherty",1,5,6,16.666666666666668
1981,100211,"Louk Sanders",4,13,17,23.529411764705884
1981,100214,"Adriano Panatta",18,14,32,56.25
1981,100215,"Fred Mcnair",1,1,2,50
1981,100216,"Charles Owens",1,1,2,50
1981,100220,"Jiri Hrebec",3,9,12,25
1981,100221,"Carlos Kirmayr",27,16,43,62.7906976744186
1981,100223,"Jeff Simpson",1,2,3,33.333333333333336
1981,100228,"Kjell Johansson",9,11,20,45
1981,100229,"Dick Stockton",14,15,29,48.275862068965516
1981,100231,"Erik Van Dillen",7,8,15,46.666666666666664
1981,100232,"Eddie Dibbs",38,15,53,71.69811320754717
1981,100233,"Ricardo Cano",33,24,57,57.89473684210526
1981,100236,"John James",3,4,7,42.857142857142854
1981,100240,"Joao Soares",1,9,10,10
1981,100241,"Joel Bailey",1,4,5,20
1981,100243,"Steve Krulevitz",14,13,27,51.851851851851855
1981,100244,"John Alexander",23,21,44,52.27272727272727
1981,100249,"Paolo Bertolucci",9,12,21,42.857142857142854
1981,100252,"Tim Gullikson",29,24,53,54.716981132075475
1981,100253,"Tom Gullikson",24,21,45,53.333333333333336
1981,100255,"Roscoe Tanner",51,22,73,69.86301369863014
1981,100257,"Ross Case",5,15,20,25
1981,100259,"Peter Feigl",9,19,28,32.142857142857146
1981,100261,"Brian Gottfried",47,22,69,68.1159420289855
1981,100265,"Cliff Letcher",4,7,11,36.36363636363637
1981,100266,"John Feaver",2,8,10,20
1981,100270,"Anand Amritraj",4,11,15,26.666666666666668
1981,100271,"Jean Francois Caujolle",3,8,11,27.272727272727273
1981,100272,"Sandy Mayer",43,17,60,71.66666666666667
1981,100273,"Kim Warwick",6,12,18,33.333333333333336
1981,100274,"Eric Deblicker",5,7,12,41.666666666666664
1981,100276,"Terry Moor",26,25,51,50.98039215686274
1981,100279,"Mike Cahill",6,10,16,37.5
1981,100280,"Wojtek Fibak",42,20,62,67.74193548387096
1981,100281,"Sashi Menon",3,14,17,17.647058823529413
1981,100282,"Guillermo Vilas",65,17,82,79.26829268292683
1981,100284,"Jimmy Connors",59,12,71,83.09859154929578
1981,100285,"Rod Frawley",20,24,44,45.45454545454545
1981,100286,"Harold Solomon",30,22,52,57.69230769230769
1981,100287,"Robin Drysdale",1,5,6,16.666666666666668
1981,100291,"Ian Harris",1,1,2,50
1981,100292,"Alvaro Fillol",2,9,11,18.181818181818183
1981,100297,"Corrado Barazzutti",17,17,34,50
1981,100298,"George Hardie",4,7,11,36.36363636363637
1981,100300,"Jose Higueras",35,23,58,60.3448275862069
1981,100301,"Jim Delaney",11,21,32,34.375
1981,100307,"Paul Torre",10,9,19,52.63157894736842
1981,100309,"Raul Ramirez",23,17,40,57.5
1981,100314,"Bernard Fritz",8,11,19,42.10526315789474
1981,100315,"Hank Pfister",37,21,58,63.793103448275865
1981,100319,"Rick Fagel",11,19,30,36.666666666666664
1981,100321,"Vijay Amritraj",27,19,46,58.69565217391305
1981,100325,"Ulrich Pinner",10,8,18,55.55555555555556
1981,100326,"Russell Simpson",15,20,35,42.857142857142854
1981,100332,"Balazs Taroczy",45,17,62,72.58064516129032
1981,100333,"Shigeyuki Nishio",1,1,2,50
1981,100336,"Guillermo Aubone",8,17,25,32
1981,100337,"Mark Edmondson",59,26,85,69.41176470588235
1981,100339,"Victor Amaya",11,13,24,45.833333333333336
1981,100342,"Vitas Gerulaitis",44,19,63,69.84126984126983
1981,100343,"John Lloyd",6,8,14,42.857142857142854
1981,100345,"Pat Dupre",26,22,48,54.166666666666664
1981,100346,"Paul Kronk",15,21,36,41.666666666666664
1981,100349,"Glen Holroyd",4,9,13,30.76923076923077
1981,100351,"Freddie De Jesus",2,1,3,66.66666666666667
1981,100354,"Bernard Mitton",13,19,32,40.625
1981,100356,"Paul Mcnamee",16,13,29,55.172413793103445
1981,100358,"Mike Fishbach",1,4,5,20
1981,100359,"Richard Lewis",6,8,14,42.857142857142854
1981,100360,"Brian Teacher",30,15,45,66.66666666666667
1981,100362,"Peter Fleming",9,13,22,40.90909090909091
1981,100363,"Jiri Granat",6,7,13,46.15384615384615
1981,100364,"Jonathan Smith",9,13,22,40.90909090909091
1981,100367,"Belus Prajoux",6,11,17,35.294117647058826
1981,100368,"Haroon Ismail",5,7,12,41.666666666666664
1981,100372,"Trey Waltke",13,24,37,35.13513513513514
1981,100375,"John Hayes",6,14,20,30
1981,100376,"Buster C Mottram",13,13,26,50
1981,100378,"David Schneider",2,7,9,22.22222222222222
1981,100379,"Craig Edwards",2,4,6,33.333333333333336
1981,100380,"Butch Walts",15,17,32,46.875
1981,100383,"Peter Mcnamara",43,13,56,76.78571428571429
1981,100384,"Alejandro Cortes",4,9,13,30.76923076923077
1981,100387,"Jiri Prucha",1,1,2,50
1981,100390,"Trevor Allan",1,1,2,50
1981,100392,"Richard Meyer",11,22,33,33.333333333333336
1981,100393,"Marcos Hocevar",11,19,30,36.666666666666664
1981,100394,"Angel Gimenez",26,26,52,50
1981,100395,"Victor Pecci",48,20,68,70.58823529411765
1981,100402,"Francisco Gonzalez",12,15,27,44.44444444444444
1981,100403,"Rolf Gehring",22,19,41,53.65853658536585
1981,100407,"Dale Collings",4,7,11,36.36363636363637
1981,100411,"Pavel Slozil",18,16,34,52.94117647058823
1981,100416,"Bill Maze",1,2,3,33.333333333333336
1981,100417,"Hans Gildemeister",21,11,32,65.625
1981,100421,"Jan Norback",7,19,26,26.923076923076923
1981,100422,"Bruce Manson",24,22,46,52.17391304347826
1981,100426,"Hans Peter Kandler",1,5,6,16.666666666666668
1981,100428,"Gene Mayer",37,8,45,82.22222222222223
1981,100430,"David Carter",16,19,35,45.714285714285715
1981,100431,"Mansour Bahrami",1,1,2,50
1981,100434,"Tomas Smid",54,28,82,65.85365853658537
1981,100435,"Regis Brunet",1,1,2,50
1981,100436,"Nick Saviano",26,28,54,48.148148148148145
1981,100437,"Bjorn Borg",35,6,41,85.36585365853658
1981,100440,"Eddie Edwards",10,19,29,34.48275862068966
1981,100443,"Christophe Freyss",7,20,27,25.925925925925927
1981,100444,"Werner Zirngibl",3,2,5,60
1981,100445,"Steve Denton",20,17,37,54.054054054054056
1981,100446,"John Sadri",22,21,43,51.16279069767442
1981,100447,"Juan Nunez",3,9,12,25
1981,100449,"Stanislav Birner",11,14,25,44
1981,100450,"Leo Palin",6,7,13,46.15384615384615
1981,100451,"Tony Graham",9,12,21,42.857142857142854
1981,100452,"Bill Scanlon",34,21,55,61.81818181818182
1981,100453,"Jose Luis Damiani",21,15,36,58.333333333333336
1981,100456,"Ferdi Taygan",8,24,32,25
1981,100460,"Jose Lopez Maeso",19,19,38,50
1981,100461,"Billy Martin",10,15,25,40
1981,100463,"Ben Mckown",4,7,11,36.36363636363637
1981,100464,"Warren Maher",2,4,6,33.333333333333336
1981,100468,"Dominique Bedel",7,18,25,28
1981,100471,"Mark Vines",7,4,11,63.63636363636363
1981,100472,"Craig Wittus",7,13,20,35
1981,100474,"Chris Lewis",41,23,64,64.0625
1981,100475,"Matt Mitchell",2,4,6,33.333333333333336
1981,100477,"Gianni Ocleppo",11,12,23,47.82608695652174
1981,100481,"Roberto Vizcaino",3,7,10,30
1981,100483,"Christophe Casa",2,6,8,25
1981,100485,"Tsuyoshi Fukui",2,2,4,50
1981,100486,"Christophe Roger Vasselin",14,22,36,38.888888888888886
1981,100488,"Chris Delaney",2,5,7,28.571428571428573
1981,100489,"Larry Stefanki",12,18,30,40
1981,100490,"Jaroslav Navratil",3,2,5,60
1981,100492,"John Austin",16,13,29,55.172413793103445
1981,100495,"Wayne Hampson",2,7,9,22.22222222222222
1981,100496,"Charles Buzz Strode",1,5,6,16.666666666666668
1981,100498,"Klaus Eberhard",15,17,32,46.875
1981,100499,"Chris Mayotte",15,24,39,38.46153846153846
1981,100501,"Gregoire Rafaitin",2,1,3,66.66666666666667
1981,100502,"Vincent Van Patten",13,11,24,54.166666666666664
1981,100512,"Robert Reininger",5,7,12,41.666666666666664
1981,100515,"Shlomo Glickstein",42,24,66,63.63636363636363
1981,100517,"Matt Doyle",8,9,17,47.05882352941177
1981,100518,"Ricardo Acuna",2,9,11,18.181818181818183
1981,100519,"Scott Mccain",6,11,17,35.294117647058826
1981,100522,"Chris Dunk",8,11,19,42.10526315789474
1981,100523,"Erick Iskersky",4,5,9,44.44444444444444
1981,100525,"Gilles Moretton",18,16,34,52.94117647058823
1981,100526,"Ricardo Ycaza",19,16,35,54.285714285714285
1981,100529,"Kevin Curren",23,18,41,56.09756097560975
1981,100530,"Andreas Maurer",8,9,17,47.05882352941177
1981,100532,"Johan Kriek",38,15,53,71.69811320754717
1981,100533,"Paul Avis",1,3,4,25
1981,100534,"Steve Meister",4,12,16,25
1981,100535,"Tony Giammalva",17,21,38,44.73684210526316
1981,100536,"Fernando Luna",17,15,32,53.125
1981,100538,"Alejandro Gattiker",1,3,4,25
1981,100540,"Drew Gitlin",4,8,12,33.333333333333336
1981,100543,"Peter Elter",9,9,18,50
1981,100545,"Deon Joubert",3,4,7,42.857142857142854
1981,100546,"Eric Fromm",4,15,19,21.05263157894737
1981,100550,"Brad Guan",3,8,11,27.272727272727273
1981,100551,"Brad Drewett",15,22,37,40.54054054054054
1981,100553,"Nduka Odizor",3,3,6,50
1981,100554,"Matthew McDonald",1,2,3,33.333333333333336
1981,100555,"Jose Luis Clerc",54,12,66,81.81818181818181
1981,100559,"Mike Gandolfo",1,1,2,50
1981,100562,"Tom Cain",2,5,7,28.571428571428573
1981,100565,"Lloyd Bourne",6,13,19,31.57894736842105
1981,100566,"Hitoshi Shirato",1,1,2,50
1981,100567,"Chip Hooper",2,4,6,33.333333333333336
1981,100570,"Marty Davis",14,18,32,43.75
1981,100573,"Ron Hightower",4,12,16,25
1981,100574,"Peter Rennert",10,14,24,41.666666666666664
1981,100577,"Rory Chappell",2,4,6,33.333333333333336
1981,100579,"Heinz Gunthardt",28,22,50,56
1981,100581,"John McEnroe",69,9,78,88.46153846153847
1981,100585,"Van Winitsky",16,12,28,57.142857142857146
1981,100586,"Eliot Teltscher",54,18,72,75
1981,100589,"Harald Theissen",2,2,4,50
1981,100592,"Robert Vant Hof",16,20,36,44.44444444444444
1981,100597,"Jay Lapidus",9,12,21,42.857142857142854
1981,100598,"Wolfgang Popp",1,10,11,9.090909090909092
1981,100599,"Bernard Boileau",4,8,12,33.333333333333336
1981,100600,"Pascal Portes",19,23,42,45.23809523809524
1981,100603,"Roland Stadler",8,13,21,38.095238095238095
1981,100605,"Charlie Fancutt",8,9,17,47.05882352941177
1981,100606,"Mike Bauer",2,5,7,28.571428571428573
1981,100607,"Eduardo Bengoechea",5,16,21,23.80952380952381
1981,100608,"John Benson",1,5,6,16.666666666666668
1981,100611,"Mel Purcell",48,20,68,70.58823529411765
1981,100615,"Gianluca Rinaldini",1,7,8,12.5
1981,100630,"Gustavo Guerrero",1,9,10,10
1981,100631,"Tim Wilkison",23,24,47,48.93617021276596
1981,100635,"Mark Dickson",1,3,4,25
1981,100636,"Gustavo Tiberti",1,6,7,14.285714285714286
1981,100640,"Stefan Simonsson",5,10,15,33.333333333333336
1981,100646,"Claudio Panatta",7,6,13,53.84615384615385
1981,100649,"David Dowlen",2,5,7,28.571428571428573
1981,100651,"Alejandro Ganzabal",3,4,7,42.857142857142854
1981,100652,"Cassio Motta",1,3,4,25
1981,100653,"Andres Gomez",36,21,57,63.1578947368421
1981,100655,"Fritz Buehning",24,20,44,54.54545454545455
1981,100656,"Ivan Lendl",95,12,107,88.78504672897196
1981,100657,"Mike Leach",2,3,5,40
1981,100661,"Damir Keretic",3,6,9,33.333333333333336
1981,100663,"Marcel Freeman",1,3,4,25
1981,100667,"Per Hjertquist",16,21,37,43.24324324324324
1981,100673,"Robbie Venter",3,4,7,42.857142857142854
1981,100676,"Yannick Noah",51,18,69,73.91304347826087
1981,100677,"Bob Blazekovic",1,1,2,50
1981,100681,"Morris Skip Strode",1,4,5,20
1981,100682,"Ernie Fernandez",2,2,4,50
1981,100689,"Tim Mayotte",31,16,47,65.95744680851064
1981,100699,"Chris Johnstone",11,15,26,42.30769230769231
1981,100700,"Heinz Gildemeister",2,2,4,50
1981,100701,"Marko Ostoja",14,20,34,41.1764705882353
1981,100711,"Pedro Rebolledo",23,14,37,62.16216216216216
1981,100713,"John Fitzgerald",26,24,50,52
1981,100715,"Jim Gurfein",9,14,23,39.130434782608695
1981,100726,"Greg Whitecross",2,6,8,25
1981,100730,"Florin Segarceanu",3,1,4,75
1981,100738,"Schalk Van Der Merwe",1,1,2,50
1981,100749,"Dave Siegler",6,9,15,40
1981,100752,"Ramesh Krishnan",18,19,37,48.648648648648646
1981,100757,"Anders Jarryd",11,12,23,47.82608695652174
1981,100759,"Danie Visser",1,2,3,33.333333333333336
1981,100762,"Freddie Sauer",2,1,3,66.66666666666667
1981,100763,"Brad Gilbert",5,5,10,50
1981,100764,"Gabriel Urpi",11,20,31,35.483870967741936
1981,100765,"Rodney Harmon",3,2,5,60
1981,100769,"Mario Martinez",27,20,47,57.4468085106383
1981,100775,"Tian C Viljoen",3,2,5,60
1981,100781,"Bernhard Pils",1,4,5,20
1981,100782,"Pablo Arraya",6,11,17,35.294117647058826
1981,100789,"Ivan Dupasquier",10,9,19,52.63157894736842
1981,100797,"Ben Testerman",6,9,15,40
1981,100799,"Carlos Castellan",7,9,16,43.75
1981,100800,"Diego Perez",16,15,31,51.61290322580645
1981,100809,"Juan Aguilera",2,3,5,40
1981,100821,"Hans Simonsson",8,17,25,32
1981,100828,"John Davis",1,1,2,50
1981,100829,"Jan Gunnarsson",4,6,10,40
1981,100835,"Hans Dieter Beutel",5,7,12,41.666666666666664
1981,100837,"Jeremy Bates",1,1,2,50
1981,100844,"Jerome Potier",7,11,18,38.888888888888886
1981,100855,"Scott Davis",4,7,11,36.36363636363637
1981,100857,"Sergio Casal",3,3,6,50
1981,100868,"Craig A Miller",2,6,8,25
1981,100878,"Christoph Zipf",5,9,14,35.714285714285715
1981,100893,"Joakim Nystrom",13,12,25,52
1981,100894,"Francesco Cancellotti",1,2,3,33.333333333333336
1981,100905,"Sammy Giammalva Jr",25,23,48,52.083333333333336
1981,100921,"Patrice Kuchna",1,2,3,33.333333333333336
1981,100922,"Roberto Arguello",1,2,3,33.333333333333336
1981,100923,"Wally Masur",3,4,7,42.857142857142854
1981,100928,"Barry Moir",1,1,2,50
1981,100936,"Henri Leconte",3,6,9,33.333333333333336
1981,100942,"Thierry Tulasne",26,23,49,53.06122448979592
1981,100962,"Thomas Hogstedt",1,1,2,50
1981,100993,"Loic Courteau",1,3,4,25
1981,101046,"Eric Wilborts",3,6,9,33.333333333333336
1981,101053,"Michael Kures",1,1,2,50
1981,101061,"Jimmy Arias",10,10,20,50
1981,101062,"Mats Wilander",13,10,23,56.52173913043478
1981,101131,"Jimmy Brown",2,4,6,33.333333333333336
1981,101138,"Pat Cash",2,5,7,28.571428571428573
1981,106447,"Adolfo Gonzalez",3,1,4,75
1981,106531,"Andrei Dirzu",1,1,2,50
1981,106588,"Arthur Anastopoulo",1,1,2,50
1981,106610,"Beejong Sisson",3,4,7,42.857142857142854
1981,106638,"Bob Weise W055",1,2,3,33.333333333333336
1981,106641,"Bobby Webb",1,2,3,33.333333333333336
1981,106642,"Bojidar Pampoulov",2,1,3,66.66666666666667
1981,106780,"Cliff Skakle",1,1,2,50
1981,106835,"David Egdes",1,1,2,50
1981,106929,"Eiji Takeuchi",1,2,3,33.333333333333336
1981,106983,"Fabrizio Fanucci",1,1,2,50
1981,107000,"Fernando Dalla Fontana",6,9,15,40
1981,107024,"Francisco Ferrer",1,1,2,50
1981,107078,"George Rudman",1,1,2,50
1981,107168,"Hans Hansson",1,3,4,25
1981,107285,"Janos Guti",1,1,2,50
1981,107298,"Javier Restrepo",1,2,3,33.333333333333336
1981,107318,"Jeff Davis",1,1,2,50
1981,107563,"Leon Naude",1,1,2,50
1981,107621,"Manuel Diaz",1,1,2,50
1981,107649,"Marco Alciati",1,1,2,50
1981,107699,"Mark Lewis",1,1,2,50
1981,107761,"Max Wunschig",1,1,2,50
1981,108053,"Ray Kelly",1,1,2,50
1981,108253,"Shinichi Sakamoto",1,1,2,50
1981,108345,"Taisen Kanai",1,1,2,50
1981,108377,"Thierry Stevaux",2,2,4,50
1981,108385,"Thomas Emmrich",1,1,2,50
1981,108494,"Walter Redondo",3,5,8,37.5
1981,108505,"Wayne Pascoe",4,8,12,33.333333333333336
1981,109771,"Jairo Velasco",1,4,5,20
1981,110064,"U Hoigshoidt",1,2,3,33.333333333333336
1981,110231,"Hachiro Shibata",1,1,2,50
1981,110233,"Kunio Tsukamoto",1,1,2,50
1981,130938,"John Austin",4,5,9,44.44444444444444
1982,100099,"Thomaz Koch",1,5,6,16.666666666666668
1982,100109,"Jun Kuki",1,1,2,50
1982,100115,"Jaime Fillol",14,8,22,63.63636363636363
1982,100116,"Sherwood Stewart",1,2,3,33.333333333333336
1982,100119,"Ilie Nastase",14,24,38,36.8421052631579
1982,100121,"Raymond Moore",1,3,4,25
1982,100126,"Stan Smith",8,11,19,42.10526315789474
1982,100141,"Zeljko Franulovic",3,6,9,33.333333333333336
1982,100144,"Robert Lutz",10,15,25,40
1982,100148,"Ismail El Shafei",1,2,3,33.333333333333336
1982,100155,"Ramiro Benavides",2,6,8,25
1982,100160,"Georges Goven",6,16,22,27.272727272727273
1982,100163,"Tom Leonard",1,1,2,50
1982,100173,"Andrew Pattison",5,13,18,27.77777777777778
1982,100174,"Manuel Orantes",17,9,26,65.38461538461539
1982,100175,"Zan Guerry",1,1,2,50
1982,100179,"Karl Meiler",5,9,14,35.714285714285715
1982,100182,"Mike Estep",11,15,26,42.30769230769231
1982,100186,"Jeff Borowiak",21,20,41,51.21951219512195
1982,100197,"Alejandro Pierola",2,7,9,22.22222222222222
1982,100200,"Antonio Zugarelli",3,5,8,37.5
1982,100201,"Syd Ball",1,4,5,20
1982,100203,"Phil Dent",17,19,36,47.22222222222222
1982,100214,"Adriano Panatta",11,15,26,42.30769230769231
1982,100221,"Carlos Kirmayr",24,23,47,51.06382978723404
1982,100223,"Jeff Simpson",1,8,9,11.11111111111111
1982,100228,"Kjell Johansson",3,5,8,37.5
1982,100229,"Dick Stockton",8,18,26,30.76923076923077
1982,100232,"Eddie Dibbs",26,18,44,59.09090909090909
1982,100233,"Ricardo Cano",4,12,16,25
1982,100236,"John James",4,3,7,57.142857142857146
1982,100240,"Joao Soares",11,20,31,35.483870967741936
1982,100243,"Steve Krulevitz",7,21,28,25
1982,100244,"John Alexander",38,21,59,64.40677966101696
1982,100249,"Paolo Bertolucci",3,5,8,37.5
1982,100252,"Tim Gullikson",17,25,42,40.476190476190474
1982,100253,"Tom Gullikson",20,18,38,52.63157894736842
1982,100255,"Roscoe Tanner",20,17,37,54.054054054054056
1982,100257,"Ross Case",1,5,6,16.666666666666668
1982,100259,"Peter Feigl",11,11,22,50
1982,100261,"Brian Gottfried",43,22,65,66.15384615384616
1982,100265,"Cliff Letcher",2,11,13,15.384615384615385
1982,100270,"Anand Amritraj",1,2,3,33.333333333333336
1982,100271,"Jean Francois Caujolle",1,2,3,33.333333333333336
1982,100272,"Sandy Mayer",38,19,57,66.66666666666667
1982,100273,"Kim Warwick",15,16,31,48.38709677419355
1982,100276,"Terry Moor",18,22,40,45
1982,100279,"Mike Cahill",12,14,26,46.15384615384615
1982,100280,"Wojtek Fibak",52,26,78,66.66666666666667
1982,100281,"Sashi Menon",6,7,13,46.15384615384615
1982,100282,"Guillermo Vilas",74,16,90,82.22222222222223
1982,100284,"Jimmy Connors",78,11,89,87.64044943820225
1982,100285,"Rod Frawley",22,23,45,48.888888888888886
1982,100286,"Harold Solomon",22,23,45,48.888888888888886
1982,100297,"Corrado Barazzutti",20,22,42,47.61904761904762
1982,100300,"Jose Higueras",55,24,79,69.62025316455696
1982,100301,"Jim Delaney",3,7,10,30
1982,100307,"Paul Torre",5,9,14,35.714285714285715
1982,100309,"Raul Ramirez",28,13,41,68.29268292682927
1982,100310,"Mike Myburg",6,9,15,40
1982,100314,"Bernard Fritz",16,16,32,50
1982,100315,"Hank Pfister",35,21,56,62.5
1982,100316,"Scott Carnahan",1,1,2,50
1982,100321,"Vijay Amritraj",12,12,24,50
1982,100323,"Givaldo Barbosa",1,3,4,25
1982,100325,"Ulrich Pinner",9,11,20,45
1982,100326,"Russell Simpson",19,18,37,51.351351351351354
1982,100328,"Rand Evett",2,7,9,22.22222222222222
1982,100331,"Jean Louis Haillet",1,3,4,25
1982,100332,"Balazs Taroczy",43,24,67,64.17910447761194
1982,100336,"Guillermo Aubone",2,5,7,28.571428571428573
1982,100337,"Mark Edmondson",29,26,55,52.72727272727273
1982,100339,"Victor Amaya",14,17,31,45.16129032258065
1982,100342,"Vitas Gerulaitis",61,15,76,80.26315789473684
1982,100343,"John Lloyd",8,15,23,34.78260869565217
1982,100345,"Pat Dupre",17,22,39,43.58974358974359
1982,100346,"Paul Kronk",1,5,6,16.666666666666668
1982,100349,"Glen Holroyd",1,7,8,12.5
1982,100353,"Bruce Kleege",3,7,10,30
1982,100354,"Bernard Mitton",8,11,19,42.10526315789474
1982,100356,"Paul Mcnamee",24,16,40,60
1982,100359,"Richard Lewis",6,13,19,31.57894736842105
1982,100360,"Brian Teacher",42,20,62,67.74193548387096
1982,100362,"Peter Fleming",2,6,8,25
1982,100363,"Jiri Granat",5,14,19,26.31578947368421
1982,100364,"Jonathan Smith",10,16,26,38.46153846153846
1982,100367,"Belus Prajoux",2,2,4,50
1982,100368,"Haroon Ismail",3,14,17,17.647058823529413
1982,100369,"Herve Gauvain",1,1,2,50
1982,100372,"Trey Waltke",10,14,24,41.666666666666664
1982,100374,"Javier Soler",1,1,2,50
1982,100375,"John Hayes",2,4,6,33.333333333333336
1982,100376,"Buster C Mottram",28,16,44,63.63636363636363
1982,100377,"Colin Dowdeswell",2,4,6,33.333333333333336
1982,100378,"David Schneider",1,5,6,16.666666666666668
1982,100380,"Butch Walts",3,5,8,37.5
1982,100383,"Peter Mcnamara",41,22,63,65.07936507936508
1982,100384,"Alejandro Cortes",4,8,12,33.333333333333336
1982,100386,"Jose Garcia",8,13,21,38.095238095238095
1982,100390,"Trevor Allan",1,2,3,33.333333333333336
1982,100392,"Richard Meyer",6,9,15,40
1982,100393,"Marcos Hocevar",31,23,54,57.407407407407405
1982,100394,"Angel Gimenez",10,19,29,34.48275862068966
1982,100395,"Victor Pecci",19,19,38,50
1982,100398,"Julio Goes",3,12,15,20
1982,100402,"Francisco Gonzalez",14,19,33,42.42424242424242
1982,100403,"Rolf Gehring",3,23,26,11.538461538461538
1982,100407,"Dale Collings",2,4,6,33.333333333333336
1982,100411,"Pavel Slozil",19,18,37,51.351351351351354
1982,100417,"Hans Gildemeister",25,13,38,65.78947368421052
1982,100422,"Bruce Manson",21,28,49,42.857142857142854
1982,100425,"Junie Chatman",2,4,6,33.333333333333336
1982,100426,"Hans Peter Kandler",2,7,9,22.22222222222222
1982,100428,"Gene Mayer",37,12,49,75.51020408163265
1982,100429,"Miguel Mir",1,4,5,20
1982,100430,"David Carter",14,23,37,37.83783783783784
1982,100434,"Tomas Smid",62,28,90,68.88888888888889
1982,100436,"Nick Saviano",14,27,41,34.146341463414636
1982,100437,"Bjorn Borg",2,1,3,66.66666666666667
1982,100440,"Eddie Edwards",14,18,32,43.75
1982,100444,"Werner Zirngibl",1,4,5,20
1982,100445,"Steve Denton",43,24,67,64.17910447761194
1982,100446,"John Sadri",32,23,55,58.18181818181818
1982,100449,"Stanislav Birner",11,21,32,34.375
1982,100450,"Leo Palin",8,17,25,32
1982,100452,"Bill Scanlon",31,24,55,56.36363636363637
1982,100453,"Jose Luis Damiani",14,24,38,36.8421052631579
1982,100456,"Ferdi Taygan",3,7,10,30
1982,100460,"Jose Lopez Maeso",20,24,44,45.45454545454545
1982,100461,"Billy Martin",1,1,2,50
1982,100464,"Warren Maher",2,1,3,66.66666666666667
1982,100468,"Dominique Bedel",10,11,21,47.61904761904762
1982,100471,"Mark Vines",1,17,18,5.555555555555555
1982,100472,"Craig Wittus",8,12,20,40
1982,100474,"Chris Lewis",30,20,50,60
1982,100475,"Matt Mitchell",10,11,21,47.61904761904762
1982,100477,"Gianni Ocleppo",6,15,21,28.571428571428573
1982,100478,"Pascal Deniau",1,1,2,50
1982,100485,"Tsuyoshi Fukui",2,5,7,28.571428571428573
1982,100486,"Christophe Roger Vasselin",19,21,40,47.5
1982,100489,"Larry Stefanki",6,15,21,28.571428571428573
1982,100493,"Eric Sherbeck",3,2,5,60
1982,100495,"Wayne Hampson",3,8,11,27.272727272727273
1982,100496,"Charles Buzz Strode",3,6,9,33.333333333333336
1982,100497,"Markus Gunthardt",1,2,3,33.333333333333336
1982,100498,"Klaus Eberhard",8,12,20,40
1982,100499,"Chris Mayotte",5,10,15,33.333333333333336
1982,100501,"Gregoire Rafaitin",1,2,3,33.333333333333336
1982,100502,"Vincent Van Patten",18,21,39,46.15384615384615
1982,100512,"Robert Reininger",4,8,12,33.333333333333336
1982,100515,"Shlomo Glickstein",30,22,52,57.69230769230769
1982,100517,"Matt Doyle",11,17,28,39.285714285714285
1982,100518,"Ricardo Acuna",7,10,17,41.1764705882353
1982,100519,"Scott Mccain",3,10,13,23.076923076923077
1982,100522,"Chris Dunk",4,12,16,25
1982,100523,"Erick Iskersky",14,23,37,37.83783783783784
1982,100525,"Gilles Moretton",11,17,28,39.285714285714285
1982,100526,"Ricardo Ycaza",3,15,18,16.666666666666668
1982,100529,"Kevin Curren",33,17,50,66
1982,100530,"Andreas Maurer",7,13,20,35
1982,100532,"Johan Kriek",41,21,62,66.12903225806451
1982,100534,"Steve Meister",1,7,8,12.5
1982,100535,"Tony Giammalva",10,16,26,38.46153846153846
1982,100536,"Fernando Luna",23,19,42,54.76190476190476
1982,100537,"Mike Brunnberg",8,8,16,50
1982,100538,"Alejandro Gattiker",2,10,12,16.666666666666668
1982,100539,"Rick Meyers",1,1,2,50
1982,100540,"Drew Gitlin",12,13,25,48
1982,100543,"Peter Elter",18,19,37,48.648648648648646
1982,100546,"Eric Fromm",18,18,36,50
1982,100547,"Rocky Royer",3,6,9,33.333333333333336
1982,100550,"Brad Guan",4,6,10,40
1982,100551,"Brad Drewett",16,21,37,43.24324324324324
1982,100553,"Nduka Odizor",13,16,29,44.827586206896555
1982,100555,"Jose Luis Clerc",66,23,89,74.15730337078652
1982,100559,"Mike Gandolfo",2,3,5,40
1982,100562,"Tom Cain",13,14,27,48.148148148148145
1982,100564,"Cary Stansbury",1,1,2,50
1982,100565,"Lloyd Bourne",22,18,40,55
1982,100567,"Chip Hooper",34,24,58,58.62068965517241
1982,100569,"Toru Yonezawa",2,1,3,66.66666666666667
1982,100570,"Marty Davis",16,22,38,42.10526315789474
1982,100573,"Ron Hightower",3,5,8,37.5
1982,100574,"Peter Rennert",13,17,30,43.333333333333336
1982,100575,"Andy Andrews",11,16,27,40.74074074074074
1982,100579,"Heinz Gunthardt",26,25,51,50.98039215686274
1982,100581,"John McEnroe",64,10,74,86.48648648648648
1982,100585,"Van Winitsky",28,23,51,54.90196078431372
1982,100586,"Eliot Teltscher",41,20,61,67.21311475409836
1982,100588,"Pender Murphy",5,10,15,33.333333333333336
1982,100589,"Harald Theissen",4,9,13,30.76923076923077
1982,100592,"Robert Vant Hof",18,16,34,52.94117647058823
1982,100594,"Kevin Kerns",1,2,3,33.333333333333336
1982,100595,"Ronnie Bathman",1,1,2,50
1982,100597,"Jay Lapidus",26,17,43,60.46511627906977
1982,100598,"Wolfgang Popp",1,2,3,33.333333333333336
1982,100599,"Bernard Boileau",6,6,12,50
1982,100600,"Pascal Portes",11,18,29,37.93103448275862
1982,100603,"Roland Stadler",8,10,18,44.44444444444444
1982,100604,"Egan Adams",2,4,6,33.333333333333336
1982,100605,"Charlie Fancutt",3,5,8,37.5
1982,100606,"Mike Bauer",15,9,24,62.5
1982,100609,"Zoltan Kuharszky",18,21,39,46.15384615384615
1982,100611,"Mel Purcell",38,24,62,61.29032258064516
1982,100615,"Gianluca Rinaldini",7,9,16,43.75
1982,100616,"Andy Kohlberg",4,8,12,33.333333333333336
1982,100624,"Derek Tarr",3,10,13,23.076923076923077
1982,100631,"Tim Wilkison",28,22,50,56
1982,100635,"Mark Dickson",14,13,27,51.851851851851855
1982,100636,"Gustavo Tiberti",8,8,16,50
1982,100638,"David Mustard",2,5,7,28.571428571428573
1982,100640,"Stefan Simonsson",21,20,41,51.21951219512195
1982,100646,"Claudio Panatta",29,26,55,52.72727272727273
1982,100649,"David Dowlen",1,3,4,25
1982,100651,"Alejandro Ganzabal",15,17,32,46.875
1982,100652,"Cassio Motta",8,13,21,38.095238095238095
1982,100653,"Andres Gomez",51,25,76,67.10526315789474
1982,100655,"Fritz Buehning",24,27,51,47.05882352941177
1982,100656,"Ivan Lendl",104,8,112,92.85714285714286
1982,100657,"Mike Leach",9,13,22,40.90909090909091
1982,100661,"Damir Keretic",15,17,32,46.875
1982,100667,"Per Hjertquist",6,12,18,33.333333333333336
1982,100674,"Jeff Turpin",3,3,6,50
1982,100675,"John Mccurdy",1,2,3,33.333333333333336
1982,100676,"Yannick Noah",51,14,65,78.46153846153847
1982,100680,"Peter Johnston",1,3,4,25
1982,100681,"Morris Skip Strode",9,9,18,50
1982,100682,"Ernie Fernandez",1,1,2,50
1982,100689,"Tim Mayotte",33,22,55,60
1982,100699,"Chris Johnstone",15,18,33,45.45454545454545
1982,100700,"Heinz Gildemeister",1,1,2,50
1982,100701,"Marko Ostoja",14,21,35,40
1982,100710,"Phil Lehnhoff",1,1,2,50
1982,100711,"Pedro Rebolledo",9,13,22,40.90909090909091
1982,100713,"John Fitzgerald",22,22,44,50
1982,100714,"Broderick Dyke",7,8,15,46.666666666666664
1982,100715,"Jim Gurfein",9,11,20,45
1982,100719,"Juan Avendano",11,17,28,39.285714285714285
1982,100726,"Greg Whitecross",3,10,13,23.076923076923077
1982,100729,"Fernando Soler",1,2,3,33.333333333333336
1982,100730,"Florin Segarceanu",7,7,14,50
1982,100738,"Schalk Van Der Merwe",6,11,17,35.294117647058826
1982,100744,"Peter Doohan",3,3,6,50
1982,100749,"Dave Siegler",5,9,14,35.714285714285715
1982,100752,"Ramesh Krishnan",23,25,48,47.916666666666664
1982,100757,"Anders Jarryd",21,14,35,60
1982,100759,"Danie Visser",7,18,25,28
1982,100762,"Freddie Sauer",18,20,38,47.36842105263158
1982,100763,"Brad Gilbert",19,13,32,59.375
1982,100764,"Gabriel Urpi",3,7,10,30
1982,100765,"Rodney Harmon",9,5,14,64.28571428571429
1982,100769,"Mario Martinez",20,18,38,52.63157894736842
1982,100772,"Kelly Evernden",1,1,2,50
1982,100780,"Mike De Palmer",16,9,25,64
1982,100781,"Bernhard Pils",2,5,7,28.571428571428573
1982,100782,"Pablo Arraya",34,21,55,61.81818181818182
1982,100789,"Ivan Dupasquier",5,12,17,29.41176470588235
1982,100790,"Bruce Derlin",5,12,17,29.41176470588235
1982,100797,"Ben Testerman",4,7,11,36.36363636363637
1982,100799,"Carlos Castellan",7,10,17,41.1764705882353
1982,100800,"Diego Perez",11,16,27,40.74074074074074
1982,100809,"Juan Aguilera",4,9,13,30.76923076923077
1982,100815,"David Pate",2,5,7,28.571428571428573
1982,100821,"Hans Simonsson",14,11,25,56
1982,100829,"Jan Gunnarsson",9,12,21,42.857142857142854
1982,100835,"Hans Dieter Beutel",2,8,10,20
1982,100836,"Glenn Michibata",7,6,13,53.84615384615385
1982,100844,"Jerome Potier",5,15,20,25
1982,100848,"Alberto Tous",3,4,7,42.857142857142854
1982,100855,"Scott Davis",5,5,10,50
1982,100857,"Sergio Casal",3,9,12,25
1982,100864,"Martin Wostenholme",2,1,3,66.66666666666667
1982,100868,"Craig A Miller",11,11,22,50
1982,100878,"Christoph Zipf",2,7,9,22.22222222222222
1982,100887,"Eric Korita",2,1,3,66.66666666666667
1982,100893,"Joakim Nystrom",10,14,24,41.666666666666664
1982,100894,"Francesco Cancellotti",1,4,5,20
1982,100905,"Sammy Giammalva Jr",10,16,26,38.46153846153846
1982,100910,"Magnus Tideman",3,4,7,42.857142857142854
1982,100914,"Jean Marc Piacentile",1,2,3,33.333333333333336
1982,100923,"Wally Masur",6,8,14,42.857142857142854
1982,100924,"Jorge Lozano",1,1,2,50
1982,100934,"Matt Anger",4,6,10,40
1982,100936,"Henri Leconte",31,21,52,59.61538461538461
1982,100938,"Jaromir Becka",1,1,2,50
1982,100942,"Thierry Tulasne",18,22,40,45
1982,100962,"Thomas Hogstedt",9,10,19,47.36842105263158
1982,100993,"Loic Courteau",7,5,12,58.333333333333336
1982,101013,"Henrik Sundstrom",14,10,24,58.333333333333336
1982,101057,"Peter Carter",1,2,3,33.333333333333336
1982,101061,"Jimmy Arias",30,17,47,63.829787234042556
1982,101062,"Mats Wilander",58,17,75,77.33333333333333
1982,101073,"Martin Jaite",1,1,2,50
1982,101074,"Carlos Di Laura",1,1,2,50
1982,101084,"Jakob Hlasek",1,2,3,33.333333333333336
1982,101098,"Guy Forget",16,13,29,55.172413793103445
1982,101113,"Michael Westphal",4,6,10,40
1982,101131,"Jimmy Brown",15,17,32,46.875
1982,101138,"Pat Cash",17,10,27,62.96296296296296
1982,101145,"Jonathan Canter",3,5,8,37.5
1982,101154,"Simon Youl",1,3,4,25
1982,101158,"John Frawley",2,5,7,28.571428571428573
1982,101174,"Fernando Roese",1,1,2,50
1982,101216,"Olli Rahnasto",2,1,3,66.66666666666667
1982,102312,"Jairo Velasco Jr",1,1,2,50
1982,106684,"Carl Axel Hageskog",2,1,3,66.66666666666667
1982,106706,"Cary Leeds",1,5,6,16.666666666666668
1982,106758,"Christophe Lesage",1,1,2,50
1982,107049,"Gabriel Auroux",1,1,2,50
1982,107051,"Gabriel Mattos",1,1,2,50
1982,107298,"Javier Restrepo",2,3,5,40
1982,107357,"Joe Meyers",1,1,2,50
1982,107397,"John Stoddart",1,1,2,50
1982,107495,"Ken Barton",1,4,5,20
1982,107699,"Mark Lewis",1,2,3,33.333333333333336
1982,109771,"Jairo Velasco",4,4,8,50
1983,100099,"Thomaz Koch",1,1,2,50
1983,100115,"Jaime Fillol",14,16,30,46.666666666666664
1983,100119,"Ilie Nastase",6,11,17,35.294117647058826
1983,100126,"Stan Smith",4,11,15,26.666666666666668
1983,100144,"Robert Lutz",5,3,8,62.5
1983,100155,"Ramiro Benavides",2,2,4,50
1983,100160,"Georges Goven",6,7,13,46.15384615384615
1983,100174,"Manuel Orantes",17,17,34,50
1983,100179,"Karl Meiler",4,6,10,40
1983,100182,"Mike Estep",2,4,6,33.333333333333336
1983,100186,"Jeff Borowiak",13,19,32,40.625
1983,100214,"Adriano Panatta",2,6,8,25
1983,100221,"Carlos Kirmayr",4,14,18,22.22222222222222
1983,100223,"Jeff Simpson",2,3,5,40
1983,100229,"Dick Stockton",1,2,3,33.333333333333336
1983,100232,"Eddie Dibbs",16,10,26,61.53846153846154
1983,100233,"Ricardo Cano",4,6,10,40
1983,100240,"Joao Soares",4,12,16,25
1983,100244,"John Alexander",24,25,49,48.97959183673469
1983,100249,"Paolo Bertolucci",1,3,4,25
1983,100252,"Tim Gullikson",23,16,39,58.97435897435897
1983,100253,"Tom Gullikson",25,22,47,53.191489361702125
1983,100255,"Roscoe Tanner",16,13,29,55.172413793103445
1983,100257,"Ross Case",1,3,4,25
1983,100259,"Peter Feigl",6,7,13,46.15384615384615
1983,100261,"Brian Gottfried",31,19,50,62
1983,100272,"Sandy Mayer",33,17,50,66
1983,100273,"Kim Warwick",3,7,10,30
1983,100276,"Terry Moor",8,9,17,47.05882352941177
1983,100280,"Wojtek Fibak",27,23,50,54
1983,100281,"Sashi Menon",1,7,8,12.5
1983,100282,"Guillermo Vilas",51,17,68,75
1983,100284,"Jimmy Connors",52,11,63,82.53968253968254
1983,100285,"Rod Frawley",10,14,24,41.666666666666664
1983,100286,"Harold Solomon",5,17,22,22.727272727272727
1983,100292,"Alvaro Fillol",3,1,4,75
1983,100297,"Corrado Barazzutti",16,14,30,53.333333333333336
1983,100300,"Jose Higueras",49,14,63,77.77777777777777
1983,100309,"Raul Ramirez",11,5,16,68.75
1983,100310,"Mike Myburg",3,6,9,33.333333333333336
1983,100314,"Bernard Fritz",10,14,24,41.666666666666664
1983,100315,"Hank Pfister",19,17,36,52.77777777777778
1983,100318,"Roger Guedes",1,1,2,50
1983,100321,"Vijay Amritraj",8,12,20,40
1983,100323,"Givaldo Barbosa",7,11,18,38.888888888888886
1983,100325,"Ulrich Pinner",1,3,4,25
1983,100326,"Russell Simpson",10,16,26,38.46153846153846
1983,100328,"Rand Evett",1,2,3,33.333333333333336
1983,100332,"Balazs Taroczy",13,14,27,48.148148148148145
1983,100337,"Mark Edmondson",17,21,38,44.73684210526316
1983,100339,"Victor Amaya",8,13,21,38.095238095238095
1983,100342,"Vitas Gerulaitis",32,20,52,61.53846153846154
1983,100343,"John Lloyd",9,11,20,45
1983,100345,"Pat Dupre",9,19,28,32.142857142857146
1983,100353,"Bruce Kleege",1,6,7,14.285714285714286
1983,100354,"Bernard Mitton",13,16,29,44.827586206896555
1983,100356,"Paul Mcnamee",38,26,64,59.375
1983,100360,"Brian Teacher",33,21,54,61.111111111111114
1983,100362,"Peter Fleming",14,11,25,56
1983,100363,"Jiri Granat",2,4,6,33.333333333333336
1983,100364,"Jonathan Smith",1,6,7,14.285714285714286
1983,100367,"Belus Prajoux",1,4,5,20
1983,100372,"Trey Waltke",3,13,16,18.75
1983,100376,"Buster C Mottram",5,10,15,33.333333333333336
1983,100377,"Colin Dowdeswell",17,10,27,62.96296296296296
1983,100380,"Butch Walts",9,10,19,47.36842105263158
1983,100383,"Peter Mcnamara",10,4,14,71.42857142857143
1983,100390,"Trevor Allan",5,3,8,62.5
1983,100392,"Richard Meyer",4,7,11,36.36363636363637
1983,100393,"Marcos Hocevar",17,28,45,37.77777777777778
1983,100394,"Angel Gimenez",2,4,6,33.333333333333336
1983,100395,"Victor Pecci",18,15,33,54.54545454545455
1983,100398,"Julio Goes",4,7,11,36.36363636363637
1983,100402,"Francisco Gonzalez",11,16,27,40.74074074074074
1983,100403,"Rolf Gehring",8,6,14,57.142857142857146
1983,100411,"Pavel Slozil",22,21,43,51.16279069767442
1983,100417,"Hans Gildemeister",10,11,21,47.61904761904762
1983,100422,"Bruce Manson",4,10,14,28.571428571428573
1983,100426,"Hans Peter Kandler",1,3,4,25
1983,100428,"Gene Mayer",25,10,35,71.42857142857143
1983,100429,"Miguel Mir",1,1,2,50
1983,100430,"David Carter",3,8,11,27.272727272727273
1983,100431,"Mansour Bahrami",2,1,3,66.66666666666667
1983,100434,"Tomas Smid",59,30,89,66.29213483146067
1983,100436,"Nick Saviano",20,21,41,48.78048780487805
1983,100437,"Bjorn Borg",1,1,2,50
1983,100440,"Eddie Edwards",6,15,21,28.571428571428573
1983,100445,"Steve Denton",25,23,48,52.083333333333336
1983,100446,"John Sadri",8,13,21,38.095238095238095
1983,100448,"Bruce Foxworth",2,6,8,25
1983,100449,"Stanislav Birner",4,11,15,26.666666666666668
1983,100450,"Leo Palin",1,1,2,50
1983,100452,"Bill Scanlon",42,21,63,66.66666666666667
1983,100453,"Jose Luis Damiani",1,3,4,25
1983,100464,"Warren Maher",1,1,2,50
1983,100468,"Dominique Bedel",14,20,34,41.1764705882353
1983,100472,"Craig Wittus",4,9,13,30.76923076923077
1983,100474,"Chris Lewis",32,23,55,58.18181818181818
1983,100475,"Matt Mitchell",9,14,23,39.130434782608695
1983,100477,"Gianni Ocleppo",16,14,30,53.333333333333336
1983,100481,"Roberto Vizcaino",6,4,10,60
1983,100483,"Christophe Casa",2,2,4,50
1983,100486,"Christophe Roger Vasselin",13,17,30,43.333333333333336
1983,100489,"Larry Stefanki",7,9,16,43.75
1983,100490,"Jaroslav Navratil",1,4,5,20
1983,100495,"Wayne Hampson",1,5,6,16.666666666666668
1983,100496,"Charles Buzz Strode",3,8,11,27.272727272727273
1983,100502,"Vincent Van Patten",13,20,33,39.39393939393939
1983,100503,"Lorenzo Fargas",1,2,3,33.333333333333336
1983,100504,"Jerome Vanier",4,6,10,40
1983,100513,"Hugo Roverano",1,1,2,50
1983,100515,"Shlomo Glickstein",20,21,41,48.78048780487805
1983,100516,"Andrew Jarrett",1,2,3,33.333333333333336
1983,100517,"Matt Doyle",12,9,21,57.142857142857146
1983,100518,"Ricardo Acuna",15,17,32,46.875
1983,100519,"Scott Mccain",3,6,9,33.333333333333336
1983,100522,"Chris Dunk",1,1,2,50
1983,100523,"Erick Iskersky",7,12,19,36.8421052631579
1983,100524,"Shozo Shiraishi",1,2,3,33.333333333333336
1983,100525,"Gilles Moretton",9,13,22,40.90909090909091
1983,100527,"Chris Bradnam",1,2,3,33.333333333333336
1983,100529,"Kevin Curren",32,20,52,61.53846153846154
1983,100530,"Andreas Maurer",10,11,21,47.61904761904762
1983,100532,"Johan Kriek",39,19,58,67.24137931034483
1983,100534,"Steve Meister",6,10,16,37.5
1983,100535,"Tony Giammalva",7,11,18,38.888888888888886
1983,100536,"Fernando Luna",19,13,32,59.375
1983,100537,"Mike Brunnberg",1,6,7,14.285714285714286
1983,100538,"Alejandro Gattiker",1,4,5,20
1983,100540,"Drew Gitlin",13,21,34,38.23529411764706
1983,100543,"Peter Elter",11,18,29,37.93103448275862
1983,100546,"Eric Fromm",19,23,42,45.23809523809524
1983,100548,"Ivan Kley",3,3,6,50
1983,100551,"Brad Drewett",21,16,37,56.75675675675676
1983,100553,"Nduka Odizor",19,20,39,48.717948717948715
1983,100555,"Jose Luis Clerc",29,14,43,67.44186046511628
1983,100559,"Mike Gandolfo",1,3,4,25
1983,100562,"Tom Cain",15,19,34,44.11764705882353
1983,100565,"Lloyd Bourne",11,17,28,39.285714285714285
1983,100567,"Chip Hooper",24,24,48,50
1983,100568,"John Mattke",2,2,4,50
1983,100570,"Marty Davis",12,11,23,52.17391304347826
1983,100574,"Peter Rennert",3,5,8,37.5
1983,100575,"Andy Andrews",6,15,21,28.571428571428573
1983,100577,"Rory Chappell",1,2,3,33.333333333333336
1983,100578,"Brent Pirow",1,2,3,33.333333333333336
1983,100579,"Heinz Gunthardt",27,15,42,64.28571428571429
1983,100581,"John McEnroe",62,9,71,87.32394366197182
1983,100585,"Van Winitsky",10,17,27,37.03703703703704
1983,100586,"Eliot Teltscher",44,22,66,66.66666666666667
1983,100588,"Pender Murphy",3,6,9,33.333333333333336
1983,100589,"Harald Theissen",1,2,3,33.333333333333336
1983,100592,"Robert Vant Hof",16,14,30,53.333333333333336
1983,100595,"Ronnie Bathman",1,1,2,50
1983,100598,"Wolfgang Popp",1,5,6,16.666666666666668
1983,100599,"Bernard Boileau",11,14,25,44
1983,100600,"Pascal Portes",4,4,8,50
1983,100603,"Roland Stadler",9,8,17,52.94117647058823
1983,100604,"Egan Adams",1,10,11,9.090909090909092
1983,100605,"Charlie Fancutt",2,5,7,28.571428571428573
1983,100606,"Mike Bauer",28,23,51,54.90196078431372
1983,100609,"Zoltan Kuharszky",9,15,24,37.5
1983,100611,"Mel Purcell",30,25,55,54.54545454545455
1983,100615,"Gianluca Rinaldini",1,7,8,12.5
1983,100618,"Leif Shiras",2,2,4,50
1983,100619,"George Kalovelonis",1,1,2,50
1983,100624,"Derek Tarr",5,8,13,38.46153846153846
1983,100625,"Scott Lipton",6,10,16,37.5
1983,100628,"Michiel Schapers",9,14,23,39.130434782608695
1983,100631,"Tim Wilkison",14,20,34,41.1764705882353
1983,100635,"Mark Dickson",28,27,55,50.90909090909091
1983,100636,"Gustavo Tiberti",3,7,10,30
1983,100638,"David Mustard",1,6,7,14.285714285714286
1983,100639,"Blaine Willenborg",1,3,4,25
1983,100640,"Stefan Simonsson",24,19,43,55.81395348837209
1983,100646,"Claudio Panatta",15,19,34,44.11764705882353
1983,100649,"David Dowlen",5,7,12,41.666666666666664
1983,100651,"Alejandro Ganzabal",9,13,22,40.90909090909091
1983,100652,"Cassio Motta",14,21,35,40
1983,100653,"Andres Gomez",43,20,63,68.25396825396825
1983,100655,"Fritz Buehning",22,21,43,51.16279069767442
1983,100656,"Ivan Lendl",75,16,91,82.41758241758242
1983,100657,"Mike Leach",12,14,26,46.15384615384615
1983,100661,"Damir Keretic",9,18,27,33.333333333333336
1983,100663,"Marcel Freeman",7,12,19,36.8421052631579
1983,100667,"Per Hjertquist",2,7,9,22.22222222222222
1983,100673,"Robbie Venter",2,9,11,18.181818181818183
1983,100675,"John Mccurdy",5,12,17,29.41176470588235
1983,100676,"Yannick Noah",36,12,48,75
1983,100680,"Peter Johnston",1,4,5,20
1983,100681,"Morris Skip Strode",7,13,20,35
1983,100689,"Tim Mayotte",23,18,41,56.09756097560975
1983,100699,"Chris Johnstone",6,15,21,28.571428571428573
1983,100701,"Marko Ostoja",7,9,16,43.75
1983,100702,"Sean Brawley",3,4,7,42.857142857142854
1983,100711,"Pedro Rebolledo",9,8,17,52.94117647058823
1983,100713,"John Fitzgerald",32,19,51,62.745098039215684
1983,100714,"Broderick Dyke",6,9,15,40
1983,100715,"Jim Gurfein",13,15,28,46.42857142857143
1983,100719,"Juan Avendano",12,14,26,46.15384615384615
1983,100726,"Greg Whitecross",1,3,4,25
1983,100728,"Todd Nelson",4,5,9,44.44444444444444
1983,100729,"Fernando Soler",1,1,2,50
1983,100730,"Florin Segarceanu",13,15,28,46.42857142857143
1983,100738,"Schalk Van Der Merwe",2,3,5,40
1983,100742,"Christo Steyn",1,2,3,33.333333333333336
1983,100744,"Peter Doohan",1,2,3,33.333333333333336
1983,100749,"Dave Siegler",2,1,3,66.66666666666667
1983,100752,"Ramesh Krishnan",21,25,46,45.65217391304348
1983,100757,"Anders Jarryd",35,20,55,63.63636363636363
1983,100758,"John Van Nostrand",2,2,4,50
1983,100759,"Danie Visser",7,12,19,36.8421052631579
1983,100761,"Danny Saltz",1,1,2,50
1983,100762,"Freddie Sauer",3,8,11,27.272727272727273
1983,100763,"Brad Gilbert",33,27,60,55
1983,100764,"Gabriel Urpi",1,4,5,20
1983,100765,"Rodney Harmon",9,10,19,47.36842105263158
1983,100769,"Mario Martinez",17,18,35,48.57142857142857
1983,100774,"Thomas Stalhandske",1,1,2,50
1983,100776,"Tomm Warneke",1,1,2,50
1983,100779,"Kevin Moir",1,1,2,50
1983,100780,"Mike De Palmer",20,23,43,46.51162790697674
1983,100781,"Bernhard Pils",1,5,6,16.666666666666668
1983,100782,"Pablo Arraya",29,18,47,61.702127659574465
1983,100790,"Bruce Derlin",3,6,9,33.333333333333336
1983,100793,"Stephane Bonneau",1,1,2,50
1983,100797,"Ben Testerman",8,16,24,33.333333333333336
1983,100799,"Carlos Castellan",4,8,12,33.333333333333336
1983,100800,"Diego Perez",19,14,33,57.57575757575758
1983,100803,"Stefan Svensson",1,1,2,50
1983,100809,"Juan Aguilera",15,11,26,57.69230769230769
1983,100812,"Gerald Mild",1,2,3,33.333333333333336
1983,100815,"David Pate",5,7,12,41.666666666666664
1983,100821,"Hans Simonsson",8,22,30,26.666666666666668
1983,100824,"Peter Bastiansen",3,2,5,60
1983,100829,"Jan Gunnarsson",18,16,34,52.94117647058823
1983,100835,"Hans Dieter Beutel",6,4,10,60
1983,100836,"Glenn Michibata",10,10,20,50
1983,100837,"Jeremy Bates",1,4,5,20
1983,100844,"Jerome Potier",1,2,3,33.333333333333336
1983,100848,"Alberto Tous",6,14,20,30
1983,100849,"David Graham",1,1,2,50
1983,100855,"Scott Davis",29,16,45,64.44444444444444
1983,100857,"Sergio Casal",11,11,22,50
1983,100866,"Shahar Perkiss",2,1,3,66.66666666666667
1983,100868,"Craig A Miller",3,12,15,20
1983,100878,"Christoph Zipf",6,5,11,54.54545454545455
1983,100880,"Russell Barlow",1,1,2,50
1983,100883,"Christophe Bernelle",1,2,3,33.333333333333336
1983,100887,"Eric Korita",16,12,28,57.142857142857146
1983,100893,"Joakim Nystrom",27,14,41,65.85365853658537
1983,100894,"Francesco Cancellotti",14,9,23,60.869565217391305
1983,100899,"Jorgen Windahl",1,2,3,33.333333333333336
1983,100901,"Paul Annacone",5,5,10,50
1983,100905,"Sammy Giammalva Jr",25,22,47,53.191489361702125
1983,100910,"Magnus Tideman",5,13,18,27.77777777777778
1983,100917,"Nelson Aerts",2,1,3,66.66666666666667
1983,100920,"Robert Seguso",7,5,12,58.333333333333336
1983,100921,"Patrice Kuchna",2,3,5,40
1983,100922,"Roberto Arguello",11,5,16,68.75
1983,100923,"Wally Masur",19,17,36,52.77777777777778
1983,100926,"Ken Flach",2,3,5,40
1983,100934,"Matt Anger",5,9,14,35.714285714285715
1983,100936,"Henri Leconte",35,23,58,60.3448275862069
1983,100938,"Jaromir Becka",5,6,11,45.45454545454545
1983,100942,"Thierry Tulasne",17,18,35,48.57142857142857
1983,100950,"Libor Pimek",19,14,33,57.57575757575758
1983,100957,"Greg Holmes",3,7,10,30
1983,100962,"Thomas Hogstedt",15,16,31,48.38709677419355
1983,100964,"Jon Levine",4,5,9,44.44444444444444
1983,100972,"Todd Witsken",1,2,3,33.333333333333336
1983,100993,"Loic Courteau",9,14,23,39.130434782608695
1983,100998,"Stuart Bale",1,2,3,33.333333333333336
1983,101013,"Henrik Sundstrom",31,18,49,63.265306122448976
1983,101020,"Hans Schwaier",6,3,9,66.66666666666667
1983,101036,"Miloslav Mecir",11,5,16,68.75
1983,101061,"Jimmy Arias",47,15,62,75.80645161290323
1983,101062,"Mats Wilander",74,11,85,87.05882352941177
1983,101064,"David Lewis",1,1,2,50
1983,101073,"Martin Jaite",4,3,7,57.142857142857146
1983,101084,"Jakob Hlasek",5,6,11,45.45454545454545
1983,101098,"Guy Forget",7,23,30,23.333333333333332
1983,101106,"Peter Lundgren",1,1,2,50
1983,101109,"Tarik Benhabiles",1,4,5,20
1983,101113,"Michael Westphal",7,9,16,43.75
1983,101117,"Eric Jelen",2,3,5,40
1983,101124,"Paolo Cane",1,4,5,20
1983,101131,"Jimmy Brown",26,17,43,60.46511627906977
1983,101138,"Pat Cash",27,20,47,57.4468085106383
1983,101145,"Jonathan Canter",2,5,7,28.571428571428573
1983,101147,"Claudio Mezzadri",1,3,4,25
1983,101154,"Simon Youl",4,6,10,40
1983,101158,"John Frawley",2,7,9,22.22222222222222
1983,101174,"Fernando Roese",2,1,3,66.66666666666667
1983,101195,"Amos Mansdorf",1,1,2,50
1983,101222,"Stefan Edberg",12,10,22,54.54545454545455
1983,101226,"Johan Carlsson",4,3,7,57.142857142857146
1983,101237,"Danilo Marcelino",1,1,2,50
1983,101256,"Mark Kratzmann",1,3,4,25
1983,101298,"Jonas Svensson",1,2,3,33.333333333333336
1983,101381,"Aaron Krickstein",8,5,13,61.53846153846154
1983,106582,"Armand Molino",2,2,4,50
1983,106694,"Carlos Chabalgoity",2,1,3,66.66666666666667
1983,106917,"Edson Krause",1,1,2,50
1983,107455,"Juan Hernandez",2,1,3,66.66666666666667
1983,107924,"Paschoal Penetta",1,1,2,50
1983,108084,"Richard Gallien",1,1,2,50
1983,108191,"S Viljoen",1,1,2,50
1983,109771,"Jairo Velasco",11,18,29,37.93103448275862
1983,109803,"John Brown",1,1,2,50
1983,201470,"Tian C Viljoen",1,2,3,33.333333333333336
1984,100119,"Ilie Nastase",4,12,16,25
1984,100144,"Robert Lutz",3,2,5,60
1984,100179,"Karl Meiler",2,1,3,66.66666666666667
1984,100232,"Eddie Dibbs",1,5,6,16.666666666666668
1984,100240,"Joao Soares",5,10,15,33.333333333333336
1984,100244,"John Alexander",12,24,36,33.333333333333336
1984,100252,"Tim Gullikson",14,21,35,40
1984,100253,"Tom Gullikson",19,20,39,48.717948717948715
1984,100255,"Roscoe Tanner",3,11,14,21.428571428571427
1984,100259,"Peter Feigl",2,4,6,33.333333333333336
1984,100261,"Brian Gottfried",13,18,31,41.935483870967744
1984,100272,"Sandy Mayer",10,11,21,47.61904761904762
1984,100273,"Kim Warwick",6,5,11,54.54545454545455
1984,100276,"Terry Moor",28,19,47,59.57446808510638
1984,100280,"Wojtek Fibak",21,23,44,47.72727272727273
1984,100282,"Guillermo Vilas",17,14,31,54.83870967741935
1984,100284,"Jimmy Connors",69,12,81,85.18518518518519
1984,100285,"Rod Frawley",1,3,4,25
1984,100286,"Harold Solomon",4,6,10,40
1984,100297,"Corrado Barazzutti",5,7,12,41.666666666666664
1984,100300,"Jose Higueras",26,14,40,65
1984,100315,"Hank Pfister",15,18,33,45.45454545454545
1984,100321,"Vijay Amritraj",19,18,37,51.351351351351354
1984,100323,"Givaldo Barbosa",1,8,9,11.11111111111111
1984,100326,"Russell Simpson",9,16,25,36
1984,100332,"Balazs Taroczy",18,20,38,47.36842105263158
1984,100337,"Mark Edmondson",9,18,27,33.333333333333336
1984,100342,"Vitas Gerulaitis",34,21,55,61.81818181818182
1984,100343,"John Lloyd",16,16,32,50
1984,100345,"Pat Dupre",1,5,6,16.666666666666668
1984,100354,"Bernard Mitton",4,8,12,33.333333333333336
1984,100356,"Paul Mcnamee",16,18,34,47.05882352941177
1984,100360,"Brian Teacher",23,18,41,56.09756097560975
1984,100362,"Peter Fleming",18,19,37,48.648648648648646
1984,100364,"Jonathan Smith",5,6,11,45.45454545454545
1984,100374,"Javier Soler",1,1,2,50
1984,100377,"Colin Dowdeswell",10,24,34,29.41176470588235
1984,100380,"Butch Walts",1,3,4,25
1984,100390,"Trevor Allan",12,10,22,54.54545454545455
1984,100393,"Marcos Hocevar",4,10,14,28.571428571428573
1984,100395,"Victor Pecci",17,12,29,58.62068965517241
1984,100401,"Sean Sorensen",1,1,2,50
1984,100402,"Francisco Gonzalez",14,17,31,45.16129032258065
1984,100403,"Rolf Gehring",8,14,22,36.36363636363637
1984,100411,"Pavel Slozil",21,17,38,55.26315789473684
1984,100416,"Bill Maze",1,1,2,50
1984,100417,"Hans Gildemeister",8,8,16,50
1984,100422,"Bruce Manson",7,11,18,38.888888888888886
1984,100428,"Gene Mayer",24,15,39,61.53846153846154
1984,100434,"Tomas Smid",49,28,77,63.63636363636363
1984,100440,"Eddie Edwards",12,13,25,48
1984,100445,"Steve Denton",13,21,34,38.23529411764706
1984,100446,"John Sadri",25,16,41,60.97560975609756
1984,100449,"Stanislav Birner",4,3,7,57.142857142857146
1984,100450,"Leo Palin",2,4,6,33.333333333333336
1984,100452,"Bill Scanlon",20,17,37,54.054054054054056
1984,100460,"Jose Lopez Maeso",2,4,6,33.333333333333336
1984,100468,"Dominique Bedel",2,2,4,50
1984,100472,"Craig Wittus",1,1,2,50
1984,100474,"Chris Lewis",15,17,32,46.875
1984,100475,"Matt Mitchell",13,13,26,50
1984,100477,"Gianni Ocleppo",13,17,30,43.333333333333336
1984,100483,"Christophe Casa",1,1,2,50
1984,100486,"Christophe Roger Vasselin",1,11,12,8.333333333333334
1984,100489,"Larry Stefanki",11,13,24,45.833333333333336
1984,100490,"Jaroslav Navratil",8,7,15,53.333333333333336
1984,100502,"Vincent Van Patten",9,10,19,47.36842105263158
1984,100515,"Shlomo Glickstein",17,20,37,45.945945945945944
1984,100517,"Matt Doyle",8,17,25,32
1984,100518,"Ricardo Acuna",6,11,17,35.294117647058826
1984,100519,"Scott Mccain",6,8,14,42.857142857142854
1984,100522,"Chris Dunk",1,2,3,33.333333333333336
1984,100523,"Erick Iskersky",1,4,5,20
1984,100529,"Kevin Curren",32,17,49,65.3061224489796
1984,100530,"Andreas Maurer",9,14,23,39.130434782608695
1984,100532,"Johan Kriek",37,17,54,68.51851851851852
1984,100534,"Steve Meister",17,19,36,47.22222222222222
1984,100535,"Tony Giammalva",6,11,17,35.294117647058826
1984,100536,"Fernando Luna",13,14,27,48.148148148148145
1984,100540,"Drew Gitlin",5,5,10,50
1984,100543,"Peter Elter",4,8,12,33.333333333333336
1984,100546,"Eric Fromm",3,9,12,25
1984,100548,"Ivan Kley",1,1,2,50
1984,100551,"Brad Drewett",26,25,51,50.98039215686274
1984,100553,"Nduka Odizor",9,13,22,40.90909090909091
1984,100555,"Jose Luis Clerc",14,12,26,53.84615384615385
1984,100556,"Brian Levine",4,5,9,44.44444444444444
1984,100562,"Tom Cain",6,9,15,40
1984,100564,"Cary Stansbury",1,1,2,50
1984,100565,"Lloyd Bourne",19,20,39,48.717948717948715
1984,100567,"Chip Hooper",18,21,39,46.15384615384615
1984,100568,"John Mattke",3,5,8,37.5
1984,100570,"Marty Davis",25,19,44,56.81818181818182
1984,100575,"Andy Andrews",1,3,4,25
1984,100579,"Heinz Gunthardt",23,19,42,54.76190476190476
1984,100581,"John McEnroe",75,2,77,97.40259740259741
1984,100585,"Van Winitsky",7,14,21,33.333333333333336
1984,100586,"Eliot Teltscher",42,19,61,68.85245901639344
1984,100587,"Steve Guy",2,4,6,33.333333333333336
1984,100592,"Robert Vant Hof",7,15,22,31.818181818181817
1984,100597,"Jay Lapidus",13,12,25,52
1984,100598,"Wolfgang Popp",1,2,3,33.333333333333336
1984,100599,"Bernard Boileau",6,7,13,46.15384615384615
1984,100600,"Pascal Portes",4,8,12,33.333333333333336
1984,100603,"Roland Stadler",3,12,15,20
1984,100604,"Egan Adams",4,3,7,57.142857142857146
1984,100606,"Mike Bauer",17,19,36,47.22222222222222
1984,100607,"Eduardo Bengoechea",1,1,2,50
1984,100609,"Zoltan Kuharszky",13,16,29,44.827586206896555
1984,100611,"Mel Purcell",20,21,41,48.78048780487805
1984,100616,"Andy Kohlberg",2,2,4,50
1984,100618,"Leif Shiras",15,16,31,48.38709677419355
1984,100624,"Derek Tarr",6,12,18,33.333333333333336
1984,100628,"Michiel Schapers",10,11,21,47.61904761904762
1984,100631,"Tim Wilkison",26,20,46,56.52173913043478
1984,100635,"Mark Dickson",36,22,58,62.06896551724138
1984,100637,"Stefan Hermann",1,1,2,50
1984,100638,"David Mustard",4,10,14,28.571428571428573
1984,100639,"Blaine Willenborg",6,10,16,37.5
1984,100640,"Stefan Simonsson",17,22,39,43.58974358974359
1984,100645,"Huub Van Boeckel",6,5,11,54.54545454545455
1984,100646,"Claudio Panatta",10,19,29,34.48275862068966
1984,100649,"David Dowlen",2,7,9,22.22222222222222
1984,100651,"Alejandro Ganzabal",9,7,16,56.25
1984,100652,"Cassio Motta",12,19,31,38.70967741935484
1984,100653,"Andres Gomez",60,13,73,82.1917808219178
1984,100655,"Fritz Buehning",5,14,19,26.31578947368421
1984,100656,"Ivan Lendl",61,13,74,82.43243243243244
1984,100657,"Mike Leach",12,18,30,40
1984,100660,"Bob Green",15,8,23,65.21739130434783
1984,100661,"Damir Keretic",7,8,15,46.666666666666664
1984,100663,"Marcel Freeman",13,18,31,41.935483870967744
1984,100674,"Jeff Turpin",4,5,9,44.44444444444444
1984,100676,"Yannick Noah",23,10,33,69.6969696969697
1984,100680,"Peter Johnston",1,1,2,50
1984,100682,"Ernie Fernandez",2,2,4,50
1984,100689,"Tim Mayotte",23,20,43,53.48837209302326
1984,100700,"Heinz Gildemeister",3,1,4,75
1984,100701,"Marko Ostoja",13,21,34,38.23529411764706
1984,100702,"Sean Brawley",1,2,3,33.333333333333336
1984,100703,"Randy Nixon",1,6,7,14.285714285714286
1984,100705,"Erik Vant Hof",1,1,2,50
1984,100710,"Phil Lehnhoff",1,1,2,50
1984,100711,"Pedro Rebolledo",9,12,21,42.857142857142854
1984,100713,"John Fitzgerald",27,19,46,58.69565217391305
1984,100715,"Jim Gurfein",1,10,11,9.090909090909092
1984,100719,"Juan Avendano",2,8,10,20
1984,100725,"Michael Mortensen",2,2,4,50
1984,100727,"Raul Antonio Viver",5,5,10,50
1984,100728,"Todd Nelson",10,12,22,45.45454545454545
1984,100729,"Fernando Soler",1,2,3,33.333333333333336
1984,100730,"Florin Segarceanu",3,9,12,25
1984,100740,"Dan Cassidy",12,8,20,60
1984,100744,"Peter Doohan",10,9,19,52.63157894736842
1984,100747,"Glenn Layendecker",3,12,15,20
1984,100752,"Ramesh Krishnan",33,20,53,62.264150943396224
1984,100757,"Anders Jarryd",47,19,66,71.21212121212122
1984,100759,"Danie Visser",13,14,27,48.148148148148145
1984,100761,"Danny Saltz",12,13,25,48
1984,100763,"Brad Gilbert",39,23,62,62.903225806451616
1984,100764,"Gabriel Urpi",8,11,19,42.10526315789474
1984,100765,"Rodney Harmon",8,15,23,34.78260869565217
1984,100769,"Mario Martinez",3,7,10,30
1984,100771,"Kelvin Belcher",4,6,10,40
1984,100774,"Thomas Stalhandske",1,1,2,50
1984,100779,"Kevin Moir",2,3,5,40
1984,100780,"Mike De Palmer",12,10,22,54.54545454545455
1984,100781,"Bernhard Pils",2,1,3,66.66666666666667
1984,100782,"Pablo Arraya",17,17,34,50
1984,100787,"Dale Houston",2,3,5,40
1984,100790,"Bruce Derlin",4,6,10,40
1984,100797,"Ben Testerman",24,19,43,55.81395348837209
1984,100798,"Howard Sands",4,9,13,30.76923076923077
1984,100799,"Carlos Castellan",8,9,17,47.05882352941177
1984,100800,"Diego Perez",15,16,31,48.38709677419355
1984,100809,"Juan Aguilera",26,15,41,63.41463414634146
1984,100815,"David Pate",21,13,34,61.76470588235294
1984,100821,"Hans Simonsson",5,9,14,35.714285714285715
1984,100824,"Peter Bastiansen",2,1,3,66.66666666666667
1984,100829,"Jan Gunnarsson",21,17,38,55.26315789473684
1984,100833,"Marc Flur",3,5,8,37.5
1984,100835,"Hans Dieter Beutel",4,13,17,23.529411764705884
1984,100836,"Glenn Michibata",7,17,24,29.166666666666668
1984,100840,"Mark Wooldridge",2,3,5,40
1984,100848,"Alberto Tous",6,7,13,46.15384615384615
1984,100855,"Scott Davis",23,22,45,51.111111111111114
1984,100857,"Sergio Casal",2,9,11,18.181818181818183
1984,100864,"Martin Wostenholme",2,3,5,40
1984,100865,"Marcelo Ingaramo",2,1,3,66.66666666666667
1984,100866,"Shahar Perkiss",16,13,29,55.172413793103445
1984,100868,"Craig A Miller",2,9,11,18.181818181818183
1984,100870,"Christo Van Rensburg",7,9,16,43.75
1984,100884,"Steve Shaw",3,5,8,37.5
1984,100887,"Eric Korita",9,13,22,40.90909090909091
1984,100892,"Alexandre Hocevar",1,1,2,50
1984,100893,"Joakim Nystrom",56,20,76,73.6842105263158
1984,100894,"Francesco Cancellotti",25,12,37,67.56756756756756
1984,100900,"Josef Cihak",1,2,3,33.333333333333336
1984,100901,"Paul Annacone",8,9,17,47.05882352941177
1984,100905,"Sammy Giammalva Jr",20,15,35,57.142857142857146
1984,100907,"Luca Bottazzi",3,3,6,50
1984,100910,"Magnus Tideman",1,6,7,14.285714285714286
1984,100913,"Peter Carlsson",1,3,4,25
1984,100920,"Robert Seguso",5,13,18,27.77777777777778
1984,100921,"Patrice Kuchna",1,2,3,33.333333333333336
1984,100922,"Roberto Arguello",12,16,28,42.857142857142854
1984,100923,"Wally Masur",18,23,41,43.90243902439025
1984,100926,"Ken Flach",7,6,13,53.84615384615385
1984,100934,"Matt Anger",7,6,13,53.84615384615385
1984,100936,"Henri Leconte",26,18,44,59.09090909090909
1984,100938,"Jaromir Becka",4,6,10,40
1984,100942,"Thierry Tulasne",15,14,29,51.724137931034484
1984,100945,"Craig Campbell",3,3,6,50
1984,100946,"Slobodan Zivojinovic",8,11,19,42.10526315789474
1984,100950,"Libor Pimek",31,18,49,63.265306122448976
1984,100956,"Simone Colombo",4,12,16,25
1984,100957,"Greg Holmes",16,14,30,53.333333333333336
1984,100962,"Thomas Hogstedt",10,16,26,38.46153846153846
1984,100964,"Jon Levine",1,4,5,20
1984,100967,"Dan Goldie",7,4,11,63.63636363636363
1984,100974,"Jeff Klaparda",4,4,8,50
1984,100993,"Loic Courteau",1,4,5,20
1984,100998,"Stuart Bale",2,4,6,33.333333333333336
1984,101007,"Guillermo Rivas",1,4,5,20
1984,101013,"Henrik Sundstrom",48,21,69,69.56521739130434
1984,101014,"John Ross",1,1,2,50
1984,101020,"Hans Schwaier",12,15,27,44.44444444444444
1984,101022,"Kelly Jones",1,1,2,50
1984,101029,"Ricki Osterthun",2,1,3,66.66666666666667
1984,101036,"Miloslav Mecir",22,19,41,53.65853658536585
1984,101048,"Francisco Maciel",5,4,9,55.55555555555556
1984,101053,"Michael Kures",1,1,2,50
1984,101058,"Francisco Yunis",3,3,6,50
1984,101061,"Jimmy Arias",41,21,62,66.12903225806451
1984,101062,"Mats Wilander",49,13,62,79.03225806451613
1984,101063,"Jordi Arrese",3,5,8,37.5
1984,101073,"Martin Jaite",11,8,19,57.89473684210526
1984,101074,"Carlos Di Laura",2,2,4,50
1984,101076,"Cesar Kist",1,1,2,50
1984,101080,"Lawson Duncan",4,5,9,44.44444444444444
1984,101084,"Jakob Hlasek",18,20,38,47.36842105263158
1984,101098,"Guy Forget",19,13,32,59.375
1984,101109,"Tarik Benhabiles",10,9,19,52.63157894736842
1984,101110,"David De Miguel",2,2,4,50
1984,101113,"Michael Westphal",21,15,36,58.333333333333336
1984,101115,"Jorge Bardou",3,6,9,33.333333333333336
1984,101117,"Eric Jelen",5,9,14,35.714285714285715
1984,101119,"Marian Vajda",1,4,5,20
1984,101120,"Karel Novacek",6,6,12,50
1984,101124,"Paolo Cane",3,3,6,50
1984,101131,"Jimmy Brown",20,23,43,46.51162790697674
1984,101138,"Pat Cash",26,16,42,61.904761904761905
1984,101142,"Emilio Sanchez",10,13,23,43.47826086956522
1984,101147,"Claudio Mezzadri",7,11,18,38.888888888888886
1984,101154,"Simon Youl",4,9,13,30.76923076923077
1984,101158,"John Frawley",17,14,31,54.83870967741935
1984,101190,"Darren Cahill",2,4,6,33.333333333333336
1984,101195,"Amos Mansdorf",3,3,6,50
1984,101196,"Derrick Rostagno",1,3,4,25
1984,101204,"Eric Amend",1,1,2,50
1984,101222,"Stefan Edberg",32,18,50,64
1984,101256,"Mark Kratzmann",2,6,8,25
1984,101276,"Horacio De La Pena",4,4,8,50
1984,101298,"Jonas Svensson",2,2,4,50
1984,101332,"Gilad Bloom",1,1,2,50
1984,101340,"Ricky Brown",1,4,5,20
1984,101368,"Christian Miniussi",2,2,4,50
1984,101381,"Aaron Krickstein",34,17,51,66.66666666666667
1984,101404,"Thomas Muster",3,3,6,50
1984,101414,"Boris Becker",11,11,22,50
1984,101426,"Kent Carlsson",7,8,15,46.666666666666664
1984,106576,"Arafat Chekrouni",1,1,2,50
1984,106751,"Christoph Meyer",1,1,2,50
1984,107819,"Minoru Ueda",1,1,2,50
1985,100119,"Ilie Nastase",1,4,5,20
1985,100144,"Robert Lutz",1,1,2,50
1985,100179,"Karl Meiler",1,1,2,50
1985,100240,"Joao Soares",4,6,10,40
1985,100252,"Tim Gullikson",8,11,19,42.10526315789474
1985,100253,"Tom Gullikson",18,16,34,52.94117647058823
1985,100272,"Sandy Mayer",2,3,5,40
1985,100273,"Kim Warwick",1,3,4,25
1985,100276,"Terry Moor",13,22,35,37.142857142857146
1985,100280,"Wojtek Fibak",13,17,30,43.333333333333336
1985,100282,"Guillermo Vilas",17,14,31,54.83870967741935
1985,100284,"Jimmy Connors",48,16,64,75
1985,100286,"Harold Solomon",4,6,10,40
1985,100292,"Alvaro Fillol",1,2,3,33.333333333333336
1985,100300,"Jose Higueras",7,13,20,35
1985,100315,"Hank Pfister",12,10,22,54.54545454545455
1985,100321,"Vijay Amritraj",11,19,30,36.666666666666664
1985,100323,"Givaldo Barbosa",2,12,14,14.285714285714286
1985,100326,"Russell Simpson",11,11,22,50
1985,100332,"Balazs Taroczy",9,17,26,34.61538461538461
1985,100337,"Mark Edmondson",9,10,19,47.36842105263158
1985,100342,"Vitas Gerulaitis",12,15,27,44.44444444444444
1985,100343,"John Lloyd",23,21,44,52.27272727272727
1985,100356,"Paul Mcnamee",15,13,28,53.57142857142857
1985,100360,"Brian Teacher",17,16,33,51.515151515151516
1985,100362,"Peter Fleming",9,12,21,42.857142857142854
1985,100377,"Colin Dowdeswell",2,11,13,15.384615384615385
1985,100383,"Peter Mcnamara",4,7,11,36.36363636363637
1985,100390,"Trevor Allan",4,15,19,21.05263157894737
1985,100393,"Marcos Hocevar",4,4,8,50
1985,100395,"Victor Pecci",12,19,31,38.70967741935484
1985,100398,"Julio Goes",1,2,3,33.333333333333336
1985,100402,"Francisco Gonzalez",9,17,26,34.61538461538461
1985,100403,"Rolf Gehring",4,4,8,50
1985,100411,"Pavel Slozil",18,26,44,40.90909090909091
1985,100417,"Hans Gildemeister",6,12,18,33.333333333333336
1985,100426,"Hans Peter Kandler",1,3,4,25
1985,100428,"Gene Mayer",2,1,3,66.66666666666667
1985,100431,"Mansour Bahrami",1,1,2,50
1985,100434,"Tomas Smid",47,27,74,63.513513513513516
1985,100440,"Eddie Edwards",11,13,24,45.833333333333336
1985,100445,"Steve Denton",3,10,13,23.076923076923077
1985,100446,"John Sadri",25,25,50,50
1985,100448,"Bruce Foxworth",1,1,2,50
1985,100449,"Stanislav Birner",2,8,10,20
1985,100452,"Bill Scanlon",7,13,20,35
1985,100460,"Jose Lopez Maeso",7,12,19,36.8421052631579
1985,100474,"Chris Lewis",11,11,22,50
1985,100475,"Matt Mitchell",8,20,28,28.571428571428573
1985,100477,"Gianni Ocleppo",5,10,15,33.333333333333336
1985,100485,"Tsuyoshi Fukui",1,2,3,33.333333333333336
1985,100489,"Larry Stefanki",11,15,26,42.30769230769231
1985,100490,"Jaroslav Navratil",7,19,26,26.923076923076923
1985,100498,"Klaus Eberhard",2,2,4,50
1985,100502,"Vincent Van Patten",10,12,22,45.45454545454545
1985,100504,"Jerome Vanier",1,2,3,33.333333333333336
1985,100515,"Shlomo Glickstein",7,16,23,30.434782608695652
1985,100517,"Matt Doyle",4,8,12,33.333333333333336
1985,100518,"Ricardo Acuna",9,10,19,47.36842105263158
1985,100519,"Scott Mccain",3,10,13,23.076923076923077
1985,100522,"Chris Dunk",2,2,4,50
1985,100529,"Kevin Curren",25,13,38,65.78947368421052
1985,100530,"Andreas Maurer",28,14,42,66.66666666666667
1985,100532,"Johan Kriek",43,21,64,67.1875
1985,100534,"Steve Meister",2,15,17,11.764705882352942
1985,100536,"Fernando Luna",10,14,24,41.666666666666664
1985,100543,"Peter Elter",2,11,13,15.384615384615385
1985,100544,"Tony Mmoh",1,2,3,33.333333333333336
1985,100548,"Ivan Kley",3,10,13,23.076923076923077
1985,100551,"Brad Drewett",14,21,35,40
1985,100553,"Nduka Odizor",9,13,22,40.90909090909091
1985,100555,"Jose Luis Clerc",23,13,36,63.888888888888886
1985,100560,"Jacques Manset",1,1,2,50
1985,100562,"Tom Cain",3,10,13,23.076923076923077
1985,100564,"Cary Stansbury",1,2,3,33.333333333333336
1985,100565,"Lloyd Bourne",6,13,19,31.57894736842105
1985,100567,"Chip Hooper",14,18,32,43.75
1985,100570,"Marty Davis",20,19,39,51.282051282051285
1985,100578,"Brent Pirow",1,1,2,50
1985,100579,"Heinz Gunthardt",22,19,41,53.65853658536585
1985,100581,"John McEnroe",72,10,82,87.8048780487805
1985,100586,"Eliot Teltscher",19,12,31,61.29032258064516
1985,100592,"Robert Vant Hof",1,4,5,20
1985,100597,"Jay Lapidus",11,25,36,30.555555555555557
1985,100598,"Wolfgang Popp",4,17,21,19.047619047619047
1985,100600,"Pascal Portes",5,6,11,45.45454545454545
1985,100603,"Roland Stadler",1,2,3,33.333333333333336
1985,100606,"Mike Bauer",9,22,31,29.032258064516128
1985,100607,"Eduardo Bengoechea",11,14,25,44
1985,100609,"Zoltan Kuharszky",3,16,19,15.789473684210526
1985,100611,"Mel Purcell",6,9,15,40
1985,100616,"Andy Kohlberg",1,5,6,16.666666666666668
1985,100617,"Bud Schultz",26,18,44,59.09090909090909
1985,100618,"Leif Shiras",17,19,36,47.22222222222222
1985,100620,"Eduardo Osta",1,1,2,50
1985,100623,"Roger Knapp",4,3,7,57.142857142857146
1985,100624,"Derek Tarr",1,4,5,20
1985,100628,"Michiel Schapers",12,19,31,38.70967741935484
1985,100630,"Gustavo Guerrero",1,1,2,50
1985,100631,"Tim Wilkison",36,28,64,56.25
1985,100635,"Mark Dickson",23,23,46,50
1985,100636,"Gustavo Tiberti",1,1,2,50
1985,100638,"David Mustard",3,6,9,33.333333333333336
1985,100639,"Blaine Willenborg",8,12,20,40
1985,100640,"Stefan Simonsson",10,16,26,38.46153846153846
1985,100645,"Huub Van Boeckel",11,16,27,40.74074074074074
1985,100646,"Claudio Panatta",15,15,30,50
1985,100651,"Alejandro Ganzabal",7,17,24,29.166666666666668
1985,100652,"Cassio Motta",7,11,18,38.888888888888886
1985,100653,"Andres Gomez",26,14,40,65
1985,100656,"Ivan Lendl",83,7,90,92.22222222222223
1985,100657,"Mike Leach",18,17,35,51.42857142857143
1985,100660,"Bob Green",13,24,37,35.13513513513514
1985,100661,"Damir Keretic",12,15,27,44.44444444444444
1985,100663,"Marcel Freeman",4,8,12,33.333333333333336
1985,100674,"Jeff Turpin",1,2,3,33.333333333333336
1985,100676,"Yannick Noah",50,17,67,74.6268656716418
1985,100682,"Ernie Fernandez",2,3,5,40
1985,100686,"Karl Richter",1,2,3,33.333333333333336
1985,100689,"Tim Mayotte",48,19,67,71.64179104477611
1985,100696,"Mark Buckley",1,3,4,25
1985,100701,"Marko Ostoja",7,18,25,28
1985,100711,"Pedro Rebolledo",3,5,8,37.5
1985,100713,"John Fitzgerald",16,22,38,42.10526315789474
1985,100714,"Broderick Dyke",9,8,17,52.94117647058823
1985,100715,"Jim Gurfein",2,2,4,50
1985,100716,"Norm Schellenger",1,1,2,50
1985,100719,"Juan Avendano",2,8,10,20
1985,100727,"Raul Antonio Viver",7,13,20,35
1985,100728,"Todd Nelson",7,15,22,31.818181818181817
1985,100730,"Florin Segarceanu",4,8,12,33.333333333333336
1985,100737,"Gary Lemon",1,1,2,50
1985,100740,"Dan Cassidy",7,19,26,26.923076923076923
1985,100742,"Christo Steyn",15,10,25,60
1985,100744,"Peter Doohan",18,19,37,48.648648648648646
1985,100747,"Glenn Layendecker",10,11,21,47.61904761904762
1985,100751,"Roberto Saad",6,10,16,37.5
1985,100752,"Ramesh Krishnan",26,24,50,52
1985,100757,"Anders Jarryd",52,21,73,71.23287671232876
1985,100759,"Danie Visser",13,20,33,39.39393939393939
1985,100761,"Danny Saltz",3,2,5,60
1985,100763,"Brad Gilbert",53,22,75,70.66666666666667
1985,100764,"Gabriel Urpi",5,9,14,35.714285714285715
1985,100765,"Rodney Harmon",3,7,10,30
1985,100772,"Kelly Evernden",17,11,28,60.714285714285715
1985,100776,"Tomm Warneke",1,1,2,50
1985,100780,"Mike De Palmer",16,19,35,45.714285714285715
1985,100781,"Bernhard Pils",3,4,7,42.857142857142854
1985,100782,"Pablo Arraya",12,15,27,44.44444444444444
1985,100790,"Bruce Derlin",1,9,10,10
1985,100793,"Stephane Bonneau",2,5,7,28.571428571428573
1985,100794,"Srinivasan Vasudevan",1,1,2,50
1985,100796,"Ahmed El Mehelmy",1,3,4,25
1985,100797,"Ben Testerman",17,18,35,48.57142857142857
1985,100798,"Howard Sands",1,1,2,50
1985,100800,"Diego Perez",30,21,51,58.8235294117647
1985,100809,"Juan Aguilera",16,17,33,48.484848484848484
1985,100815,"David Pate",31,24,55,56.36363636363637
1985,100821,"Hans Simonsson",1,3,4,25
1985,100826,"Juan Antonio Rodriguez",1,2,3,33.333333333333336
1985,100829,"Jan Gunnarsson",30,20,50,60
1985,100830,"Gary Donnelly",1,1,2,50
1985,100831,"Rick Rudeen",2,1,3,66.66666666666667
1985,100833,"Marc Flur",15,19,34,44.11764705882353
1985,100834,"Karsten Schulz",1,1,2,50
1985,100836,"Glenn Michibata",7,6,13,53.84615384615385
1985,100837,"Jeremy Bates",9,11,20,45
1985,100840,"Mark Wooldridge",1,5,6,16.666666666666668
1985,100844,"Jerome Potier",4,5,9,44.44444444444444
1985,100848,"Alberto Tous",6,10,16,37.5
1985,100855,"Scott Davis",37,21,58,63.793103448275865
1985,100857,"Sergio Casal",18,10,28,64.28571428571429
1985,100864,"Martin Wostenholme",4,8,12,33.333333333333336
1985,100865,"Marcelo Ingaramo",13,11,24,54.166666666666664
1985,100866,"Shahar Perkiss",16,18,34,47.05882352941177
1985,100868,"Craig A Miller",2,7,9,22.22222222222222
1985,100870,"Christo Van Rensburg",3,10,13,23.076923076923077
1985,100871,"Laurie Warder",1,2,3,33.333333333333336
1985,100877,"Brett Dickinson",1,3,4,25
1985,100880,"Russell Barlow",1,2,3,33.333333333333336
1985,100884,"Steve Shaw",7,14,21,33.333333333333336
1985,100887,"Eric Korita",1,3,4,25
1985,100893,"Joakim Nystrom",50,21,71,70.4225352112676
1985,100894,"Francesco Cancellotti",18,15,33,54.54545454545455
1985,100901,"Paul Annacone",45,19,64,70.3125
1985,100904,"George Bezecny",1,2,3,33.333333333333336
1985,100905,"Sammy Giammalva Jr",22,20,42,52.38095238095238
1985,100907,"Luca Bottazzi",2,6,8,25
1985,100910,"Magnus Tideman",2,3,5,40
1985,100913,"Peter Carlsson",4,6,10,40
1985,100917,"Nelson Aerts",4,5,9,44.44444444444444
1985,100918,"Harald Rittersbacher",1,1,2,50
1985,100920,"Robert Seguso",12,9,21,57.142857142857146
1985,100922,"Roberto Arguello",18,15,33,54.54545454545455
1985,100923,"Wally Masur",21,21,42,50
1985,100926,"Ken Flach",12,12,24,50
1985,100928,"Barry Moir",2,4,6,33.333333333333336
1985,100934,"Matt Anger",17,10,27,62.96296296296296
1985,100935,"Michael Robertson",5,7,12,41.666666666666664
1985,100936,"Henri Leconte",47,21,68,69.11764705882354
1985,100938,"Jaromir Becka",2,3,5,40
1985,100942,"Thierry Tulasne",36,22,58,62.06896551724138
1985,100944,"Mikael Pernfors",3,5,8,37.5
1985,100945,"Craig Campbell",1,1,2,50
1985,100946,"Slobodan Zivojinovic",23,20,43,53.48837209302326
1985,100950,"Libor Pimek",25,19,44,56.81818181818182
1985,100951,"Alessandro De Minicis",4,8,12,33.333333333333336
1985,100956,"Simone Colombo",1,3,4,25
1985,100957,"Greg Holmes",25,19,44,56.81818181818182
1985,100962,"Thomas Hogstedt",3,10,13,23.076923076923077
1985,100967,"Dan Goldie",3,9,12,25
1985,100970,"Stefan Eriksson",7,8,15,46.666666666666664
1985,100986,"Dacio Campos",1,7,8,12.5
1985,100993,"Loic Courteau",2,3,5,40
1985,100998,"Stuart Bale",2,8,10,20
1985,101000,"Carl Limberger",3,10,13,23.076923076923077
1985,101006,"Bruno Dadillon",1,1,2,50
1985,101007,"Guillermo Rivas",3,8,11,27.272727272727273
1985,101012,"Massimiliano Narducci",2,2,4,50
1985,101013,"Henrik Sundstrom",27,18,45,60
1985,101014,"John Ross",3,2,5,60
1985,101020,"Hans Schwaier",24,21,45,53.333333333333336
1985,101026,"Jim Grabb",4,4,8,50
1985,101029,"Ricki Osterthun",7,10,17,41.1764705882353
1985,101030,"Goran Prpic",8,8,16,50
1985,101031,"Massimo Cierro",2,7,9,22.22222222222222
1985,101035,"Menno Oosting",4,6,10,40
1985,101036,"Miloslav Mecir",36,16,52,69.23076923076923
1985,101048,"Francisco Maciel",5,6,11,45.45454545454545
1985,101057,"Peter Carter",1,2,3,33.333333333333336
1985,101061,"Jimmy Arias",32,21,53,60.37735849056604
1985,101062,"Mats Wilander",66,19,85,77.6470588235294
1985,101063,"Jordi Arrese",3,8,11,27.272727272727273
1985,101066,"Richard Matuszewski",1,1,2,50
1985,101073,"Martin Jaite",37,17,54,68.51851851851852
1985,101074,"Carlos Di Laura",1,1,2,50
1985,101080,"Lawson Duncan",26,19,45,57.77777777777778
1985,101081,"Massimo Zampieri",1,2,3,33.333333333333336
1985,101084,"Jakob Hlasek",29,23,52,55.76923076923077
1985,101086,"Ronald Agenor",17,14,31,54.83870967741935
1985,101093,"Steve Devries",1,2,3,33.333333333333336
1985,101097,"Rick Leach",1,2,3,33.333333333333336
1985,101098,"Guy Forget",18,21,39,46.15384615384615
1985,101106,"Peter Lundgren",8,4,12,66.66666666666667
1985,101109,"Tarik Benhabiles",16,26,42,38.095238095238095
1985,101110,"David De Miguel",4,4,8,50
1985,101113,"Michael Westphal",15,18,33,45.45454545454545
1985,101115,"Jorge Bardou",2,6,8,25
1985,101117,"Eric Jelen",2,3,5,40
1985,101119,"Marian Vajda",15,14,29,51.724137931034484
1985,101120,"Karel Novacek",4,4,8,50
1985,101124,"Paolo Cane",2,5,7,28.571428571428573
1985,101131,"Jimmy Brown",23,18,41,56.09756097560975
1985,101138,"Pat Cash",11,8,19,57.89473684210526
1985,101142,"Emilio Sanchez",16,14,30,53.333333333333336
1985,101145,"Jonathan Canter",16,14,30,53.333333333333336
1985,101147,"Claudio Mezzadri",5,8,13,38.46153846153846
1985,101154,"Simon Youl",9,8,17,52.94117647058823
1985,101158,"John Frawley",14,24,38,36.8421052631579
1985,101180,"Jose Clavet",1,1,2,50
1985,101185,"Mark Woodforde",6,4,10,60
1985,101190,"Darren Cahill",11,12,23,47.82608695652174
1985,101195,"Amos Mansdorf",15,13,28,53.57142857142857
1985,101196,"Derrick Rostagno",1,2,3,33.333333333333336
1985,101222,"Stefan Edberg",58,17,75,77.33333333333333
1985,101226,"Johan Carlsson",4,3,7,57.142857142857146
1985,101230,"Andrei Chesnokov",3,3,6,50
1985,101233,"Alex Antonitsch",2,2,4,50
1985,101240,"Martin Hipp",1,1,2,50
1985,101242,"Brad Pearce",2,3,5,40
1985,101256,"Mark Kratzmann",4,3,7,57.142857142857146
1985,101263,"Luke Jensen",1,2,3,33.333333333333336
1985,101274,"Udo Riglewski",2,2,4,50
1985,101276,"Horacio De La Pena",23,17,40,57.5
1985,101285,"Thierry Champion",3,3,6,50
1985,101295,"Toshihisa Tsuchihashi",1,1,2,50
1985,101298,"Jonas Svensson",3,10,13,23.076923076923077
1985,101309,"Jay Berger",3,2,5,60
1985,101332,"Gilad Bloom",1,1,2,50
1985,101340,"Ricky Brown",2,8,10,20
1985,101344,"Bruno Oresar",6,5,11,54.54545454545455
1985,101368,"Christian Miniussi",1,4,5,20
1985,101374,"Leonardo Lavalle",4,5,9,44.44444444444444
1985,101377,"Christian Bergstrom",1,1,2,50
1985,101378,"Tore Meinecke",2,5,7,28.571428571428573
1985,101380,"Amit Naor",1,1,2,50
1985,101381,"Aaron Krickstein",24,20,44,54.54545454545455
1985,101387,"Claudio Pistolesi",4,3,7,57.142857142857146
1985,101404,"Thomas Muster",9,8,17,52.94117647058823
1985,101409,"Jaime Yzaga",4,3,7,57.142857142857146
1985,101414,"Boris Becker",50,18,68,73.52941176470588
1985,101426,"Kent Carlsson",17,12,29,58.62068965517241
1985,101511,"Horst Skoff",1,2,3,33.333333333333336
1985,101650,"Shane Barr",1,2,3,33.333333333333336
1985,101686,"Franco Davin",1,1,2,50
1985,107159,"Hajime Nihonmatsu",1,1,2,50
1985,108007,"Phillip Tuckniss",1,1,2,50
1985,200630,"Alexander Zverev Sr",1,2,3,33.333333333333336
1986,100221,"Carlos Kirmayr",2,10,12,16.666666666666668
1986,100240,"Joao Soares",3,3,6,50
1986,100252,"Tim Gullikson",1,3,4,25
1986,100253,"Tom Gullikson",6,12,18,33.333333333333336
1986,100280,"Wojtek Fibak",5,12,17,29.41176470588235
1986,100282,"Guillermo Vilas",19,14,33,57.57575757575758
1986,100284,"Jimmy Connors",46,15,61,75.40983606557377
1986,100286,"Harold Solomon",4,8,12,33.333333333333336
1986,100300,"Jose Higueras",2,1,3,66.66666666666667
1986,100321,"Vijay Amritraj",8,7,15,53.333333333333336
1986,100326,"Russell Simpson",4,10,14,28.571428571428573
1986,100332,"Balazs Taroczy",2,2,4,50
1986,100337,"Mark Edmondson",3,9,12,25
1986,100343,"John Lloyd",5,9,14,35.714285714285715
1986,100356,"Paul Mcnamee",24,21,45,53.333333333333336
1986,100360,"Brian Teacher",8,13,21,38.095238095238095
1986,100362,"Peter Fleming",6,10,16,37.5
1986,100377,"Colin Dowdeswell",1,1,2,50
1986,100383,"Peter Mcnamara",1,1,2,50
1986,100395,"Victor Pecci",4,6,10,40
1986,100398,"Julio Goes",1,6,7,14.285714285714286
1986,100411,"Pavel Slozil",8,16,24,33.333333333333336
1986,100417,"Hans Gildemeister",3,8,11,27.272727272727273
1986,100427,"Ferrante Rocchi",1,1,2,50
1986,100431,"Mansour Bahrami",5,4,9,55.55555555555556
1986,100434,"Tomas Smid",30,25,55,54.54545454545455
1986,100440,"Eddie Edwards",15,17,32,46.875
1986,100445,"Steve Denton",2,7,9,22.22222222222222
1986,100446,"John Sadri",12,21,33,36.36363636363637
1986,100449,"Stanislav Birner",3,7,10,30
1986,100452,"Bill Scanlon",13,13,26,50
1986,100460,"Jose Lopez Maeso",6,12,18,33.333333333333336
1986,100485,"Tsuyoshi Fukui",1,1,2,50
1986,100489,"Larry Stefanki",4,9,13,30.76923076923077
1986,100490,"Jaroslav Navratil",1,1,2,50
1986,100502,"Vincent Van Patten",2,5,7,28.571428571428573
1986,100515,"Shlomo Glickstein",2,8,10,20
1986,100517,"Matt Doyle",1,2,3,33.333333333333336
1986,100518,"Ricardo Acuna",9,20,29,31.03448275862069
1986,100522,"Chris Dunk",1,1,2,50
1986,100529,"Kevin Curren",36,19,55,65.45454545454545
1986,100530,"Andreas Maurer",17,19,36,47.22222222222222
1986,100532,"Johan Kriek",21,14,35,60
1986,100536,"Fernando Luna",19,14,33,57.57575757575758
1986,100543,"Peter Elter",3,3,6,50
1986,100548,"Ivan Kley",3,2,5,60
1986,100551,"Brad Drewett",6,8,14,42.857142857142854
1986,100553,"Nduka Odizor",5,14,19,26.31578947368421
1986,100556,"Brian Levine",1,3,4,25
1986,100564,"Cary Stansbury",2,2,4,50
1986,100567,"Chip Hooper",5,12,17,29.41176470588235
1986,100570,"Marty Davis",21,25,46,45.65217391304348
1986,100579,"Heinz Gunthardt",4,11,15,26.666666666666668
1986,100581,"John McEnroe",22,5,27,81.48148148148148
1986,100586,"Eliot Teltscher",14,13,27,51.851851851851855
1986,100587,"Steve Guy",2,3,5,40
1986,100595,"Ronnie Bathman",2,8,10,20
1986,100597,"Jay Lapidus",5,7,12,41.666666666666664
1986,100598,"Wolfgang Popp",4,7,11,36.36363636363637
1986,100602,"Vallis Wilder",3,8,11,27.272727272727273
1986,100603,"Roland Stadler",6,3,9,66.66666666666667
1986,100606,"Mike Bauer",2,5,7,28.571428571428573
1986,100607,"Eduardo Bengoechea",13,15,28,46.42857142857143
1986,100611,"Mel Purcell",12,16,28,42.857142857142854
1986,100616,"Andy Kohlberg",1,1,2,50
1986,100617,"Bud Schultz",15,24,39,38.46153846153846
1986,100618,"Leif Shiras",2,5,7,28.571428571428573
1986,100619,"George Kalovelonis",1,1,2,50
1986,100624,"Derek Tarr",1,1,2,50
1986,100628,"Michiel Schapers",20,23,43,46.51162790697674
1986,100631,"Tim Wilkison",33,23,56,58.92857142857143
1986,100635,"Mark Dickson",8,11,19,42.10526315789474
1986,100638,"David Mustard",1,1,2,50
1986,100639,"Blaine Willenborg",5,9,14,35.714285714285715
1986,100646,"Claudio Panatta",7,16,23,30.434782608695652
1986,100651,"Alejandro Ganzabal",3,5,8,37.5
1986,100652,"Cassio Motta",10,10,20,50
1986,100653,"Andres Gomez",57,20,77,74.02597402597402
1986,100656,"Ivan Lendl",75,6,81,92.5925925925926
1986,100657,"Mike Leach",16,23,39,41.02564102564103
1986,100660,"Bob Green",14,16,30,46.666666666666664
1986,100661,"Damir Keretic",16,14,30,53.333333333333336
1986,100663,"Marcel Freeman",14,14,28,50
1986,100669,"Charles Bud Cox",2,5,7,28.571428571428573
1986,100676,"Yannick Noah",43,14,57,75.43859649122807
1986,100689,"Tim Mayotte",26,15,41,63.41463414634146
1986,100690,"Marco Armellini",2,1,3,66.66666666666667
1986,100691,"Ivo Werner",3,4,7,42.857142857142854
1986,100696,"Mark Buckley",2,3,5,40
1986,100701,"Marko Ostoja",10,18,28,35.714285714285715
1986,100711,"Pedro Rebolledo",2,4,6,33.333333333333336
1986,100713,"John Fitzgerald",8,12,20,40
1986,100714,"Broderick Dyke",16,21,37,43.24324324324324
1986,100715,"Jim Gurfein",1,2,3,33.333333333333336
1986,100719,"Juan Avendano",6,10,16,37.5
1986,100728,"Todd Nelson",8,15,23,34.78260869565217
1986,100730,"Florin Segarceanu",4,13,17,23.529411764705884
1986,100738,"Schalk Van Der Merwe",1,1,2,50
1986,100740,"Dan Cassidy",2,6,8,25
1986,100742,"Christo Steyn",22,23,45,48.888888888888886
1986,100747,"Glenn Layendecker",17,17,34,50
1986,100752,"Ramesh Krishnan",31,24,55,56.36363636363637
1986,100757,"Anders Jarryd",32,15,47,68.08510638297872
1986,100759,"Danie Visser",15,14,29,51.724137931034484
1986,100763,"Brad Gilbert",45,14,59,76.27118644067797
1986,100770,"Peter Moraing",4,5,9,44.44444444444444
1986,100772,"Kelly Evernden",2,12,14,14.285714285714286
1986,100776,"Tomm Warneke",3,12,15,20
1986,100780,"Mike De Palmer",9,12,21,42.857142857142854
1986,100782,"Pablo Arraya",23,19,42,54.76190476190476
1986,100790,"Bruce Derlin",4,5,9,44.44444444444444
1986,100794,"Srinivasan Vasudevan",1,1,2,50
1986,100797,"Ben Testerman",8,11,19,42.10526315789474
1986,100799,"Carlos Castellan",1,4,5,20
1986,100800,"Diego Perez",30,25,55,54.54545454545455
1986,100809,"Juan Aguilera",5,14,19,26.31578947368421
1986,100810,"Paul Chamberlin",3,2,5,60
1986,100815,"David Pate",35,23,58,60.3448275862069
1986,100820,"Thierry Pham",2,1,3,66.66666666666667
1986,100825,"Hugo Chapacu",1,1,2,50
1986,100826,"Juan Antonio Rodriguez",1,4,5,20
1986,100829,"Jan Gunnarsson",23,24,47,48.93617021276596
1986,100830,"Gary Donnelly",11,11,22,50
1986,100831,"Rick Rudeen",1,5,6,16.666666666666668
1986,100833,"Marc Flur",3,9,12,25
1986,100836,"Glenn Michibata",7,20,27,25.925925925925927
1986,100837,"Jeremy Bates",9,16,25,36
1986,100844,"Jerome Potier",1,5,6,16.666666666666668
1986,100852,"Howard Herr",1,1,2,50
1986,100855,"Scott Davis",19,19,38,50
1986,100857,"Sergio Casal",23,28,51,45.09803921568628
1986,100863,"Gustavo Luza",1,2,3,33.333333333333336
1986,100864,"Martin Wostenholme",9,18,27,33.333333333333336
1986,100865,"Marcelo Ingaramo",9,15,24,37.5
1986,100866,"Shahar Perkiss",6,11,17,35.294117647058826
1986,100868,"Craig A Miller",2,2,4,50
1986,100870,"Christo Van Rensburg",13,13,26,50
1986,100877,"Brett Dickinson",2,2,4,50
1986,100882,"David Livingston",1,1,2,50
1986,100887,"Eric Korita",1,2,3,33.333333333333336
1986,100893,"Joakim Nystrom",56,18,74,75.67567567567568
1986,100894,"Francesco Cancellotti",7,16,23,30.434782608695652
1986,100899,"Jorgen Windahl",6,9,15,40
1986,100901,"Paul Annacone",18,16,34,52.94117647058823
1986,100905,"Sammy Giammalva Jr",14,18,32,43.75
1986,100910,"Magnus Tideman",1,2,3,33.333333333333336
1986,100913,"Peter Carlsson",3,4,7,42.857142857142854
1986,100917,"Nelson Aerts",3,11,14,21.428571428571427
1986,100920,"Robert Seguso",19,12,31,61.29032258064516
1986,100922,"Roberto Arguello",7,15,22,31.818181818181817
1986,100923,"Wally Masur",17,16,33,51.515151515151516
1986,100926,"Ken Flach",4,15,19,21.05263157894737
1986,100928,"Barry Moir",8,16,24,33.333333333333336
1986,100934,"Matt Anger",20,21,41,48.78048780487805
1986,100935,"Michael Robertson",5,10,15,33.333333333333336
1986,100936,"Henri Leconte",42,14,56,75
1986,100941,"Alex Stepanek",2,8,10,20
1986,100942,"Thierry Tulasne",39,23,62,62.903225806451616
1986,100944,"Mikael Pernfors",36,19,55,65.45454545454545
1986,100946,"Slobodan Zivojinovic",21,21,42,50
1986,100950,"Libor Pimek",26,25,51,50.98039215686274
1986,100954,"Luiz Mattar",6,7,13,46.15384615384615
1986,100956,"Simone Colombo",14,7,21,66.66666666666667
1986,100957,"Greg Holmes",16,17,33,48.484848484848484
1986,100962,"Thomas Hogstedt",2,8,10,20
1986,100964,"Jon Levine",1,4,5,20
1986,100966,"Nick Fulwood",1,1,2,50
1986,100967,"Dan Goldie",8,10,18,44.44444444444444
1986,100970,"Stefan Eriksson",9,16,25,36
1986,100972,"Todd Witsken",13,15,28,46.42857142857143
1986,100978,"Andrew Castle",4,3,7,57.142857142857146
1986,100990,"Milan Srejber",30,23,53,56.60377358490566
1986,101006,"Bruno Dadillon",1,2,3,33.333333333333336
1986,101013,"Henrik Sundstrom",21,19,40,52.5
1986,101018,"Edoardo Mazza",1,1,2,50
1986,101020,"Hans Schwaier",8,22,30,26.666666666666668
1986,101022,"Kelly Jones",5,5,10,50
1986,101026,"Jim Grabb",7,6,13,53.84615384615385
1986,101029,"Ricki Osterthun",15,17,32,46.875
1986,101033,"John Letts",1,1,2,50
1986,101035,"Menno Oosting",4,4,8,50
1986,101036,"Miloslav Mecir",42,18,60,70
1986,101040,"Peter Lindgren",1,3,4,25
1986,101048,"Francisco Maciel",21,16,37,56.75675675675676
1986,101050,"Martin Laurendeau",3,3,6,50
1986,101057,"Peter Carter",1,2,3,33.333333333333336
1986,101058,"Francisco Yunis",1,2,3,33.333333333333336
1986,101061,"Jimmy Arias",18,19,37,48.648648648648646
1986,101062,"Mats Wilander",50,13,63,79.36507936507937
1986,101063,"Jordi Arrese",13,11,24,54.166666666666664
1986,101064,"David Lewis",2,1,3,66.66666666666667
1986,101066,"Richard Matuszewski",6,3,9,66.66666666666667
1986,101073,"Martin Jaite",37,15,52,71.15384615384616
1986,101074,"Carlos Di Laura",4,12,16,25
1986,101076,"Cesar Kist",3,5,8,37.5
1986,101080,"Lawson Duncan",11,18,29,37.93103448275862
1986,101084,"Jakob Hlasek",35,28,63,55.55555555555556
1986,101085,"Corrado Aprili",3,4,7,42.857142857142854
1986,101086,"Ronald Agenor",20,22,42,47.61904761904762
1986,101096,"Gary Muller",2,3,5,40
1986,101098,"Guy Forget",32,23,55,58.18181818181818
1986,101106,"Peter Lundgren",15,22,37,40.54054054054054
1986,101109,"Tarik Benhabiles",7,7,14,50
1986,101110,"David De Miguel",7,12,19,36.8421052631579
1986,101113,"Michael Westphal",12,21,33,36.36363636363637
1986,101115,"Jorge Bardou",2,6,8,25
1986,101117,"Eric Jelen",17,15,32,53.125
1986,101119,"Marian Vajda",17,22,39,43.58974358974359
1986,101120,"Karel Novacek",16,14,30,53.333333333333336
1986,101124,"Paolo Cane",23,14,37,62.16216216216216
1986,101131,"Jimmy Brown",9,18,27,33.333333333333336
1986,101132,"Fredrik Rosenquist",1,2,3,33.333333333333336
1986,101138,"Pat Cash",18,11,29,62.06896551724138
1986,101142,"Emilio Sanchez",52,23,75,69.33333333333333
1986,101145,"Jonathan Canter",27,22,49,55.10204081632653
1986,101147,"Claudio Mezzadri",12,16,28,42.857142857142854
1986,101154,"Simon Youl",5,5,10,50
1986,101155,"James Turner",1,1,2,50
1986,101174,"Fernando Roese",1,1,2,50
1986,101178,"Pieter Aldrich",1,1,2,50
1986,101179,"Jean Philippe Fleurian",6,3,9,66.66666666666667
1986,101180,"Jose Clavet",2,2,4,50
1986,101185,"Mark Woodforde",11,14,25,44
1986,101186,"Desmond Tyson",1,1,2,50
1986,101190,"Darren Cahill",5,6,11,45.45454545454545
1986,101191,"Richey Reneberg",2,3,5,40
1986,101195,"Amos Mansdorf",19,17,36,52.77777777777778
1986,101196,"Derrick Rostagno",8,11,19,42.10526315789474
1986,101216,"Olli Rahnasto",1,3,4,25
1986,101222,"Stefan Edberg",66,20,86,76.74418604651163
1986,101226,"Johan Carlsson",11,9,20,55
1986,101230,"Andrei Chesnokov",13,9,22,59.09090909090909
1986,101233,"Alex Antonitsch",3,4,7,42.857142857142854
1986,101234,"Patrik Kuhnen",1,3,4,25
1986,101242,"Brad Pearce",6,9,15,40
1986,101243,"Roberto Azar",1,2,3,33.333333333333336
1986,101247,"Stephen Botfield",1,1,2,50
1986,101251,"Eric Winogradsky",1,1,2,50
1986,101256,"Mark Kratzmann",5,10,15,33.333333333333336
1986,101263,"Luke Jensen",1,2,3,33.333333333333336
1986,101264,"Michael Tauson",1,1,2,50
1986,101274,"Udo Riglewski",1,2,3,33.333333333333336
1986,101276,"Horacio De La Pena",33,21,54,61.111111111111114
1986,101285,"Thierry Champion",4,11,15,26.666666666666668
1986,101298,"Jonas Svensson",34,19,53,64.15094339622641
1986,101301,"Jan Willem Lodder",1,1,2,50
1986,101309,"Jay Berger",7,3,10,70
1986,101318,"Javier Frana",1,3,4,25
1986,101324,"Ulf Stenlund",20,12,32,62.5
1986,101332,"Gilad Bloom",2,1,3,66.66666666666667
1986,101340,"Ricky Brown",1,4,5,20
1986,101344,"Bruno Oresar",6,10,16,37.5
1986,101354,"Andrew Sznajder",4,4,8,50
1986,101358,"Olivier Delaitre",1,2,3,33.333333333333336
1986,101367,"Igor Saric",1,1,2,50
1986,101368,"Christian Miniussi",7,8,15,46.666666666666664
1986,101372,"Joey Blake",2,2,4,50
1986,101374,"Leonardo Lavalle",10,17,27,37.03703703703704
1986,101377,"Christian Bergstrom",4,7,11,36.36363636363637
1986,101378,"Tore Meinecke",5,8,13,38.46153846153846
1986,101381,"Aaron Krickstein",38,21,59,64.40677966101696
1986,101387,"Claudio Pistolesi",7,12,19,36.8421052631579
1986,101391,"Carl Uwe Steeb",2,4,6,33.333333333333336
1986,101402,"Stephen Furlong",1,1,2,50
1986,101404,"Thomas Muster",18,16,34,52.94117647058823
1986,101409,"Jaime Yzaga",19,18,37,51.351351351351354
1986,101412,"Shuzo Matsuoka",1,3,4,25
1986,101414,"Boris Becker",65,13,78,83.33333333333333
1986,101426,"Kent Carlsson",43,13,56,76.78571428571429
1986,101439,"Javier Sanchez",2,1,3,66.66666666666667
1986,101507,"Tomas Carbonell",1,3,4,25
1986,101511,"Horst Skoff",12,7,19,63.1578947368421
1986,101598,"Eduardo Velez",1,2,3,33.333333333333336
1986,101649,"Guillermo Perez Roldan",9,7,16,56.25
1986,101686,"Franco Davin",8,7,15,53.333333333333336
1986,101736,"Andre Agassi",5,6,11,45.45454545454545
1986,107085,"Gerardo Vacarezza",1,1,2,50
1986,107480,"Karel Demuynck",1,1,2,50
1986,108378,"Thierry Van Den Daele",1,2,3,33.333333333333336
1987,100276,"Terry Moor",1,2,3,33.333333333333336
1987,100282,"Guillermo Vilas",18,14,32,56.25
1987,100284,"Jimmy Connors",52,19,71,73.2394366197183
1987,100321,"Vijay Amritraj",5,6,11,45.45454545454545
1987,100326,"Russell Simpson",3,4,7,42.857142857142854
1987,100337,"Mark Edmondson",1,1,2,50
1987,100356,"Paul Mcnamee",7,16,23,30.434782608695652
1987,100362,"Peter Fleming",4,13,17,23.529411764705884
1987,100395,"Victor Pecci",6,8,14,42.857142857142854
1987,100398,"Julio Goes",2,3,5,40
1987,100431,"Mansour Bahrami",5,7,12,41.666666666666664
1987,100434,"Tomas Smid",30,26,56,53.57142857142857
1987,100440,"Eddie Edwards",8,18,26,30.76923076923077
1987,100446,"John Sadri",8,11,19,42.10526315789474
1987,100449,"Stanislav Birner",3,9,12,25
1987,100452,"Bill Scanlon",16,17,33,48.484848484848484
1987,100460,"Jose Lopez Maeso",2,4,6,33.333333333333336
1987,100485,"Tsuyoshi Fukui",1,2,3,33.333333333333336
1987,100489,"Larry Stefanki",1,2,3,33.333333333333336
1987,100490,"Jaroslav Navratil",10,10,20,50
1987,100502,"Vincent Van Patten",2,2,4,50
1987,100518,"Ricardo Acuna",3,8,11,27.272727272727273
1987,100529,"Kevin Curren",21,17,38,55.26315789473684
1987,100530,"Andreas Maurer",12,18,30,40
1987,100532,"Johan Kriek",26,20,46,56.52173913043478
1987,100536,"Fernando Luna",4,6,10,40
1987,100544,"Tony Mmoh",6,12,18,33.333333333333336
1987,100546,"Eric Fromm",1,1,2,50
1987,100548,"Ivan Kley",1,11,12,8.333333333333334
1987,100551,"Brad Drewett",12,18,30,40
1987,100553,"Nduka Odizor",16,19,35,45.714285714285715
1987,100565,"Lloyd Bourne",2,3,5,40
1987,100567,"Chip Hooper",6,11,17,35.294117647058826
1987,100570,"Marty Davis",16,17,33,48.484848484848484
1987,100581,"John McEnroe",33,11,44,75
1987,100586,"Eliot Teltscher",24,13,37,64.86486486486487
1987,100595,"Ronnie Bathman",1,3,4,25
1987,100597,"Jay Lapidus",4,12,16,25
1987,100598,"Wolfgang Popp",8,10,18,44.44444444444444
1987,100602,"Vallis Wilder",1,1,2,50
1987,100603,"Roland Stadler",4,12,16,25
1987,100606,"Mike Bauer",1,3,4,25
1987,100607,"Eduardo Bengoechea",27,17,44,61.36363636363637
1987,100611,"Mel Purcell",12,23,35,34.285714285714285
1987,100616,"Andy Kohlberg",1,1,2,50
1987,100617,"Bud Schultz",4,8,12,33.333333333333336
1987,100618,"Leif Shiras",4,11,15,26.666666666666668
1987,100624,"Derek Tarr",2,4,6,33.333333333333336
1987,100628,"Michiel Schapers",26,20,46,56.52173913043478
1987,100630,"Gustavo Guerrero",1,1,2,50
1987,100631,"Tim Wilkison",23,20,43,53.48837209302326
1987,100635,"Mark Dickson",9,10,19,47.36842105263158
1987,100639,"Blaine Willenborg",10,11,21,47.61904761904762
1987,100645,"Huub Van Boeckel",2,4,6,33.333333333333336
1987,100646,"Claudio Panatta",8,16,24,33.333333333333336
1987,100652,"Cassio Motta",12,17,29,41.37931034482759
1987,100653,"Andres Gomez",46,18,64,71.875
1987,100656,"Ivan Lendl",75,7,82,91.46341463414635
1987,100657,"Mike Leach",5,13,18,27.77777777777778
1987,100660,"Bob Green",1,6,7,14.285714285714286
1987,100661,"Damir Keretic",15,16,31,48.38709677419355
1987,100663,"Marcel Freeman",12,20,32,37.5
1987,100669,"Charles Bud Cox",4,8,12,33.333333333333336
1987,100676,"Yannick Noah",34,13,47,72.34042553191489
1987,100689,"Tim Mayotte",44,13,57,77.19298245614036
1987,100691,"Ivo Werner",2,4,6,33.333333333333336
1987,100696,"Mark Buckley",3,10,13,23.076923076923077
1987,100711,"Pedro Rebolledo",12,8,20,60
1987,100713,"John Fitzgerald",18,18,36,50
1987,100714,"Broderick Dyke",12,20,32,37.5
1987,100715,"Jim Gurfein",2,3,5,40
1987,100719,"Juan Avendano",4,10,14,28.571428571428573
1987,100728,"Todd Nelson",9,12,21,42.857142857142854
1987,100730,"Florin Segarceanu",1,1,2,50
1987,100740,"Dan Cassidy",4,3,7,57.142857142857146
1987,100742,"Christo Steyn",5,17,22,22.727272727272727
1987,100744,"Peter Doohan",12,15,27,44.44444444444444
1987,100747,"Glenn Layendecker",1,12,13,7.6923076923076925
1987,100751,"Roberto Saad",4,6,10,40
1987,100752,"Ramesh Krishnan",30,24,54,55.55555555555556
1987,100757,"Anders Jarryd",40,20,60,66.66666666666667
1987,100759,"Danie Visser",11,16,27,40.74074074074074
1987,100761,"Danny Saltz",1,1,2,50
1987,100763,"Brad Gilbert",58,24,82,70.73170731707317
1987,100764,"Gabriel Urpi",3,2,5,60
1987,100770,"Peter Moraing",1,6,7,14.285714285714286
1987,100772,"Kelly Evernden",29,18,47,61.702127659574465
1987,100776,"Tomm Warneke",1,2,3,33.333333333333336
1987,100780,"Mike De Palmer",3,10,13,23.076923076923077
1987,100782,"Pablo Arraya",15,20,35,42.857142857142854
1987,100790,"Bruce Derlin",7,4,11,63.63636363636363
1987,100793,"Stephane Bonneau",3,5,8,37.5
1987,100795,"Alvaro Jordan",1,2,3,33.333333333333336
1987,100797,"Ben Testerman",20,21,41,48.78048780487805
1987,100800,"Diego Perez",15,19,34,44.11764705882353
1987,100807,"Marcelo Hennemann",1,2,3,33.333333333333336
1987,100809,"Juan Aguilera",7,8,15,46.666666666666664
1987,100810,"Paul Chamberlin",5,6,11,45.45454545454545
1987,100815,"David Pate",28,18,46,60.869565217391305
1987,100820,"Thierry Pham",1,2,3,33.333333333333336
1987,100825,"Hugo Chapacu",1,1,2,50
1987,100829,"Jan Gunnarsson",21,18,39,53.84615384615385
1987,100830,"Gary Donnelly",1,20,21,4.761904761904762
1987,100833,"Marc Flur",10,11,21,47.61904761904762
1987,100836,"Glenn Michibata",5,8,13,38.46153846153846
1987,100837,"Jeremy Bates",12,10,22,54.54545454545455
1987,100844,"Jerome Potier",4,3,7,57.142857142857146
1987,100848,"Alberto Tous",8,11,19,42.10526315789474
1987,100850,"Wayne Hearn",1,1,2,50
1987,100852,"Howard Herr",1,3,4,25
1987,100853,"Dong Wook Song",1,1,2,50
1987,100855,"Scott Davis",20,21,41,48.78048780487805
1987,100857,"Sergio Casal",21,27,48,43.75
1987,100864,"Martin Wostenholme",2,7,9,22.22222222222222
1987,100865,"Marcelo Ingaramo",1,2,3,33.333333333333336
1987,100866,"Shahar Perkiss",2,2,4,50
1987,100868,"Craig A Miller",2,2,4,50
1987,100870,"Christo Van Rensburg",21,13,34,61.76470588235294
1987,100871,"Laurie Warder",3,5,8,37.5
1987,100876,"Bong Soo Kim",1,1,2,50
1987,100884,"Steve Shaw",5,7,12,41.666666666666664
1987,100893,"Joakim Nystrom",34,18,52,65.38461538461539
1987,100894,"Francesco Cancellotti",16,13,29,55.172413793103445
1987,100899,"Jorgen Windahl",4,7,11,36.36363636363637
1987,100900,"Josef Cihak",5,3,8,62.5
1987,100901,"Paul Annacone",29,20,49,59.183673469387756
1987,100904,"George Bezecny",1,1,2,50
1987,100905,"Sammy Giammalva Jr",16,21,37,43.24324324324324
1987,100910,"Magnus Tideman",1,2,3,33.333333333333336
1987,100913,"Peter Carlsson",2,7,9,22.22222222222222
1987,100920,"Robert Seguso",11,16,27,40.74074074074074
1987,100921,"Patrice Kuchna",3,2,5,60
1987,100922,"Roberto Arguello",1,10,11,9.090909090909092
1987,100923,"Wally Masur",33,20,53,62.264150943396224
1987,100924,"Jorge Lozano",3,8,11,27.272727272727273
1987,100926,"Ken Flach",10,13,23,43.47826086956522
1987,100928,"Barry Moir",7,15,22,31.818181818181817
1987,100930,"Paul Vojtischek",9,11,20,45
1987,100932,"Denys Maasdorp",1,1,2,50
1987,100934,"Matt Anger",16,22,38,42.10526315789474
1987,100935,"Michael Robertson",1,5,6,16.666666666666668
1987,100936,"Henri Leconte",23,19,42,54.76190476190476
1987,100939,"Joey Rive",8,11,19,42.10526315789474
1987,100942,"Thierry Tulasne",27,22,49,55.10204081632653
1987,100944,"Mikael Pernfors",21,16,37,56.75675675675676
1987,100945,"Craig Campbell",2,2,4,50
1987,100946,"Slobodan Zivojinovic",35,21,56,62.5
1987,100950,"Libor Pimek",12,18,30,40
1987,100951,"Alessandro De Minicis",5,5,10,50
1987,100954,"Luiz Mattar",24,17,41,58.53658536585366
1987,100956,"Simone Colombo",5,16,21,23.80952380952381
1987,100957,"Greg Holmes",11,16,27,40.74074074074074
1987,100962,"Thomas Hogstedt",8,15,23,34.78260869565217
1987,100964,"Jon Levine",4,10,14,28.571428571428573
1987,100966,"Nick Fulwood",1,2,3,33.333333333333336
1987,100967,"Dan Goldie",24,19,43,55.81395348837209
1987,100970,"Stefan Eriksson",3,9,12,25
1987,100972,"Todd Witsken",10,16,26,38.46153846153846
1987,100978,"Andrew Castle",8,16,24,33.333333333333336
1987,100982,"Charlton Eagle",1,3,4,25
1987,100985,"Tim Pawsat",1,2,3,33.333333333333336
1987,100990,"Milan Srejber",24,24,48,50
1987,100993,"Loic Courteau",1,2,3,33.333333333333336
1987,100995,"Eduardo Masso",1,2,3,33.333333333333336
1987,100997,"Roger Smith",1,1,2,50
1987,101000,"Carl Limberger",12,22,34,35.294117647058826
1987,101003,"Ricardo Acioly",1,1,2,50
1987,101004,"Jim Pugh",24,20,44,54.54545454545455
1987,101012,"Massimiliano Narducci",1,1,2,50
1987,101013,"Henrik Sundstrom",5,13,18,27.77777777777778
1987,101014,"John Ross",8,9,17,47.05882352941177
1987,101020,"Hans Schwaier",3,10,13,23.076923076923077
1987,101022,"Kelly Jones",9,23,32,28.125
1987,101026,"Jim Grabb",20,18,38,52.63157894736842
1987,101029,"Ricki Osterthun",19,22,41,46.34146341463415
1987,101031,"Massimo Cierro",3,3,6,50
1987,101033,"John Letts",1,3,4,25
1987,101034,"Bobby Banck",1,1,2,50
1987,101035,"Menno Oosting",1,4,5,20
1987,101036,"Miloslav Mecir",71,19,90,78.88888888888889
1987,101040,"Peter Lindgren",1,4,5,20
1987,101048,"Francisco Maciel",4,10,14,28.571428571428573
1987,101050,"Martin Laurendeau",8,10,18,44.44444444444444
1987,101053,"Michael Kures",4,10,14,28.571428571428573
1987,101058,"Francisco Yunis",8,12,20,40
1987,101059,"Richard Vogel",1,2,3,33.333333333333336
1987,101061,"Jimmy Arias",22,18,40,55
1987,101062,"Mats Wilander",65,17,82,79.26829268292683
1987,101063,"Jordi Arrese",9,13,22,40.90909090909091
1987,101066,"Richard Matuszewski",8,16,24,33.333333333333336
1987,101071,"Tom Nijssen",7,9,16,43.75
1987,101073,"Martin Jaite",45,18,63,71.42857142857143
1987,101074,"Carlos Di Laura",2,5,7,28.571428571428573
1987,101080,"Lawson Duncan",6,9,15,40
1987,101084,"Jakob Hlasek",32,21,53,60.37735849056604
1987,101085,"Corrado Aprili",1,9,10,10
1987,101086,"Ronald Agenor",25,20,45,55.55555555555556
1987,101088,"Larry Scott",1,6,7,14.285714285714286
1987,101096,"Gary Muller",15,15,30,50
1987,101097,"Rick Leach",5,11,16,31.25
1987,101098,"Guy Forget",20,20,40,50
1987,101106,"Peter Lundgren",28,17,45,62.22222222222222
1987,101109,"Tarik Benhabiles",12,17,29,41.37931034482759
1987,101110,"David De Miguel",3,10,13,23.076923076923077
1987,101113,"Michael Westphal",5,15,20,25
1987,101115,"Jorge Bardou",3,5,8,37.5
1987,101117,"Eric Jelen",23,21,44,52.27272727272727
1987,101119,"Marian Vajda",24,18,42,57.142857142857146
1987,101120,"Karel Novacek",17,22,39,43.58974358974359
1987,101124,"Paolo Cane",20,16,36,55.55555555555556
1987,101126,"Chris Pridham",1,2,3,33.333333333333336
1987,101131,"Jimmy Brown",10,11,21,47.61904761904762
1987,101138,"Pat Cash",42,17,59,71.1864406779661
1987,101142,"Emilio Sanchez",57,25,82,69.51219512195122
1987,101143,"Branislav Stankovic",1,1,2,50
1987,101144,"Anthony Lane",1,3,4,25
1987,101145,"Jonathan Canter",5,17,22,22.727272727272727
1987,101147,"Claudio Mezzadri",25,16,41,60.97560975609756
1987,101150,"Gianluca Pozzi",1,2,3,33.333333333333336
1987,101154,"Simon Youl",9,14,23,39.130434782608695
1987,101158,"John Frawley",7,5,12,58.333333333333336
1987,101161,"Thomas Haldin",1,1,2,50
1987,101166,"Gustavo Garetto",3,2,5,60
1987,101178,"Pieter Aldrich",1,1,2,50
1987,101179,"Jean Philippe Fleurian",4,11,15,26.666666666666668
1987,101185,"Mark Woodforde",12,13,25,48
1987,101190,"Darren Cahill",17,18,35,48.57142857142857
1987,101191,"Richey Reneberg",15,13,28,53.57142857142857
1987,101195,"Amos Mansdorf",35,21,56,62.5
1987,101196,"Derrick Rostagno",23,23,46,50
1987,101222,"Stefan Edberg",76,12,88,86.36363636363636
1987,101226,"Johan Carlsson",12,19,31,38.70967741935484
1987,101230,"Andrei Chesnokov",24,16,40,60
1987,101232,"Nicklas Kroon",2,2,4,50
1987,101233,"Alex Antonitsch",7,10,17,41.1764705882353
1987,101234,"Patrik Kuhnen",10,12,22,45.45454545454545
1987,101237,"Danilo Marcelino",1,3,4,25
1987,101242,"Brad Pearce",5,16,21,23.80952380952381
1987,101250,"Jose Daher",1,3,4,25
1987,101251,"Eric Winogradsky",7,12,19,36.8421052631579
1987,101256,"Mark Kratzmann",8,14,22,36.36363636363637
1987,101274,"Udo Riglewski",1,2,3,33.333333333333336
1987,101276,"Horacio De La Pena",17,19,36,47.22222222222222
1987,101281,"Shelby Cannon",1,3,4,25
1987,101284,"Lars Anders Wahlgren",2,7,9,22.22222222222222
1987,101285,"Thierry Champion",6,11,17,35.294117647058826
1987,101298,"Jonas Svensson",24,18,42,57.142857142857146
1987,101309,"Jay Berger",28,19,47,59.57446808510638
1987,101314,"Woody Hunt",1,1,2,50
1987,101318,"Javier Frana",6,10,16,37.5
1987,101320,"Magnus Gustafsson",5,4,9,55.55555555555556
1987,101324,"Ulf Stenlund",24,19,43,55.81395348837209
1987,101329,"Christer Allgardh",2,3,5,40
1987,101332,"Gilad Bloom",10,16,26,38.46153846153846
1987,101334,"Alexander Volkov",5,6,11,45.45454545454545
1987,101337,"Martin Strelba",1,1,2,50
1987,101344,"Bruno Oresar",5,9,14,35.714285714285715
1987,101354,"Andrew Sznajder",2,3,5,40
1987,101368,"Christian Miniussi",11,12,23,47.82608695652174
1987,101374,"Leonardo Lavalle",2,9,11,18.181818181818183
1987,101377,"Christian Bergstrom",16,15,31,51.61290322580645
1987,101378,"Tore Meinecke",15,16,31,48.38709677419355
1987,101381,"Aaron Krickstein",14,12,26,53.84615384615385
1987,101382,"Marcelo Filippini",3,4,7,42.857142857142854
1987,101387,"Claudio Pistolesi",12,13,25,48
1987,101391,"Carl Uwe Steeb",10,8,18,55.55555555555556
1987,101404,"Thomas Muster",22,16,38,57.89473684210526
1987,101409,"Jaime Yzaga",23,20,43,53.48837209302326
1987,101412,"Shuzo Matsuoka",1,3,4,25
1987,101414,"Boris Becker",50,15,65,76.92307692307692
1987,101420,"Vaclav Roubicek",1,1,2,50
1987,101426,"Kent Carlsson",35,9,44,79.54545454545455
1987,101434,"Petr Korda",2,1,3,66.66666666666667
1987,101439,"Javier Sanchez",16,19,35,45.714285714285715
1987,101477,"Chris Bailey",2,2,4,50
1987,101481,"Omar Camporese",1,3,4,25
1987,101500,"Christian Saceanu",8,11,19,42.10526315789474
1987,101507,"Tomas Carbonell",4,3,7,57.142857142857146
1987,101511,"Horst Skoff",20,20,40,50
1987,101543,"Jeff Tarango",1,2,3,33.333333333333336
1987,101550,"Al Parker",1,5,6,16.666666666666668
1987,101589,"Arnaud Boetsch",1,3,4,25
1987,101598,"Eduardo Velez",1,1,2,50
1987,101601,"Brett Steven",1,1,2,50
1987,101606,"Alberto Mancini",2,5,7,28.571428571428573
1987,101609,"David Wheaton",3,3,6,50
1987,101649,"Guillermo Perez Roldan",40,15,55,72.72727272727273
1987,101650,"Shane Barr",2,3,5,40
1987,101686,"Franco Davin",14,17,31,45.16129032258065
1987,101710,"Martin Blackman",1,2,3,33.333333333333336
1987,101717,"Diego Nargiso",1,2,3,33.333333333333336
1987,101726,"Boaz Merenstein",1,1,2,50
1987,101727,"Jason Stoltenberg",1,4,5,20
1987,101730,"Piet Norval",1,1,2,50
1987,101736,"Andre Agassi",26,17,43,60.46511627906977
1987,101971,"Johan Anderson",1,1,2,50
1987,102021,"Michael Chang",4,4,8,50
1987,107928,"Pat Serret",1,1,2,50
1987,108243,"Sergio Ribeiro",1,1,2,50
1988,100273,"Kim Warwick",1,1,2,50
1988,100280,"Wojtek Fibak",1,1,2,50
1988,100282,"Guillermo Vilas",11,15,26,42.30769230769231
1988,100284,"Jimmy Connors",40,11,51,78.43137254901961
1988,100321,"Vijay Amritraj",3,4,7,42.857142857142854
1988,100323,"Givaldo Barbosa",1,1,2,50
1988,100356,"Paul Mcnamee",3,2,5,60
1988,100431,"Mansour Bahrami",2,9,11,18.181818181818183
1988,100434,"Tomas Smid",18,23,41,43.90243902439025
1988,100440,"Eddie Edwards",2,6,8,25
1988,100452,"Bill Scanlon",6,12,18,33.333333333333336
1988,100460,"Jose Lopez Maeso",1,1,2,50
1988,100485,"Tsuyoshi Fukui",1,1,2,50
1988,100490,"Jaroslav Navratil",1,13,14,7.142857142857143
1988,100518,"Ricardo Acuna",4,7,11,36.36363636363637
1988,100529,"Kevin Curren",31,15,46,67.3913043478261
1988,100530,"Andreas Maurer",2,9,11,18.181818181818183
1988,100532,"Johan Kriek",25,18,43,58.13953488372093
1988,100536,"Fernando Luna",18,12,30,60
1988,100544,"Tony Mmoh",2,5,7,28.571428571428573
1988,100551,"Brad Drewett",12,13,25,48
1988,100553,"Nduka Odizor",1,7,8,12.5
1988,100570,"Marty Davis",20,25,45,44.44444444444444
1988,100581,"John McEnroe",29,9,38,76.3157894736842
1988,100586,"Eliot Teltscher",11,9,20,55
1988,100587,"Steve Guy",4,7,11,36.36363636363637
1988,100592,"Robert Vant Hof",4,4,8,50
1988,100595,"Ronnie Bathman",2,7,9,22.22222222222222
1988,100598,"Wolfgang Popp",3,6,9,33.333333333333336
1988,100603,"Roland Stadler",1,4,5,20
1988,100606,"Mike Bauer",1,4,5,20
1988,100607,"Eduardo Bengoechea",20,21,41,48.78048780487805
1988,100611,"Mel Purcell",3,6,9,33.333333333333336
1988,100617,"Bud Schultz",2,2,4,50
1988,100618,"Leif Shiras",9,12,21,42.857142857142854
1988,100619,"George Kalovelonis",1,2,3,33.333333333333336
1988,100620,"Eduardo Osta",4,6,10,40
1988,100628,"Michiel Schapers",27,20,47,57.4468085106383
1988,100631,"Tim Wilkison",15,20,35,42.857142857142854
1988,100635,"Mark Dickson",9,9,18,50
1988,100646,"Claudio Panatta",8,7,15,53.333333333333336
1988,100652,"Cassio Motta",7,9,16,43.75
1988,100653,"Andres Gomez",34,18,52,65.38461538461539
1988,100656,"Ivan Lendl",41,8,49,83.6734693877551
1988,100661,"Damir Keretic",7,17,24,29.166666666666668
1988,100663,"Marcel Freeman",1,2,3,33.333333333333336
1988,100669,"Charles Bud Cox",1,3,4,25
1988,100676,"Yannick Noah",32,10,42,76.19047619047619
1988,100689,"Tim Mayotte",48,19,67,71.64179104477611
1988,100694,"Eric Riley",1,1,2,50
1988,100701,"Marko Ostoja",3,5,8,37.5
1988,100711,"Pedro Rebolledo",11,17,28,39.285714285714285
1988,100713,"John Fitzgerald",36,20,56,64.28571428571429
1988,100714,"Broderick Dyke",15,19,34,44.11764705882353
1988,100715,"Jim Gurfein",2,7,9,22.22222222222222
1988,100719,"Juan Avendano",2,5,7,28.571428571428573
1988,100727,"Raul Antonio Viver",2,5,7,28.571428571428573
1988,100728,"Todd Nelson",11,19,30,36.666666666666664
1988,100736,"Hugo Nunez",1,1,2,50
1988,100740,"Dan Cassidy",7,21,28,25
1988,100744,"Peter Doohan",4,13,17,23.529411764705884
1988,100747,"Glenn Layendecker",9,8,17,52.94117647058823
1988,100751,"Roberto Saad",3,7,10,30
1988,100752,"Ramesh Krishnan",30,15,45,66.66666666666667
1988,100757,"Anders Jarryd",27,15,42,64.28571428571429
1988,100759,"Danie Visser",9,13,22,40.90909090909091
1988,100763,"Brad Gilbert",30,15,45,66.66666666666667
1988,100772,"Kelly Evernden",16,24,40,40
1988,100782,"Pablo Arraya",13,16,29,44.827586206896555
1988,100785,"Jesus Colas",2,2,4,50
1988,100790,"Bruce Derlin",2,4,6,33.333333333333336
1988,100800,"Diego Perez",12,17,29,41.37931034482759
1988,100807,"Marcelo Hennemann",3,6,9,33.333333333333336
1988,100809,"Juan Aguilera",11,13,24,45.833333333333336
1988,100810,"Paul Chamberlin",7,13,20,35
1988,100815,"David Pate",20,16,36,55.55555555555556
1988,100820,"Thierry Pham",2,2,4,50
1988,100829,"Jan Gunnarsson",13,15,28,46.42857142857143
1988,100833,"Marc Flur",7,15,22,31.818181818181817
1988,100836,"Glenn Michibata",9,12,21,42.857142857142854
1988,100837,"Jeremy Bates",15,19,34,44.11764705882353
1988,100841,"Jin Sun Yoo",1,2,3,33.333333333333336
1988,100844,"Jerome Potier",13,23,36,36.111111111111114
1988,100848,"Alberto Tous",10,12,22,45.45454545454545
1988,100853,"Dong Wook Song",1,2,3,33.333333333333336
1988,100855,"Scott Davis",12,15,27,44.44444444444444
1988,100857,"Sergio Casal",21,20,41,51.21951219512195
1988,100864,"Martin Wostenholme",3,4,7,42.857142857142854
1988,100865,"Marcelo Ingaramo",5,9,14,35.714285714285715
1988,100866,"Shahar Perkiss",2,2,4,50
1988,100870,"Christo Van Rensburg",24,15,39,61.53846153846154
1988,100871,"Laurie Warder",1,4,5,20
1988,100876,"Bong Soo Kim",2,3,5,40
1988,100880,"Russell Barlow",1,4,5,20
1988,100884,"Steve Shaw",8,11,19,42.10526315789474
1988,100893,"Joakim Nystrom",13,15,28,46.42857142857143
1988,100894,"Francesco Cancellotti",11,16,27,40.74074074074074
1988,100899,"Jorgen Windahl",1,4,5,20
1988,100900,"Josef Cihak",4,9,13,30.76923076923077
1988,100901,"Paul Annacone",25,18,43,58.13953488372093
1988,100903,"Mike Lee",2,1,3,66.66666666666667
1988,100905,"Sammy Giammalva Jr",17,16,33,51.515151515151516
1988,100908,"Tobias Svantesson",7,10,17,41.1764705882353
1988,100910,"Magnus Tideman",1,3,4,25
1988,100920,"Robert Seguso",21,14,35,60
1988,100922,"Roberto Arguello",6,7,13,46.15384615384615
1988,100923,"Wally Masur",26,16,42,61.904761904761905
1988,100924,"Jorge Lozano",14,15,29,48.275862068965516
1988,100926,"Ken Flach",7,12,19,36.8421052631579
1988,100928,"Barry Moir",10,13,23,43.47826086956522
1988,100930,"Paul Vojtischek",4,9,13,30.76923076923077
1988,100931,"Andrew Burrow",3,4,7,42.857142857142854
1988,100934,"Matt Anger",10,17,27,37.03703703703704
1988,100935,"Michael Robertson",6,10,16,37.5
1988,100936,"Henri Leconte",48,20,68,70.58823529411765
1988,100938,"Jaromir Becka",1,1,2,50
1988,100939,"Joey Rive",22,20,42,52.38095238095238
1988,100942,"Thierry Tulasne",19,21,40,47.5
1988,100944,"Mikael Pernfors",31,12,43,72.09302325581395
1988,100946,"Slobodan Zivojinovic",23,16,39,58.97435897435897
1988,100947,"Doug Burke",2,1,3,66.66666666666667
1988,100949,"Mauro Menezes",1,5,6,16.666666666666668
1988,100950,"Libor Pimek",10,20,30,33.333333333333336
1988,100954,"Luiz Mattar",19,17,36,52.77777777777778
1988,100955,"Yahiya Doumbia",16,15,31,51.61290322580645
1988,100956,"Simone Colombo",2,2,4,50
1988,100957,"Greg Holmes",8,14,22,36.36363636363637
1988,100962,"Thomas Hogstedt",3,4,7,42.857142857142854
1988,100966,"Nick Fulwood",1,3,4,25
1988,100967,"Dan Goldie",36,19,55,65.45454545454545
1988,100972,"Todd Witsken",17,16,33,51.515151515151516
1988,100978,"Andrew Castle",8,15,23,34.78260869565217
1988,100985,"Tim Pawsat",2,4,6,33.333333333333336
1988,100989,"Ned Caswell",1,1,2,50
1988,100990,"Milan Srejber",30,23,53,56.60377358490566
1988,100995,"Eduardo Masso",13,14,27,48.148148148148145
1988,100997,"Roger Smith",10,16,26,38.46153846153846
1988,101000,"Carl Limberger",7,13,20,35
1988,101003,"Ricardo Acioly",1,1,2,50
1988,101004,"Jim Pugh",27,27,54,50
1988,101005,"Gerald Marzenell",1,1,2,50
1988,101008,"Peter Palandjian",1,3,4,25
1988,101012,"Massimiliano Narducci",12,16,28,42.857142857142854
1988,101014,"John Ross",9,19,28,32.142857142857146
1988,101018,"Edoardo Mazza",1,1,2,50
1988,101019,"David Felgate",1,4,5,20
1988,101020,"Hans Schwaier",5,9,14,35.714285714285715
1988,101022,"Kelly Jones",2,9,11,18.181818181818183
1988,101026,"Jim Grabb",17,23,40,42.5
1988,101029,"Ricki Osterthun",12,19,31,38.70967741935484
1988,101031,"Massimo Cierro",1,4,5,20
1988,101033,"John Letts",1,5,6,16.666666666666668
1988,101035,"Menno Oosting",10,12,22,45.45454545454545
1988,101036,"Miloslav Mecir",35,13,48,72.91666666666667
1988,101040,"Peter Lindgren",2,10,12,16.666666666666668
1988,101048,"Francisco Maciel",2,7,9,22.22222222222222
1988,101050,"Martin Laurendeau",8,13,21,38.095238095238095
1988,101053,"Michael Kures",4,6,10,40
1988,101055,"Heiner Moraing",2,3,5,40
1988,101057,"Peter Carter",1,4,5,20
1988,101058,"Francisco Yunis",6,11,17,35.294117647058826
1988,101061,"Jimmy Arias",7,14,21,33.333333333333336
1988,101062,"Mats Wilander",51,9,60,85
1988,101063,"Jordi Arrese",18,12,30,60
1988,101064,"David Lewis",3,12,15,20
1988,101066,"Richard Matuszewski",11,10,21,52.38095238095238
1988,101067,"Philip Johnson",3,6,9,33.333333333333336
1988,101068,"Byron Talbot",1,1,2,50
1988,101071,"Tom Nijssen",6,13,19,31.57894736842105
1988,101073,"Martin Jaite",27,21,48,56.25
1988,101074,"Carlos Di Laura",1,3,4,25
1988,101076,"Cesar Kist",2,3,5,40
1988,101080,"Lawson Duncan",21,17,38,55.26315789473684
1988,101084,"Jakob Hlasek",49,15,64,76.5625
1988,101086,"Ronald Agenor",24,18,42,57.142857142857146
1988,101093,"Steve Devries",1,3,4,25
1988,101096,"Gary Muller",8,17,25,32
1988,101097,"Rick Leach",6,12,18,33.333333333333336
1988,101098,"Guy Forget",24,19,43,55.81395348837209
1988,101106,"Peter Lundgren",20,21,41,48.78048780487805
1988,101109,"Tarik Benhabiles",4,12,16,25
1988,101110,"David De Miguel",1,1,2,50
1988,101113,"Michael Westphal",6,9,15,40
1988,101114,"Charles Beckman",1,2,3,33.333333333333336
1988,101117,"Eric Jelen",19,20,39,48.717948717948715
1988,101119,"Marian Vajda",17,23,40,42.5
1988,101120,"Karel Novacek",13,13,26,50
1988,101123,"Alexander Mronz",4,9,13,30.76923076923077
1988,101124,"Paolo Cane",15,18,33,45.45454545454545
1988,101126,"Chris Pridham",13,16,29,44.827586206896555
1988,101131,"Jimmy Brown",13,19,32,40.625
1988,101133,"Patrick Baur",9,14,23,39.130434782608695
1988,101138,"Pat Cash",23,9,32,71.875
1988,101142,"Emilio Sanchez",41,22,63,65.07936507936508
1988,101143,"Branislav Stankovic",4,14,18,22.22222222222222
1988,101145,"Jonathan Canter",2,4,6,33.333333333333336
1988,101147,"Claudio Mezzadri",13,16,29,44.827586206896555
1988,101150,"Gianluca Pozzi",4,8,12,33.333333333333336
1988,101154,"Simon Youl",16,18,34,47.05882352941177
1988,101155,"James Turner",1,2,3,33.333333333333336
1988,101158,"John Frawley",24,21,45,53.333333333333336
1988,101161,"Thomas Haldin",1,5,6,16.666666666666668
1988,101178,"Pieter Aldrich",15,15,30,50
1988,101179,"Jean Philippe Fleurian",3,7,10,30
1988,101180,"Jose Clavet",1,2,3,33.333333333333336
1988,101185,"Mark Woodforde",31,23,54,57.407407407407405
1988,101190,"Darren Cahill",32,23,55,58.18181818181818
1988,101191,"Richey Reneberg",14,19,33,42.42424242424242
1988,101195,"Amos Mansdorf",33,17,50,66
1988,101196,"Derrick Rostagno",31,22,53,58.490566037735846
1988,101204,"Eric Amend",2,1,3,66.66666666666667
1988,101205,"Grant Connell",10,17,27,37.03703703703704
1988,101217,"Andreas Lesch",1,1,2,50
1988,101222,"Stefan Edberg",61,17,78,78.2051282051282
1988,101226,"Johan Carlsson",3,4,7,42.857142857142854
1988,101230,"Andrei Chesnokov",44,17,61,72.1311475409836
1988,101232,"Nicklas Kroon",10,17,27,37.03703703703704
1988,101233,"Alex Antonitsch",4,15,19,21.05263157894737
1988,101234,"Patrik Kuhnen",16,16,32,50
1988,101237,"Danilo Marcelino",6,5,11,54.54545454545455
1988,101238,"Andres Vysand",3,5,8,37.5
1988,101243,"Roberto Azar",3,6,9,33.333333333333336
1988,101247,"Stephen Botfield",1,3,4,25
1988,101249,"Andrei Olhovskiy",6,8,14,42.857142857142854
1988,101250,"Jose Daher",1,3,4,25
1988,101251,"Eric Winogradsky",5,10,15,33.333333333333336
1988,101252,"Brian Page",1,1,2,50
1988,101254,"Peter Svensson",1,1,2,50
1988,101256,"Mark Kratzmann",3,6,9,33.333333333333336
1988,101263,"Luke Jensen",1,3,4,25
1988,101265,"Patrick McEnroe",2,5,7,28.571428571428573
1988,101274,"Udo Riglewski",4,10,14,28.571428571428573
1988,101276,"Horacio De La Pena",27,17,44,61.36363636363637
1988,101278,"Scott Melville",1,2,3,33.333333333333336
1988,101279,"Philippe Pech",2,4,6,33.333333333333336
1988,101285,"Thierry Champion",11,14,25,44
1988,101298,"Jonas Svensson",40,21,61,65.57377049180327
1988,101301,"Jan Willem Lodder",1,1,2,50
1988,101309,"Jay Berger",28,16,44,63.63636363636363
1988,101318,"Javier Frana",15,18,33,45.45454545454545
1988,101320,"Magnus Gustafsson",24,19,43,55.81395348837209
1988,101324,"Ulf Stenlund",6,11,17,35.294117647058826
1988,101329,"Christer Allgardh",8,9,17,47.05882352941177
1988,101332,"Gilad Bloom",6,12,18,33.333333333333336
1988,101334,"Alexander Volkov",7,10,17,41.1764705882353
1988,101337,"Martin Strelba",3,2,5,60
1988,101339,"Agustin Moreno",3,6,9,33.333333333333336
1988,101344,"Bruno Oresar",16,12,28,57.142857142857146
1988,101354,"Andrew Sznajder",1,1,2,50
1988,101358,"Olivier Delaitre",1,4,5,20
1988,101364,"Bret Garnett",1,2,3,33.333333333333336
1988,101365,"Paul Wekesa",3,8,11,27.272727272727273
1988,101368,"Christian Miniussi",9,13,22,40.90909090909091
1988,101374,"Leonardo Lavalle",10,8,18,55.55555555555556
1988,101377,"Christian Bergstrom",18,17,35,51.42857142857143
1988,101378,"Tore Meinecke",14,15,29,48.275862068965516
1988,101381,"Aaron Krickstein",50,24,74,67.56756756756756
1988,101382,"Marcelo Filippini",25,17,42,59.523809523809526
1988,101387,"Claudio Pistolesi",12,17,29,41.37931034482759
1988,101388,"Gerardo Mirad",1,1,2,50
1988,101391,"Carl Uwe Steeb",25,19,44,56.81818181818182
1988,101392,"Dan Goldberg",2,4,6,33.333333333333336
1988,101398,"Neil Borwick",1,1,2,50
1988,101404,"Thomas Muster",47,16,63,74.60317460317461
1988,101406,"Wojtek Kowalski",1,3,4,25
1988,101407,"David Engel",1,4,5,20
1988,101409,"Jaime Yzaga",20,19,39,51.282051282051285
1988,101412,"Shuzo Matsuoka",12,15,27,44.44444444444444
1988,101414,"Boris Becker",50,9,59,84.7457627118644
1988,101420,"Vaclav Roubicek",1,1,2,50
1988,101426,"Kent Carlsson",49,8,57,85.96491228070175
1988,101430,"Sergio Cortes",1,1,2,50
1988,101434,"Petr Korda",6,13,19,31.57894736842105
1988,101439,"Javier Sanchez",19,18,37,51.351351351351354
1988,101451,"Gustavo Giussani",1,4,5,20
1988,101452,"Greg Failla",1,1,2,50
1988,101461,"Brett Custer",1,1,2,50
1988,101462,"Francisco Roig",3,5,8,37.5
1988,101475,"Carlos Costa",2,2,4,50
1988,101476,"Rolf Hertzog",1,1,2,50
1988,101477,"Chris Bailey",1,5,6,16.666666666666668
1988,101481,"Omar Camporese",4,8,12,33.333333333333336
1988,101499,"Eduardo Furusho",1,1,2,50
1988,101500,"Christian Saceanu",21,20,41,51.21951219512195
1988,101504,"Laurent Prades",1,1,2,50
1988,101507,"Tomas Carbonell",7,7,14,50
1988,101511,"Horst Skoff",25,19,44,56.81818181818182
1988,101532,"Francisco Clavet",1,4,5,20
1988,101543,"Jeff Tarango",7,6,13,53.84615384615385
1988,101578,"Markus Rackl",8,11,19,42.10526315789474
1988,101580,"Roger Rasheed",3,3,6,50
1988,101589,"Arnaud Boetsch",1,3,4,25
1988,101606,"Alberto Mancini",30,15,45,66.66666666666667
1988,101613,"Malivai Washington",1,3,4,25
1988,101615,"Otavio Della",1,1,2,50
1988,101632,"Per Henricsson",1,2,3,33.333333333333336
1988,101649,"Guillermo Perez Roldan",43,19,62,69.35483870967742
1988,101650,"Shane Barr",1,5,6,16.666666666666668
1988,101680,"Zeeshan Ali",2,2,4,50
1988,101686,"Franco Davin",9,14,23,39.130434782608695
1988,101710,"Martin Blackman",1,2,3,33.333333333333336
1988,101717,"Diego Nargiso",11,13,24,45.833333333333336
1988,101721,"Markus Zillner",1,2,3,33.333333333333336
1988,101723,"Magnus Larsson",2,2,4,50
1988,101727,"Jason Stoltenberg",13,11,24,54.166666666666664
1988,101730,"Piet Norval",2,1,3,66.66666666666667
1988,101731,"Nuno Marques",2,3,5,40
1988,101735,"Richard Fromberg",5,5,10,50
1988,101736,"Andre Agassi",60,11,71,84.50704225352112
1988,101761,"Jaime Oncins",1,2,3,33.333333333333336
1988,101767,"Lars Jonsson",2,3,5,40
1988,101772,"Andrei Cherkasov",1,2,3,33.333333333333336
1988,101788,"Doug Flach",1,1,2,50
1988,101793,"Jim Courier",21,15,36,58.333333333333336
1988,101809,"Nicolas Pereira",2,2,4,50
1988,101889,"Todd Woodbridge",1,6,7,14.285714285714286
1988,101900,"Nicklas Kulti",3,4,7,42.857142857142854
1988,101932,"Jared Palmer",1,2,3,33.333333333333336
1988,101934,"Paul Dogger",1,2,3,33.333333333333336
1988,101948,"Pete Sampras",10,10,20,50
1988,101961,"Martin Stringari",1,1,2,50
1988,101964,"Goran Ivanisevic",1,4,5,20
1988,101971,"Johan Anderson",3,6,9,33.333333333333336
1988,102001,"German Lopez",1,1,2,50
1988,102021,"Michael Chang",23,13,36,63.888888888888886
1988,102235,"Tommy Ho",1,4,5,20
1988,107058,"Gary Drake",1,1,2,50
1988,107228,"Igor Flego",1,1,2,50
1988,107480,"Karel Demuynck",1,2,3,33.333333333333336
1989,100282,"Guillermo Vilas",2,4,6,33.333333333333336
1989,100284,"Jimmy Connors",31,13,44,70.45454545454545
1989,100321,"Vijay Amritraj",7,9,16,43.75
1989,100323,"Givaldo Barbosa",1,1,2,50
1989,100431,"Mansour Bahrami",3,5,8,37.5
1989,100434,"Tomas Smid",2,9,11,18.181818181818183
1989,100452,"Bill Scanlon",4,5,9,44.44444444444444
1989,100529,"Kevin Curren",33,18,51,64.70588235294117
1989,100532,"Johan Kriek",12,10,22,54.54545454545455
1989,100536,"Fernando Luna",11,16,27,40.74074074074074
1989,100548,"Ivan Kley",1,2,3,33.333333333333336
1989,100551,"Brad Drewett",11,15,26,42.30769230769231
1989,100553,"Nduka Odizor",3,7,10,30
1989,100555,"Jose Luis Clerc",1,4,5,20
1989,100570,"Marty Davis",9,14,23,39.130434782608695
1989,100581,"John McEnroe",45,11,56,80.35714285714286
1989,100587,"Steve Guy",4,8,12,33.333333333333336
1989,100592,"Robert Vant Hof",6,7,13,46.15384615384615
1989,100595,"Ronnie Bathman",2,3,5,40
1989,100607,"Eduardo Bengoechea",18,16,34,52.94117647058823
1989,100618,"Leif Shiras",14,16,30,46.666666666666664
1989,100628,"Michiel Schapers",19,18,37,51.351351351351354
1989,100631,"Tim Wilkison",8,16,24,33.333333333333336
1989,100646,"Claudio Panatta",1,9,10,10
1989,100652,"Cassio Motta",13,16,29,44.827586206896555
1989,100653,"Andres Gomez",32,17,49,65.3061224489796
1989,100656,"Ivan Lendl",80,7,87,91.95402298850574
1989,100661,"Damir Keretic",3,2,5,60
1989,100676,"Yannick Noah",21,14,35,60
1989,100689,"Tim Mayotte",30,17,47,63.829787234042556
1989,100701,"Marko Ostoja",5,10,15,33.333333333333336
1989,100711,"Pedro Rebolledo",4,5,9,44.44444444444444
1989,100713,"John Fitzgerald",15,18,33,45.45454545454545
1989,100714,"Broderick Dyke",8,13,21,38.095238095238095
1989,100727,"Raul Antonio Viver",3,7,10,30
1989,100740,"Dan Cassidy",3,10,13,23.076923076923077
1989,100744,"Peter Doohan",1,5,6,16.666666666666668
1989,100747,"Glenn Layendecker",17,18,35,48.57142857142857
1989,100752,"Ramesh Krishnan",21,17,38,55.26315789473684
1989,100757,"Anders Jarryd",23,15,38,60.526315789473685
1989,100759,"Danie Visser",10,13,23,43.47826086956522
1989,100763,"Brad Gilbert",58,17,75,77.33333333333333
1989,100768,"Nick Brown",4,4,8,50
1989,100772,"Kelly Evernden",30,18,48,62.5
1989,100800,"Diego Perez",17,17,34,50
1989,100807,"Marcelo Hennemann",2,2,4,50
1989,100809,"Juan Aguilera",20,10,30,66.66666666666667
1989,100810,"Paul Chamberlin",28,21,49,57.142857142857146
1989,100815,"David Pate",9,19,28,32.142857142857146
1989,100829,"Jan Gunnarsson",22,18,40,55
1989,100835,"Hans Dieter Beutel",1,1,2,50
1989,100836,"Glenn Michibata",13,21,34,38.23529411764706
1989,100837,"Jeremy Bates",13,12,25,52
1989,100841,"Jin Sun Yoo",1,1,2,50
1989,100844,"Jerome Potier",10,10,20,50
1989,100848,"Alberto Tous",1,3,4,25
1989,100855,"Scott Davis",21,18,39,53.84615384615385
1989,100857,"Sergio Casal",8,12,20,40
1989,100864,"Martin Wostenholme",6,8,14,42.857142857142854
1989,100870,"Christo Van Rensburg",28,15,43,65.11627906976744
1989,100876,"Bong Soo Kim",2,1,3,66.66666666666667
1989,100892,"Alexandre Hocevar",1,2,3,33.333333333333336
1989,100893,"Joakim Nystrom",2,8,10,20
1989,100894,"Francesco Cancellotti",16,17,33,48.484848484848484
1989,100896,"Miguel Nido",9,10,19,47.36842105263158
1989,100900,"Josef Cihak",8,12,20,40
1989,100901,"Paul Annacone",17,18,35,48.57142857142857
1989,100905,"Sammy Giammalva Jr",5,11,16,31.25
1989,100908,"Tobias Svantesson",4,12,16,25
1989,100920,"Robert Seguso",12,16,28,42.857142857142854
1989,100922,"Roberto Arguello",3,7,10,30
1989,100923,"Wally Masur",31,21,52,59.61538461538461
1989,100926,"Ken Flach",6,7,13,46.15384615384615
1989,100928,"Barry Moir",8,9,17,47.05882352941177
1989,100930,"Paul Vojtischek",3,2,5,60
1989,100934,"Matt Anger",3,12,15,20
1989,100935,"Michael Robertson",5,9,14,35.714285714285715
1989,100936,"Henri Leconte",10,11,21,47.61904761904762
1989,100939,"Joey Rive",10,15,25,40
1989,100942,"Thierry Tulasne",10,17,27,37.03703703703704
1989,100944,"Mikael Pernfors",19,16,35,54.285714285714285
1989,100946,"Slobodan Zivojinovic",15,16,31,48.38709677419355
1989,100947,"Doug Burke",5,4,9,55.55555555555556
1989,100949,"Mauro Menezes",1,5,6,16.666666666666668
1989,100954,"Luiz Mattar",23,15,38,60.526315789473685
1989,100956,"Simone Colombo",6,7,13,46.15384615384615
1989,100957,"Greg Holmes",3,4,7,42.857142857142854
1989,100962,"Thomas Hogstedt",8,10,18,44.44444444444444
1989,100965,"Peter Ballauff",2,3,5,40
1989,100966,"Nick Fulwood",2,2,4,50
1989,100967,"Dan Goldie",12,14,26,46.15384615384615
1989,100972,"Todd Witsken",21,16,37,56.75675675675676
1989,100974,"Jeff Klaparda",1,1,2,50
1989,100978,"Andrew Castle",1,6,7,14.285714285714286
1989,100989,"Ned Caswell",1,4,5,20
1989,100990,"Milan Srejber",14,23,37,37.83783783783784
1989,100995,"Eduardo Masso",4,10,14,28.571428571428573
1989,100997,"Roger Smith",6,10,16,37.5
1989,101000,"Carl Limberger",6,12,18,33.333333333333336
1989,101004,"Jim Pugh",20,18,38,52.63157894736842
1989,101007,"Guillermo Rivas",6,8,14,42.857142857142854
1989,101009,"John Sobel",1,2,3,33.333333333333336
1989,101012,"Massimiliano Narducci",3,6,9,33.333333333333336
1989,101014,"John Ross",2,6,8,25
1989,101016,"Marcos Aurelio Gorriz",1,2,3,33.333333333333336
1989,101020,"Hans Schwaier",1,1,2,50
1989,101021,"Dean Botha",2,1,3,66.66666666666667
1989,101022,"Kelly Jones",10,8,18,55.55555555555556
1989,101024,"Christian Geyer",2,2,4,50
1989,101026,"Jim Grabb",27,20,47,57.4468085106383
1989,101027,"Jaroslav Bulant",1,5,6,16.666666666666668
1989,101029,"Ricki Osterthun",4,8,12,33.333333333333336
1989,101030,"Goran Prpic",15,9,24,62.5
1989,101031,"Massimo Cierro",6,8,14,42.857142857142854
1989,101033,"John Letts",1,1,2,50
1989,101035,"Menno Oosting",1,4,5,20
1989,101036,"Miloslav Mecir",19,17,36,52.77777777777778
1989,101050,"Martin Laurendeau",5,9,14,35.714285714285715
1989,101055,"Heiner Moraing",2,4,6,33.333333333333336
1989,101058,"Francisco Yunis",4,5,9,44.44444444444444
1989,101061,"Jimmy Arias",17,17,34,50
1989,101062,"Mats Wilander",31,15,46,67.3913043478261
1989,101063,"Jordi Arrese",22,19,41,53.65853658536585
1989,101064,"David Lewis",1,3,4,25
1989,101066,"Richard Matuszewski",16,22,38,42.10526315789474
1989,101067,"Philip Johnson",5,7,12,41.666666666666664
1989,101071,"Tom Nijssen",12,15,27,44.44444444444444
1989,101073,"Martin Jaite",50,14,64,78.125
1989,101080,"Lawson Duncan",25,22,47,53.191489361702125
1989,101084,"Jakob Hlasek",24,20,44,54.54545454545455
1989,101086,"Ronald Agenor",24,17,41,58.53658536585366
1989,101096,"Gary Muller",12,11,23,52.17391304347826
1989,101097,"Rick Leach",4,8,12,33.333333333333336
1989,101098,"Guy Forget",15,10,25,60
1989,101106,"Peter Lundgren",12,14,26,46.15384615384615
1989,101109,"Tarik Benhabiles",2,2,4,50
1989,101113,"Michael Westphal",5,7,12,41.666666666666664
1989,101117,"Eric Jelen",22,14,36,61.111111111111114
1989,101119,"Marian Vajda",14,17,31,45.16129032258065
1989,101120,"Karel Novacek",16,13,29,55.172413793103445
1989,101123,"Alexander Mronz",3,11,14,21.428571428571427
1989,101124,"Paolo Cane",24,14,38,63.1578947368421
1989,101126,"Chris Pridham",7,11,18,38.888888888888886
1989,101131,"Jimmy Brown",13,18,31,41.935483870967744
1989,101133,"Patrick Baur",4,9,13,30.76923076923077
1989,101138,"Pat Cash",4,2,6,66.66666666666667
1989,101142,"Emilio Sanchez",37,16,53,69.81132075471699
1989,101145,"Jonathan Canter",6,13,19,31.57894736842105
1989,101147,"Claudio Mezzadri",11,16,27,40.74074074074074
1989,101150,"Gianluca Pozzi",7,11,18,38.888888888888886
1989,101154,"Simon Youl",13,15,28,46.42857142857143
1989,101158,"John Frawley",3,13,16,18.75
1989,101172,"Royce Deppe",1,2,3,33.333333333333336
1989,101174,"Fernando Roese",1,4,5,20
1989,101178,"Pieter Aldrich",13,19,32,40.625
1989,101179,"Jean Philippe Fleurian",12,11,23,52.17391304347826
1989,101180,"Jose Clavet",2,4,6,33.333333333333336
1989,101185,"Mark Woodforde",21,17,38,55.26315789473684
1989,101189,"Stefan Lochbihler",3,7,10,30
1989,101190,"Darren Cahill",24,21,45,53.333333333333336
1989,101191,"Richey Reneberg",23,21,44,52.27272727272727
1989,101195,"Amos Mansdorf",29,19,48,60.416666666666664
1989,101196,"Derrick Rostagno",16,18,34,47.05882352941177
1989,101205,"Grant Connell",8,11,19,42.10526315789474
1989,101214,"Bryan Shelton",1,3,4,25
1989,101215,"Scott Warner",3,7,10,30
1989,101216,"Olli Rahnasto",5,13,18,27.77777777777778
1989,101222,"Stefan Edberg",61,16,77,79.22077922077922
1989,101224,"Kenny Thorne",1,3,4,25
1989,101225,"Jens Peter",1,1,2,50
1989,101226,"Johan Carlsson",7,15,22,31.818181818181817
1989,101230,"Andrei Chesnokov",30,16,46,65.21739130434783
1989,101232,"Nicklas Kroon",15,8,23,65.21739130434783
1989,101233,"Alex Antonitsch",10,10,20,50
1989,101234,"Patrik Kuhnen",15,13,28,53.57142857142857
1989,101235,"Paul Haarhuis",9,7,16,56.25
1989,101237,"Danilo Marcelino",4,13,17,23.529411764705884
1989,101238,"Andres Vysand",5,12,17,29.41176470588235
1989,101242,"Brad Pearce",3,6,9,33.333333333333336
1989,101243,"Roberto Azar",14,14,28,50
1989,101249,"Andrei Olhovskiy",4,10,14,28.571428571428573
1989,101251,"Eric Winogradsky",4,10,14,28.571428571428573
1989,101255,"Greg Van Emburgh",2,1,3,66.66666666666667
1989,101256,"Mark Kratzmann",11,14,25,44
1989,101262,"Rikard Bergh",1,2,3,33.333333333333336
1989,101263,"Luke Jensen",1,4,5,20
1989,101264,"Michael Tauson",5,5,10,50
1989,101265,"Patrick McEnroe",1,5,6,16.666666666666668
1989,101274,"Udo Riglewski",9,16,25,36
1989,101276,"Horacio De La Pena",15,17,32,46.875
1989,101279,"Philippe Pech",1,4,5,20
1989,101281,"Shelby Cannon",1,3,4,25
1989,101282,"Martin Barba",2,4,6,33.333333333333336
1989,101284,"Lars Anders Wahlgren",4,4,8,50
1989,101285,"Thierry Champion",3,9,12,25
1989,101293,"Ted Scherman",1,1,2,50
1989,101295,"Toshihisa Tsuchihashi",1,2,3,33.333333333333336
1989,101298,"Jonas Svensson",25,20,45,55.55555555555556
1989,101308,"Neil Broad",6,13,19,31.57894736842105
1989,101309,"Jay Berger",41,19,60,68.33333333333333
1989,101312,"Robbie Weiss",3,7,10,30
1989,101314,"Woody Hunt",1,1,2,50
1989,101315,"Enrico Cocchi",1,1,2,50
1989,101318,"Javier Frana",9,16,25,36
1989,101320,"Magnus Gustafsson",23,18,41,56.09756097560975
1989,101321,"Juan Carlos Baguena",1,6,7,14.285714285714286
1989,101327,"Cyril Suk",1,6,7,14.285714285714286
1989,101329,"Christer Allgardh",4,6,10,40
1989,101330,"Tim Donovan",3,2,5,60
1989,101332,"Gilad Bloom",5,6,11,45.45454545454545
1989,101334,"Alexander Volkov",19,17,36,52.77777777777778
1989,101337,"Martin Strelba",17,16,33,51.515151515151516
1989,101339,"Agustin Moreno",2,8,10,20
1989,101344,"Bruno Oresar",9,14,23,39.130434782608695
1989,101354,"Andrew Sznajder",14,9,23,60.869565217391305
1989,101358,"Olivier Delaitre",10,14,24,41.666666666666664
1989,101364,"Bret Garnett",2,6,8,25
1989,101365,"Paul Wekesa",4,7,11,36.36363636363637
1989,101370,"Paolo Pambianco",4,4,8,50
1989,101371,"Malcolm Allen",1,5,6,16.666666666666668
1989,101373,"Karsten Braasch",2,3,5,40
1989,101374,"Leonardo Lavalle",11,15,26,42.30769230769231
1989,101377,"Christian Bergstrom",11,14,25,44
1989,101378,"Tore Meinecke",4,7,11,36.36363636363637
1989,101380,"Amit Naor",1,1,2,50
1989,101381,"Aaron Krickstein",50,20,70,71.42857142857143
1989,101382,"Marcelo Filippini",27,18,45,60
1989,101387,"Claudio Pistolesi",12,11,23,52.17391304347826
1989,101391,"Carl Uwe Steeb",35,17,52,67.3076923076923
1989,101393,"Jens Woehrmann",9,5,14,64.28571428571429
1989,101404,"Thomas Muster",18,10,28,64.28571428571429
1989,101407,"David Engel",1,5,6,16.666666666666668
1989,101409,"Jaime Yzaga",32,16,48,66.66666666666667
1989,101412,"Shuzo Matsuoka",8,11,19,42.10526315789474
1989,101414,"Boris Becker",58,8,66,87.87878787878788
1989,101420,"Vaclav Roubicek",1,1,2,50
1989,101421,"Veli Paloheimo",6,8,14,42.857142857142854
1989,101422,"Mark Kaplan",1,2,3,33.333333333333336
1989,101426,"Kent Carlsson",5,6,11,45.45454545454545
1989,101427,"Ruben Gajardo",1,1,2,50
1989,101430,"Sergio Cortes",3,2,5,60
1989,101434,"Petr Korda",13,8,21,61.904761904761905
1989,101436,"George Cosac",1,1,2,50
1989,101439,"Javier Sanchez",26,19,45,57.77777777777778
1989,101440,"Mark Koevermans",12,11,23,52.17391304347826
1989,101441,"Martin Sinner",1,2,3,33.333333333333336
1989,101451,"Gustavo Giussani",7,12,19,36.8421052631579
1989,101459,"Tomas Nydahl",5,9,14,35.714285714285715
1989,101460,"Jose Francisco Altur",6,3,9,66.66666666666667
1989,101462,"Francisco Roig",6,7,13,46.15384615384615
1989,101469,"Brian Garrow",1,2,3,33.333333333333336
1989,101475,"Carlos Costa",2,5,7,28.571428571428573
1989,101477,"Chris Bailey",9,10,19,47.36842105263158
1989,101481,"Omar Camporese",15,14,29,51.724137931034484
1989,101482,"Markus Zoecke",4,3,7,57.142857142857146
1989,101483,"Ricardo Camargo",1,1,2,50
1989,101500,"Christian Saceanu",13,18,31,41.935483870967744
1989,101507,"Tomas Carbonell",15,15,30,50
1989,101510,"Henrik Holm",1,1,2,50
1989,101511,"Horst Skoff",35,22,57,61.40350877192982
1989,101529,"Michael Stich",11,12,23,47.82608695652174
1989,101532,"Francisco Clavet",5,6,11,45.45454545454545
1989,101534,"Libor Nemecek",4,3,7,57.142857142857146
1989,101543,"Jeff Tarango",10,11,21,47.61904761904762
1989,101546,"Mike Brown",2,2,4,50
1989,101552,"Xavier Daufresne",2,2,4,50
1989,101561,"Nicklas Utgren",1,1,2,50
1989,101574,"Alejandro Aramburu",3,8,11,27.272727272727273
1989,101580,"Roger Rasheed",1,1,2,50
1989,101581,"Jose Luis Aparisi",3,5,8,37.5
1989,101589,"Arnaud Boetsch",3,6,9,33.333333333333336
1989,101593,"Chris Garner",4,8,12,33.333333333333336
1989,101601,"Brett Steven",1,1,2,50
1989,101606,"Alberto Mancini",35,16,51,68.62745098039215
1989,101609,"David Wheaton",18,16,34,52.94117647058823
1989,101613,"Malivai Washington",2,5,7,28.571428571428573
1989,101649,"Guillermo Perez Roldan",35,18,53,66.0377358490566
1989,101650,"Shane Barr",2,3,5,40
1989,101663,"Eugenio Rossi",1,1,2,50
1989,101668,"Peter Nyborg",1,3,4,25
1989,101680,"Zeeshan Ali",1,6,7,14.285714285714286
1989,101686,"Franco Davin",23,12,35,65.71428571428571
1989,101703,"Guillaume Raoux",1,6,7,14.285714285714286
1989,101717,"Diego Nargiso",11,19,30,36.666666666666664
1989,101725,"Gabriel Markus",1,3,4,25
1989,101726,"Boaz Merenstein",1,1,2,50
1989,101727,"Jason Stoltenberg",20,18,38,52.63157894736842
1989,101731,"Nuno Marques",3,10,13,23.076923076923077
1989,101735,"Richard Fromberg",7,13,20,35
1989,101736,"Andre Agassi",37,17,54,68.51851851851852
1989,101745,"Roberto Jabali",2,2,4,50
1989,101746,"Renzo Furlan",3,5,8,37.5
1989,101750,"Cristiano Caratti",1,2,3,33.333333333333336
1989,101767,"Lars Jonsson",4,5,9,44.44444444444444
1989,101772,"Andrei Cherkasov",13,16,29,44.827586206896555
1989,101783,"Mark Petchey",1,2,3,33.333333333333336
1989,101789,"Steve Bryan",2,5,7,28.571428571428573
1989,101793,"Jim Courier",30,18,48,62.5
1989,101809,"Nicolas Pereira",12,21,33,36.36363636363637
1989,101820,"Marc Rosset",7,2,9,77.77777777777777
1989,101843,"Sergi Bruguera",23,13,36,63.888888888888886
1989,101861,"Thomas Buchmayer",3,2,5,60
1989,101866,"David Rikl",1,1,2,50
1989,101889,"Todd Woodbridge",6,6,12,50
1989,101900,"Nicklas Kulti",7,9,16,43.75
1989,101914,"Lars Koslowski",1,1,2,50
1989,101924,"Stefano Pescosolido",2,5,7,28.571428571428573
1989,101932,"Jared Palmer",3,2,5,60
1989,101948,"Pete Sampras",18,19,37,48.648648648648646
1989,101964,"Goran Ivanisevic",29,23,52,55.76923076923077
1989,101971,"Johan Anderson",9,7,16,56.25
1989,102001,"German Lopez",1,3,4,25
1989,102019,"Dirk Dier",1,1,2,50
1989,102021,"Michael Chang",45,17,62,72.58064516129032
1989,102148,"Fabrice Santoro",3,6,9,33.333333333333336
1989,106887,"Dominic Durand",1,1,2,50
1989,107172,"Harald Mair",1,1,2,50
1989,107861,"Nicolas Romero",1,1,2,50
1990,100431,"Mansour Bahrami",1,4,5,20
1990,100529,"Kevin Curren",20,19,39,51.282051282051285
1990,100536,"Fernando Luna",8,10,18,44.44444444444444
1990,100548,"Ivan Kley",2,1,3,66.66666666666667
1990,100551,"Brad Drewett",1,3,4,25
1990,100553,"Nduka Odizor",3,5,8,37.5
1990,100581,"John McEnroe",33,15,48,68.75
1990,100586,"Eliot Teltscher",1,2,3,33.333333333333336
1990,100587,"Steve Guy",4,4,8,50
1990,100607,"Eduardo Bengoechea",5,8,13,38.46153846153846
1990,100618,"Leif Shiras",8,18,26,30.76923076923077
1990,100628,"Michiel Schapers",5,13,18,27.77777777777778
1990,100631,"Tim Wilkison",7,13,20,35
1990,100652,"Cassio Motta",10,16,26,38.46153846153846
1990,100653,"Andres Gomez",38,27,65,58.46153846153846
1990,100656,"Ivan Lendl",54,12,66,81.81818181818181
1990,100676,"Yannick Noah",22,21,43,51.16279069767442
1990,100689,"Tim Mayotte",18,19,37,48.648648648648646
1990,100711,"Pedro Rebolledo",2,3,5,40
1990,100713,"John Fitzgerald",6,13,19,31.57894736842105
1990,100714,"Broderick Dyke",5,11,16,31.25
1990,100747,"Glenn Layendecker",12,14,26,46.15384615384615
1990,100752,"Ramesh Krishnan",21,21,42,50
1990,100757,"Anders Jarryd",14,13,27,51.851851851851855
1990,100759,"Danie Visser",5,5,10,50
1990,100763,"Brad Gilbert",47,22,69,68.1159420289855
1990,100768,"Nick Brown",4,5,9,44.44444444444444
1990,100772,"Kelly Evernden",15,23,38,39.473684210526315
1990,100782,"Pablo Arraya",2,3,5,40
1990,100788,"Joseph Russell",2,1,3,66.66666666666667
1990,100790,"Bruce Derlin",3,5,8,37.5
1990,100800,"Diego Perez",12,18,30,40
1990,100809,"Juan Aguilera",31,19,50,62
1990,100810,"Paul Chamberlin",14,23,37,37.83783783783784
1990,100815,"David Pate",16,15,31,51.61290322580645
1990,100829,"Jan Gunnarsson",8,21,29,27.586206896551722
1990,100837,"Jeremy Bates",6,18,24,25
1990,100844,"Jerome Potier",7,15,22,31.818181818181817
1990,100855,"Scott Davis",24,22,46,52.17391304347826
1990,100857,"Sergio Casal",3,7,10,30
1990,100864,"Martin Wostenholme",10,19,29,34.48275862068966
1990,100865,"Marcelo Ingaramo",1,4,5,20
1990,100866,"Shahar Perkiss",1,2,3,33.333333333333336
1990,100870,"Christo Van Rensburg",24,21,45,53.333333333333336
1990,100892,"Alexandre Hocevar",3,2,5,60
1990,100894,"Francesco Cancellotti",1,5,6,16.666666666666668
1990,100896,"Miguel Nido",6,10,16,37.5
1990,100899,"Jorgen Windahl",1,1,2,50
1990,100901,"Paul Annacone",10,17,27,37.03703703703704
1990,100918,"Harald Rittersbacher",1,1,2,50
1990,100920,"Robert Seguso",1,5,6,16.666666666666668
1990,100922,"Roberto Arguello",1,4,5,20
1990,100923,"Wally Masur",24,22,46,52.17391304347826
1990,100924,"Jorge Lozano",2,4,6,33.333333333333336
1990,100926,"Ken Flach",3,6,9,33.333333333333336
1990,100930,"Paul Vojtischek",6,9,15,40
1990,100935,"Michael Robertson",1,2,3,33.333333333333336
1990,100936,"Henri Leconte",25,17,42,59.523809523809526
1990,100939,"Joey Rive",14,21,35,40
1990,100942,"Thierry Tulasne",5,13,18,27.77777777777778
1990,100944,"Mikael Pernfors",4,6,10,40
1990,100945,"Craig Campbell",1,1,2,50
1990,100946,"Slobodan Zivojinovic",3,11,14,21.428571428571427
1990,100954,"Luiz Mattar",25,18,43,58.13953488372093
1990,100956,"Simone Colombo",3,4,7,42.857142857142854
1990,100962,"Thomas Hogstedt",12,26,38,31.57894736842105
1990,100965,"Peter Ballauff",1,3,4,25
1990,100967,"Dan Goldie",24,26,50,48
1990,100972,"Todd Witsken",23,20,43,53.48837209302326
1990,100990,"Milan Srejber",20,27,47,42.5531914893617
1990,100995,"Eduardo Masso",5,6,11,45.45454545454545
1990,100997,"Roger Smith",2,2,4,50
1990,101000,"Carl Limberger",3,2,5,60
1990,101004,"Jim Pugh",13,15,28,46.42857142857143
1990,101009,"John Sobel",1,1,2,50
1990,101014,"John Ross",1,4,5,20
1990,101016,"Marcos Aurelio Gorriz",2,9,11,18.181818181818183
1990,101022,"Kelly Jones",13,22,35,37.142857142857146
1990,101026,"Jim Grabb",16,18,34,47.05882352941177
1990,101029,"Ricki Osterthun",1,2,3,33.333333333333336
1990,101030,"Goran Prpic",30,21,51,58.8235294117647
1990,101031,"Massimo Cierro",2,3,5,40
1990,101036,"Miloslav Mecir",9,8,17,52.94117647058823
1990,101050,"Martin Laurendeau",4,11,15,26.666666666666668
1990,101058,"Francisco Yunis",1,2,3,33.333333333333336
1990,101061,"Jimmy Arias",24,26,50,48
1990,101062,"Mats Wilander",21,13,34,61.76470588235294
1990,101063,"Jordi Arrese",29,21,50,58
1990,101064,"David Lewis",1,1,2,50
1990,101066,"Richard Matuszewski",4,9,13,30.76923076923077
1990,101071,"Tom Nijssen",3,13,16,18.75
1990,101073,"Martin Jaite",32,21,53,60.37735849056604
1990,101080,"Lawson Duncan",12,18,30,40
1990,101084,"Jakob Hlasek",41,22,63,65.07936507936508
1990,101086,"Ronald Agenor",33,25,58,56.89655172413793
1990,101093,"Steve Devries",1,1,2,50
1990,101096,"Gary Muller",19,20,39,48.717948717948715
1990,101097,"Rick Leach",3,7,10,30
1990,101098,"Guy Forget",38,23,61,62.295081967213115
1990,101106,"Peter Lundgren",15,18,33,45.45454545454545
1990,101109,"Tarik Benhabiles",12,17,29,41.37931034482759
1990,101117,"Eric Jelen",23,23,46,50
1990,101119,"Marian Vajda",14,16,30,46.666666666666664
1990,101120,"Karel Novacek",31,29,60,51.666666666666664
1990,101123,"Alexander Mronz",11,11,22,50
1990,101124,"Paolo Cane",15,16,31,48.38709677419355
1990,101126,"Chris Pridham",2,7,9,22.22222222222222
1990,101131,"Jimmy Brown",4,15,19,21.05263157894737
1990,101133,"Patrick Baur",5,5,10,50
1990,101138,"Pat Cash",18,10,28,64.28571428571429
1990,101142,"Emilio Sanchez",48,24,72,66.66666666666667
1990,101145,"Jonathan Canter",5,5,10,50
1990,101147,"Claudio Mezzadri",2,3,5,40
1990,101150,"Gianluca Pozzi",1,8,9,11.11111111111111
1990,101154,"Simon Youl",7,15,22,31.818181818181817
1990,101165,"Mario Tabares",1,3,4,25
1990,101174,"Fernando Roese",1,5,6,16.666666666666668
1990,101178,"Pieter Aldrich",6,4,10,60
1990,101179,"Jean Philippe Fleurian",23,29,52,44.23076923076923
1990,101184,"Damir Buljevic",1,1,2,50
1990,101185,"Mark Woodforde",12,12,24,50
1990,101190,"Darren Cahill",22,19,41,53.65853658536585
1990,101191,"Richey Reneberg",37,25,62,59.67741935483871
1990,101195,"Amos Mansdorf",39,23,62,62.903225806451616
1990,101196,"Derrick Rostagno",21,18,39,53.84615384615385
1990,101205,"Grant Connell",19,21,40,47.5
1990,101214,"Bryan Shelton",9,17,26,34.61538461538461
1990,101222,"Stefan Edberg",68,15,83,81.92771084337349
1990,101224,"Kenny Thorne",1,1,2,50
1990,101226,"Johan Carlsson",5,5,10,50
1990,101230,"Andrei Chesnokov",43,20,63,68.25396825396825
1990,101232,"Nicklas Kroon",15,18,33,45.45454545454545
1990,101233,"Alex Antonitsch",26,21,47,55.319148936170215
1990,101234,"Patrik Kuhnen",23,22,45,51.111111111111114
1990,101235,"Paul Haarhuis",20,25,45,44.44444444444444
1990,101237,"Danilo Marcelino",4,4,8,50
1990,101242,"Brad Pearce",22,17,39,56.41025641025641
1990,101243,"Roberto Azar",13,18,31,41.935483870967744
1990,101249,"Andrei Olhovskiy",4,4,8,50
1990,101251,"Eric Winogradsky",3,4,7,42.857142857142854
1990,101252,"Brian Page",1,1,2,50
1990,101256,"Mark Kratzmann",21,23,44,47.72727272727273
1990,101262,"Rikard Bergh",1,2,3,33.333333333333336
1990,101264,"Michael Tauson",7,6,13,53.84615384615385
1990,101265,"Patrick McEnroe",13,12,25,52
1990,101274,"Udo Riglewski",15,23,38,39.473684210526315
1990,101276,"Horacio De La Pena",20,14,34,58.8235294117647
1990,101278,"Scott Melville",3,1,4,75
1990,101284,"Lars Anders Wahlgren",5,15,20,25
1990,101285,"Thierry Champion",15,16,31,48.38709677419355
1990,101298,"Jonas Svensson",42,20,62,67.74193548387096
1990,101308,"Neil Broad",1,2,3,33.333333333333336
1990,101309,"Jay Berger",32,18,50,64
1990,101311,"Kent Kinnear",1,1,2,50
1990,101312,"Robbie Weiss",13,8,21,61.904761904761905
1990,101318,"Javier Frana",1,3,4,25
1990,101320,"Magnus Gustafsson",26,16,42,61.904761904761905
1990,101321,"Juan Carlos Baguena",2,2,4,50
1990,101332,"Gilad Bloom",25,21,46,54.34782608695652
1990,101334,"Alexander Volkov",34,29,63,53.96825396825397
1990,101337,"Martin Strelba",10,23,33,30.303030303030305
1990,101344,"Bruno Oresar",7,16,23,30.434782608695652
1990,101354,"Andrew Sznajder",17,17,34,50
1990,101358,"Olivier Delaitre",6,16,22,27.272727272727273
1990,101364,"Bret Garnett",1,2,3,33.333333333333336
1990,101365,"Paul Wekesa",2,2,4,50
1990,101370,"Paolo Pambianco",1,2,3,33.333333333333336
1990,101374,"Leonardo Lavalle",5,9,14,35.714285714285715
1990,101377,"Christian Bergstrom",17,19,36,47.22222222222222
1990,101380,"Amit Naor",1,1,2,50
1990,101381,"Aaron Krickstein",37,26,63,58.73015873015873
1990,101382,"Marcelo Filippini",24,22,46,52.17391304347826
1990,101387,"Claudio Pistolesi",8,18,26,30.76923076923077
1990,101391,"Carl Uwe Steeb",22,23,45,48.888888888888886
1990,101393,"Jens Woehrmann",9,18,27,33.333333333333336
1990,101398,"Neil Borwick",1,4,5,20
1990,101404,"Thomas Muster",45,18,63,71.42857142857143
1990,101407,"David Engel",10,13,23,43.47826086956522
1990,101409,"Jaime Yzaga",18,20,38,47.36842105263158
1990,101412,"Shuzo Matsuoka",9,13,22,40.90909090909091
1990,101414,"Boris Becker",71,15,86,82.55813953488372
1990,101416,"Joao Cunha Silva",3,7,10,30
1990,101421,"Veli Paloheimo",20,18,38,52.63157894736842
1990,101422,"Mark Kaplan",5,9,14,35.714285714285715
1990,101429,"Stephane Grenier",1,1,2,50
1990,101432,"Dimitri Poliakov",1,2,3,33.333333333333336
1990,101434,"Petr Korda",23,26,49,46.93877551020408
1990,101439,"Javier Sanchez",22,23,45,48.888888888888886
1990,101440,"Mark Koevermans",26,19,45,57.77777777777778
1990,101441,"Martin Sinner",4,4,8,50
1990,101448,"Tasos Bavelas",1,1,2,50
1990,101459,"Tomas Nydahl",2,2,4,50
1990,101460,"Jose Francisco Altur",5,15,20,25
1990,101462,"Francisco Roig",5,9,14,35.714285714285715
1990,101469,"Brian Garrow",9,11,20,45
1990,101475,"Carlos Costa",6,8,14,42.857142857142854
1990,101481,"Omar Camporese",28,21,49,57.142857142857146
1990,101482,"Markus Zoecke",6,16,22,27.272727272727273
1990,101500,"Christian Saceanu",3,9,12,25
1990,101507,"Tomas Carbonell",25,23,48,52.083333333333336
1990,101510,"Henrik Holm",2,3,5,40
1990,101511,"Horst Skoff",31,22,53,58.490566037735846
1990,101529,"Michael Stich",29,23,52,55.76923076923077
1990,101532,"Francisco Clavet",11,15,26,42.30769230769231
1990,101543,"Jeff Tarango",11,17,28,39.285714285714285
1990,101552,"Xavier Daufresne",1,4,5,20
1990,101561,"Nicklas Utgren",3,3,6,50
1990,101574,"Alejandro Aramburu",1,2,3,33.333333333333336
1990,101576,"Ryuso Tsujino",1,1,2,50
1990,101589,"Arnaud Boetsch",2,4,6,33.333333333333336
1990,101591,"Danny Sapsford",2,3,5,40
1990,101593,"Chris Garner",6,9,15,40
1990,101598,"Eduardo Velez",1,1,2,50
1990,101601,"Brett Steven",1,3,4,25
1990,101606,"Alberto Mancini",11,18,29,37.93103448275862
1990,101609,"David Wheaton",35,20,55,63.63636363636363
1990,101611,"Cedric Pioline",5,12,17,29.41176470588235
1990,101613,"Malivai Washington",13,16,29,44.827586206896555
1990,101632,"Per Henricsson",1,2,3,33.333333333333336
1990,101642,"Bart Wuyts",3,5,8,37.5
1990,101649,"Guillermo Perez Roldan",41,21,62,66.12903225806451
1990,101660,"Francisco Montana",1,1,2,50
1990,101686,"Franco Davin",33,20,53,62.264150943396224
1990,101703,"Guillaume Raoux",6,9,15,40
1990,101715,"Jose Antonio Pepe Conde",1,1,2,50
1990,101717,"Diego Nargiso",4,6,10,40
1990,101723,"Magnus Larsson",15,9,24,62.5
1990,101725,"Gabriel Markus",1,3,4,25
1990,101727,"Jason Stoltenberg",17,19,36,47.22222222222222
1990,101730,"Piet Norval",1,1,2,50
1990,101731,"Nuno Marques",4,8,12,33.333333333333336
1990,101733,"Jan Siemerink",5,4,9,55.55555555555556
1990,101735,"Richard Fromberg",29,21,50,58
1990,101736,"Andre Agassi",43,10,53,81.13207547169812
1990,101746,"Renzo Furlan",9,8,17,52.94117647058823
1990,101750,"Cristiano Caratti",5,2,7,71.42857142857143
1990,101767,"Lars Jonsson",12,17,29,41.37931034482759
1990,101772,"Andrei Cherkasov",35,29,64,54.6875
1990,101774,"Todd Martin",3,4,7,42.857142857142854
1990,101776,"Sandon Stolle",2,3,5,40
1990,101783,"Mark Petchey",1,3,4,25
1990,101789,"Steve Bryan",1,4,5,20
1990,101792,"Slava Dosedel",1,3,4,25
1990,101793,"Jim Courier",42,22,64,65.625
1990,101797,"Jacco Eltingh",3,2,5,60
1990,101809,"Nicolas Pereira",5,15,20,25
1990,101820,"Marc Rosset",35,23,58,60.3448275862069
1990,101843,"Sergi Bruguera",35,25,60,58.333333333333336
1990,101851,"Alexis Hombrecher",3,4,7,42.857142857142854
1990,101862,"Maurice Ruah",2,1,3,66.66666666666667
1990,101889,"Todd Woodbridge",16,17,33,48.484848484848484
1990,101900,"Nicklas Kulti",15,11,26,57.69230769230769
1990,101901,"Chuck Adams",2,3,5,40
1990,101924,"Stefano Pescosolido",4,11,15,26.666666666666668
1990,101932,"Jared Palmer",1,2,3,33.333333333333336
1990,101948,"Pete Sampras",51,19,70,72.85714285714286
1990,101955,"Luis Herrera",1,3,4,25
1990,101964,"Goran Ivanisevic",49,23,72,68.05555555555556
1990,101965,"Wayne Ferreira",2,5,7,28.571428571428573
1990,101971,"Johan Anderson",8,15,23,34.78260869565217
1990,102000,"Aki Rahunen",20,23,43,46.51162790697674
1990,102001,"German Lopez",3,4,7,42.857142857142854
1990,102021,"Michael Chang",34,19,53,64.15094339622641
1990,102026,"Jan Kodes Jr",1,3,4,25
1990,102085,"Sasa Hirszon",1,2,3,33.333333333333336
1990,102148,"Fabrice Santoro",15,16,31,48.38709677419355
1990,102154,"Marcos Ondruska",3,3,6,50
1990,102235,"Tommy Ho",2,2,4,50
1990,102302,"Marcelo Saliola",1,1,2,50
1990,102375,"Dinu Pescariu",1,1,2,50
1990,106695,"Carlos Claverie",1,1,2,50
1990,107093,"Gil Kovalski",1,1,2,50
1990,107617,"Magnus Nilsson",1,1,2,50
1991,100284,"Jimmy Connors",19,14,33,57.57575757575758
1991,100529,"Kevin Curren",18,20,38,47.36842105263158
1991,100532,"Johan Kriek",3,7,10,30
1991,100581,"John McEnroe",32,18,50,64
1991,100607,"Eduardo Bengoechea",3,3,6,50
1991,100628,"Michiel Schapers",6,5,11,54.54545454545455
1991,100652,"Cassio Motta",2,8,10,20
1991,100653,"Andres Gomez",20,19,39,51.282051282051285
1991,100656,"Ivan Lendl",55,18,73,75.34246575342466
1991,100676,"Yannick Noah",7,7,14,50
1991,100689,"Tim Mayotte",12,13,25,48
1991,100711,"Pedro Rebolledo",1,11,12,8.333333333333334
1991,100713,"John Fitzgerald",5,7,12,41.666666666666664
1991,100728,"Todd Nelson",2,3,5,40
1991,100747,"Glenn Layendecker",6,8,14,42.857142857142854
1991,100752,"Ramesh Krishnan",9,18,27,33.333333333333336
1991,100757,"Anders Jarryd",26,21,47,55.319148936170215
1991,100759,"Danie Visser",1,2,3,33.333333333333336
1991,100763,"Brad Gilbert",34,24,58,58.62068965517241
1991,100768,"Nick Brown",2,3,5,40
1991,100772,"Kelly Evernden",4,13,17,23.529411764705884
1991,100782,"Pablo Arraya",9,10,19,47.36842105263158
1991,100790,"Bruce Derlin",1,2,3,33.333333333333336
1991,100800,"Diego Perez",5,9,14,35.714285714285715
1991,100809,"Juan Aguilera",4,18,22,18.181818181818183
1991,100815,"David Pate",11,18,29,37.93103448275862
1991,100829,"Jan Gunnarsson",15,17,32,46.875
1991,100836,"Glenn Michibata",5,6,11,45.45454545454545
1991,100837,"Jeremy Bates",4,5,9,44.44444444444444
1991,100855,"Scott Davis",9,22,31,29.032258064516128
1991,100864,"Martin Wostenholme",6,7,13,46.15384615384615
1991,100870,"Christo Van Rensburg",15,14,29,51.724137931034484
1991,100894,"Francesco Cancellotti",1,3,4,25
1991,100901,"Paul Annacone",2,3,5,40
1991,100917,"Nelson Aerts",1,1,2,50
1991,100923,"Wally Masur",26,24,50,52
1991,100936,"Henri Leconte",8,12,20,40
1991,100943,"Girts Dzelde",1,1,2,50
1991,100944,"Mikael Pernfors",4,7,11,36.36363636363637
1991,100946,"Slobodan Zivojinovic",3,5,8,37.5
1991,100949,"Mauro Menezes",1,2,3,33.333333333333336
1991,100950,"Libor Pimek",1,4,5,20
1991,100954,"Luiz Mattar",17,24,41,41.46341463414634
1991,100962,"Thomas Hogstedt",11,23,34,32.35294117647059
1991,100967,"Dan Goldie",8,15,23,34.78260869565217
1991,100972,"Todd Witsken",12,16,28,42.857142857142854
1991,100978,"Andrew Castle",1,6,7,14.285714285714286
1991,100990,"Milan Srejber",1,3,4,25
1991,100995,"Eduardo Masso",15,19,34,44.11764705882353
1991,100997,"Roger Smith",2,1,3,66.66666666666667
1991,101003,"Ricardo Acioly",1,1,2,50
1991,101004,"Jim Pugh",1,8,9,11.11111111111111
1991,101016,"Marcos Aurelio Gorriz",4,3,7,57.142857142857146
1991,101022,"Kelly Jones",1,6,7,14.285714285714286
1991,101026,"Jim Grabb",19,23,42,45.23809523809524
1991,101030,"Goran Prpic",38,30,68,55.88235294117647
1991,101031,"Massimo Cierro",3,4,7,42.857142857142854
1991,101035,"Menno Oosting",2,2,4,50
1991,101050,"Martin Laurendeau",4,7,11,36.36363636363637
1991,101058,"Francisco Yunis",1,1,2,50
1991,101059,"Richard Vogel",2,2,4,50
1991,101061,"Jimmy Arias",23,19,42,54.76190476190476
1991,101062,"Mats Wilander",9,10,19,47.36842105263158
1991,101063,"Jordi Arrese",36,22,58,62.06896551724138
1991,101071,"Tom Nijssen",3,5,8,37.5
1991,101073,"Martin Jaite",24,21,45,53.333333333333336
1991,101084,"Jakob Hlasek",47,26,73,64.38356164383562
1991,101086,"Ronald Agenor",16,27,43,37.2093023255814
1991,101093,"Steve Devries",1,3,4,25
1991,101096,"Gary Muller",15,23,38,39.473684210526315
1991,101098,"Guy Forget",57,19,76,75
1991,101106,"Peter Lundgren",13,25,38,34.21052631578947
1991,101109,"Tarik Benhabiles",5,11,16,31.25
1991,101117,"Eric Jelen",14,25,39,35.8974358974359
1991,101119,"Marian Vajda",18,26,44,40.90909090909091
1991,101120,"Karel Novacek",56,29,85,65.88235294117646
1991,101123,"Alexander Mronz",16,25,41,39.02439024390244
1991,101124,"Paolo Cane",8,6,14,57.142857142857146
1991,101126,"Chris Pridham",3,5,8,37.5
1991,101131,"Jimmy Brown",3,8,11,27.272727272727273
1991,101133,"Patrick Baur",17,22,39,43.58974358974359
1991,101138,"Pat Cash",14,11,25,56
1991,101142,"Emilio Sanchez",42,23,65,64.61538461538461
1991,101147,"Claudio Mezzadri",5,7,12,41.666666666666664
1991,101150,"Gianluca Pozzi",16,13,29,55.172413793103445
1991,101154,"Simon Youl",5,9,14,35.714285714285715
1991,101174,"Fernando Roese",8,8,16,50
1991,101179,"Jean Philippe Fleurian",20,28,48,41.666666666666664
1991,101185,"Mark Woodforde",12,21,33,36.36363636363637
1991,101190,"Darren Cahill",15,6,21,71.42857142857143
1991,101191,"Richey Reneberg",32,18,50,64
1991,101195,"Amos Mansdorf",21,25,46,45.65217391304348
1991,101196,"Derrick Rostagno",39,24,63,61.904761904761905
1991,101205,"Grant Connell",20,21,41,48.78048780487805
1991,101214,"Bryan Shelton",17,12,29,58.62068965517241
1991,101222,"Stefan Edberg",76,15,91,83.51648351648352
1991,101226,"Johan Carlsson",6,6,12,50
1991,101230,"Andrei Chesnokov",28,21,49,57.142857142857146
1991,101232,"Nicklas Kroon",4,10,14,28.571428571428573
1991,101233,"Alex Antonitsch",10,15,25,40
1991,101234,"Patrik Kuhnen",21,24,45,46.666666666666664
1991,101235,"Paul Haarhuis",25,25,50,50
1991,101237,"Danilo Marcelino",10,13,23,43.47826086956522
1991,101238,"Andres Vysand",1,5,6,16.666666666666668
1991,101242,"Brad Pearce",2,19,21,9.523809523809524
1991,101243,"Roberto Azar",8,13,21,38.095238095238095
1991,101249,"Andrei Olhovskiy",4,10,14,28.571428571428573
1991,101250,"Jose Daher",2,2,4,50
1991,101251,"Eric Winogradsky",2,2,4,50
1991,101256,"Mark Kratzmann",5,13,18,27.77777777777778
1991,101265,"Patrick McEnroe",29,21,50,58
1991,101274,"Udo Riglewski",10,20,30,33.333333333333336
1991,101276,"Horacio De La Pena",16,20,36,44.44444444444444
1991,101278,"Scott Melville",1,1,2,50
1991,101284,"Lars Anders Wahlgren",2,3,5,40
1991,101285,"Thierry Champion",24,29,53,45.283018867924525
1991,101298,"Jonas Svensson",24,21,45,53.333333333333336
1991,101309,"Jay Berger",2,3,5,40
1991,101311,"Kent Kinnear",2,2,4,50
1991,101312,"Robbie Weiss",5,8,13,38.46153846153846
1991,101317,"John Sullivan",1,1,2,50
1991,101318,"Javier Frana",23,15,38,60.526315789473685
1991,101320,"Magnus Gustafsson",51,17,68,75
1991,101332,"Gilad Bloom",15,24,39,38.46153846153846
1991,101334,"Alexander Volkov",44,30,74,59.45945945945946
1991,101341,"Pablo Albano",1,1,2,50
1991,101344,"Bruno Oresar",3,2,5,60
1991,101354,"Andrew Sznajder",4,14,18,22.22222222222222
1991,101358,"Olivier Delaitre",19,11,30,63.333333333333336
1991,101360,"Mark Keil",3,3,6,50
1991,101362,"Stephane Simian",2,3,5,40
1991,101364,"Bret Garnett",1,2,3,33.333333333333336
1991,101368,"Christian Miniussi",12,4,16,75
1991,101370,"Paolo Pambianco",1,1,2,50
1991,101373,"Karsten Braasch",2,3,5,40
1991,101374,"Leonardo Lavalle",5,3,8,62.5
1991,101377,"Christian Bergstrom",29,23,52,55.76923076923077
1991,101381,"Aaron Krickstein",31,21,52,59.61538461538461
1991,101382,"Marcelo Filippini",9,21,30,30
1991,101387,"Claudio Pistolesi",5,13,18,27.77777777777778
1991,101391,"Carl Uwe Steeb",27,28,55,49.09090909090909
1991,101393,"Jens Woehrmann",2,4,6,33.333333333333336
1991,101398,"Neil Borwick",2,8,10,20
1991,101404,"Thomas Muster",30,18,48,62.5
1991,101406,"Wojtek Kowalski",1,2,3,33.333333333333336
1991,101407,"David Engel",6,11,17,35.294117647058826
1991,101409,"Jaime Yzaga",24,17,41,58.53658536585366
1991,101412,"Shuzo Matsuoka",23,19,42,54.76190476190476
1991,101413,"Felix Barrientos",2,2,4,50
1991,101414,"Boris Becker",46,13,59,77.96610169491525
1991,101416,"Joao Cunha Silva",1,9,10,10
1991,101421,"Veli Paloheimo",12,20,32,37.5
1991,101422,"Mark Kaplan",1,4,5,20
1991,101432,"Dimitri Poliakov",12,11,23,52.17391304347826
1991,101434,"Petr Korda",44,22,66,66.66666666666667
1991,101437,"Seung Ho Ji",1,1,2,50
1991,101439,"Javier Sanchez",36,28,64,56.25
1991,101440,"Mark Koevermans",16,25,41,39.02439024390244
1991,101441,"Martin Sinner",3,6,9,33.333333333333336
1991,101460,"Jose Francisco Altur",2,13,15,13.333333333333334
1991,101462,"Francisco Roig",9,11,20,45
1991,101469,"Brian Garrow",2,12,14,14.285714285714286
1991,101475,"Carlos Costa",15,13,28,53.57142857142857
1991,101481,"Omar Camporese",36,25,61,59.01639344262295
1991,101482,"Markus Zoecke",13,12,25,52
1991,101490,"Daniel Orsanic",2,7,9,22.22222222222222
1991,101500,"Christian Saceanu",15,20,35,42.857142857142854
1991,101504,"Laurent Prades",1,2,3,33.333333333333336
1991,101507,"Tomas Carbonell",14,26,40,35
1991,101510,"Henrik Holm",6,12,18,33.333333333333336
1991,101511,"Horst Skoff",34,29,63,53.96825396825397
1991,101513,"John Stimpson",1,3,4,25
1991,101516,"Joao Zwetsch",1,1,2,50
1991,101529,"Michael Stich",70,24,94,74.46808510638297
1991,101532,"Francisco Clavet",38,26,64,59.375
1991,101534,"Libor Nemecek",1,1,2,50
1991,101543,"Jeff Tarango",16,23,39,41.02564102564103
1991,101549,"Rodolphe Gilbert",11,17,28,39.285714285714285
1991,101589,"Arnaud Boetsch",22,18,40,55
1991,101590,"Eui Jong Chang",1,1,2,50
1991,101591,"Danny Sapsford",2,3,5,40
1991,101593,"Chris Garner",8,11,19,42.10526315789474
1991,101594,"Carsten Arriens",1,2,3,33.333333333333336
1991,101601,"Brett Steven",1,5,6,16.666666666666668
1991,101606,"Alberto Mancini",25,17,42,59.523809523809526
1991,101609,"David Wheaton",33,19,52,63.46153846153846
1991,101611,"Cedric Pioline",21,20,41,51.21951219512195
1991,101613,"Malivai Washington",33,22,55,60
1991,101630,"Clement Ngoran",1,1,2,50
1991,101642,"Bart Wuyts",7,17,24,29.166666666666668
1991,101647,"Byron Black",2,3,5,40
1991,101649,"Guillermo Perez Roldan",26,17,43,60.46511627906977
1991,101659,"Jan Apell",1,3,4,25
1991,101660,"Francisco Montana",2,3,5,40
1991,101668,"Peter Nyborg",2,1,3,66.66666666666667
1991,101674,"Rudiger Haas",1,2,3,33.333333333333336
1991,101686,"Franco Davin",12,16,28,42.857142857142854
1991,101703,"Guillaume Raoux",14,25,39,35.8974358974359
1991,101711,"Alex Obrien",1,1,2,50
1991,101715,"Jose Antonio Pepe Conde",1,2,3,33.333333333333336
1991,101717,"Diego Nargiso",9,14,23,39.130434782608695
1991,101719,"Frederic Fontang",11,10,21,52.38095238095238
1991,101721,"Markus Zillner",3,1,4,75
1991,101723,"Magnus Larsson",21,21,42,50
1991,101725,"Gabriel Markus",11,10,21,52.38095238095238
1991,101727,"Jason Stoltenberg",20,20,40,50
1991,101731,"Nuno Marques",8,14,22,36.36363636363637
1991,101733,"Jan Siemerink",30,21,51,58.8235294117647
1991,101735,"Richard Fromberg",18,20,38,47.36842105263158
1991,101736,"Andre Agassi",36,17,53,67.9245283018868
1991,101745,"Roberto Jabali",1,2,3,33.333333333333336
1991,101746,"Renzo Furlan",22,26,48,45.833333333333336
1991,101750,"Cristiano Caratti",22,22,44,50
1991,101761,"Jaime Oncins",22,17,39,56.41025641025641
1991,101767,"Lars Jonsson",21,18,39,53.84615384615385
1991,101772,"Andrei Cherkasov",39,30,69,56.52173913043478
1991,101774,"Todd Martin",10,8,18,55.55555555555556
1991,101775,"Frederik Fetterlein",1,1,2,50
1991,101776,"Sandon Stolle",5,7,12,41.666666666666664
1991,101783,"Mark Petchey",1,3,4,25
1991,101789,"Steve Bryan",5,3,8,62.5
1991,101792,"Slava Dosedel",4,13,17,23.529411764705884
1991,101793,"Jim Courier",57,17,74,77.02702702702703
1991,101797,"Jacco Eltingh",12,24,36,33.333333333333336
1991,101809,"Nicolas Pereira",2,6,8,25
1991,101812,"Raviv Weidenfeld",1,1,2,50
1991,101820,"Marc Rosset",18,31,49,36.734693877551024
1991,101823,"Gerald Mandl",1,2,3,33.333333333333336
1991,101835,"Arne Thoms",3,2,5,60
1991,101843,"Sergi Bruguera",49,22,71,69.01408450704226
1991,101857,"Jason Cask",1,1,2,50
1991,101861,"Thomas Buchmayer",1,2,3,33.333333333333336
1991,101862,"Maurice Ruah",2,5,7,28.571428571428573
1991,101866,"David Rikl",1,3,4,25
1991,101871,"Alexander Reichel",1,1,2,50
1991,101888,"Daniel Vacek",1,3,4,25
1991,101889,"Todd Woodbridge",23,25,48,47.916666666666664
1991,101890,"Jonathan Stark",1,3,4,25
1991,101897,"Fernando Meligeni",2,2,4,50
1991,101900,"Nicklas Kulti",18,24,42,42.857142857142854
1991,101901,"Chuck Adams",10,12,22,45.45454545454545
1991,101912,"Felipe Rivera",3,4,7,42.857142857142854
1991,101914,"Lars Koslowski",4,2,6,66.66666666666667
1991,101917,"Grant Stafford",5,6,11,45.45454545454545
1991,101920,"Jamie Morgan",1,8,9,11.11111111111111
1991,101924,"Stefano Pescosolido",10,16,26,38.46153846153846
1991,101932,"Jared Palmer",1,3,4,25
1991,101948,"Pete Sampras",52,17,69,75.3623188405797
1991,101955,"Luis Herrera",13,23,36,36.111111111111114
1991,101956,"Mark Knowles",2,3,5,40
1991,101958,"Pierre Bouteyre",1,1,2,50
1991,101961,"Martin Stringari",1,1,2,50
1991,101964,"Goran Ivanisevic",37,23,60,61.666666666666664
1991,101965,"Wayne Ferreira",26,21,47,55.319148936170215
1991,101971,"Johan Anderson",5,8,13,38.46153846153846
1991,101977,"Patricio Arnold",1,1,2,50
1991,101990,"Richard Krajicek",26,20,46,56.52173913043478
1991,102000,"Aki Rahunen",6,18,24,25
1991,102001,"German Lopez",11,9,20,55
1991,102021,"Michael Chang",47,20,67,70.14925373134328
1991,102110,"Daniel Nestor",1,2,3,33.333333333333336
1991,102148,"Fabrice Santoro",26,21,47,55.319148936170215
1991,102154,"Marcos Ondruska",3,5,8,37.5
1991,102169,"Michael Joyce",1,1,2,50
1991,102205,"Sebastien Lareau",1,1,2,50
1991,102226,"David Witt",2,4,6,33.333333333333336
1991,102233,"Leander Paes",1,2,3,33.333333333333336
1991,102235,"Tommy Ho",2,4,6,33.333333333333336
1991,102302,"Marcelo Saliola",2,2,4,50
1991,102344,"Karol Kucera",1,1,2,50
1991,102358,"Thomas Enqvist",1,5,6,16.666666666666668
1991,102375,"Dinu Pescariu",3,3,6,50
1991,102446,"Andrei Medvedev",5,7,12,41.666666666666664
1991,107798,"Miguel Merz",1,1,2,50
1991,210013,"Martin Damm Sr",2,1,3,66.66666666666667
1992,100284,"Jimmy Connors",17,16,33,51.515151515151516
1992,100529,"Kevin Curren",12,17,29,41.37931034482759
1992,100581,"John McEnroe",32,18,50,64
1992,100628,"Michiel Schapers",17,26,43,39.53488372093023
1992,100652,"Cassio Motta",5,5,10,50
1992,100653,"Andres Gomez",10,12,22,45.45454545454545
1992,100656,"Ivan Lendl",51,24,75,68
1992,100713,"John Fitzgerald",10,11,21,47.61904761904762
1992,100747,"Glenn Layendecker",2,4,6,33.333333333333336
1992,100752,"Ramesh Krishnan",4,5,9,44.44444444444444
1992,100757,"Anders Jarryd",11,17,28,39.285714285714285
1992,100763,"Brad Gilbert",39,26,65,60
1992,100772,"Kelly Evernden",5,5,10,50
1992,100782,"Pablo Arraya",7,11,18,38.888888888888886
1992,100800,"Diego Perez",11,10,21,52.38095238095238
1992,100815,"David Pate",1,4,5,20
1992,100829,"Jan Gunnarsson",3,9,12,25
1992,100837,"Jeremy Bates",7,12,19,36.8421052631579
1992,100855,"Scott Davis",3,3,6,50
1992,100865,"Marcelo Ingaramo",1,2,3,33.333333333333336
1992,100870,"Christo Van Rensburg",12,22,34,35.294117647058826
1992,100901,"Paul Annacone",1,4,5,20
1992,100923,"Wally Masur",38,28,66,57.57575757575758
1992,100936,"Henri Leconte",19,17,36,52.77777777777778
1992,100943,"Girts Dzelde",2,5,7,28.571428571428573
1992,100944,"Mikael Pernfors",1,3,4,25
1992,100954,"Luiz Mattar",21,17,38,55.26315789473684
1992,100962,"Thomas Hogstedt",5,8,13,38.46153846153846
1992,100972,"Todd Witsken",14,18,32,43.75
1992,100995,"Eduardo Masso",3,14,17,17.647058823529413
1992,101000,"Carl Limberger",3,12,15,20
1992,101016,"Marcos Aurelio Gorriz",12,19,31,38.70967741935484
1992,101022,"Kelly Jones",1,2,3,33.333333333333336
1992,101026,"Jim Grabb",31,24,55,56.36363636363637
1992,101030,"Goran Prpic",18,22,40,45
1992,101031,"Massimo Cierro",1,10,11,9.090909090909092
1992,101050,"Martin Laurendeau",4,6,10,40
1992,101058,"Francisco Yunis",2,2,4,50
1992,101061,"Jimmy Arias",4,8,12,33.333333333333336
1992,101063,"Jordi Arrese",31,22,53,58.490566037735846
1992,101066,"Richard Matuszewski",2,2,4,50
1992,101071,"Tom Nijssen",4,6,10,40
1992,101073,"Martin Jaite",18,19,37,48.648648648648646
1992,101084,"Jakob Hlasek",26,26,52,50
1992,101086,"Ronald Agenor",5,16,21,23.80952380952381
1992,101096,"Gary Muller",12,17,29,41.37931034482759
1992,101098,"Guy Forget",45,23,68,66.17647058823529
1992,101106,"Peter Lundgren",5,8,13,38.46153846153846
1992,101108,"Richard Schmidt",1,2,3,33.333333333333336
1992,101120,"Karel Novacek",40,24,64,62.5
1992,101123,"Alexander Mronz",6,13,19,31.57894736842105
1992,101124,"Paolo Cane",7,10,17,41.1764705882353
1992,101126,"Chris Pridham",14,16,30,46.666666666666664
1992,101131,"Jimmy Brown",1,5,6,16.666666666666668
1992,101133,"Patrick Baur",13,21,34,38.23529411764706
1992,101138,"Pat Cash",5,4,9,55.55555555555556
1992,101142,"Emilio Sanchez",47,26,73,64.38356164383562
1992,101143,"Branislav Stankovic",2,3,5,40
1992,101147,"Claudio Mezzadri",13,16,29,44.827586206896555
1992,101150,"Gianluca Pozzi",28,28,56,50
1992,101154,"Simon Youl",17,23,40,42.5
1992,101174,"Fernando Roese",8,12,20,40
1992,101179,"Jean Philippe Fleurian",1,11,12,8.333333333333334
1992,101185,"Mark Woodforde",27,23,50,54
1992,101191,"Richey Reneberg",18,20,38,47.36842105263158
1992,101195,"Amos Mansdorf",35,27,62,56.45161290322581
1992,101196,"Derrick Rostagno",20,27,47,42.5531914893617
1992,101205,"Grant Connell",8,16,24,33.333333333333336
1992,101214,"Bryan Shelton",19,24,43,44.18604651162791
1992,101222,"Stefan Edberg",65,22,87,74.71264367816092
1992,101224,"Kenny Thorne",4,4,8,50
1992,101226,"Johan Carlsson",1,5,6,16.666666666666668
1992,101227,"Daniel Marco",1,1,2,50
1992,101230,"Andrei Chesnokov",29,28,57,50.87719298245614
1992,101232,"Nicklas Kroon",2,8,10,20
1992,101233,"Alex Antonitsch",12,15,27,44.44444444444444
1992,101234,"Patrik Kuhnen",16,23,39,41.02564102564103
1992,101235,"Paul Haarhuis",33,29,62,53.225806451612904
1992,101237,"Danilo Marcelino",3,14,17,17.647058823529413
1992,101242,"Brad Pearce",1,3,4,25
1992,101243,"Roberto Azar",7,19,26,26.923076923076923
1992,101249,"Andrei Olhovskiy",16,18,34,47.05882352941177
1992,101265,"Patrick McEnroe",14,21,35,40
1992,101270,"Thomas Gollwitzer",2,2,4,50
1992,101274,"Udo Riglewski",1,2,3,33.333333333333336
1992,101276,"Horacio De La Pena",7,18,25,28
1992,101279,"Philippe Pech",1,1,2,50
1992,101284,"Lars Anders Wahlgren",6,7,13,46.15384615384615
1992,101285,"Thierry Champion",21,28,49,42.857142857142854
1992,101298,"Jonas Svensson",16,23,39,41.02564102564103
1992,101311,"Kent Kinnear",2,3,5,40
1992,101312,"Robbie Weiss",6,6,12,50
1992,101318,"Javier Frana",12,20,32,37.5
1992,101320,"Magnus Gustafsson",29,22,51,56.86274509803921
1992,101332,"Gilad Bloom",14,15,29,48.275862068965516
1992,101334,"Alexander Volkov",45,33,78,57.69230769230769
1992,101337,"Martin Strelba",9,13,22,40.90909090909091
1992,101341,"Pablo Albano",1,3,4,25
1992,101348,"Dave Randall",3,5,8,37.5
1992,101354,"Andrew Sznajder",1,3,4,25
1992,101356,"Buff Farrow",1,1,2,50
1992,101358,"Olivier Delaitre",19,26,45,42.22222222222222
1992,101362,"Stephane Simian",4,4,8,50
1992,101364,"Bret Garnett",3,3,6,50
1992,101368,"Christian Miniussi",11,23,34,32.35294117647059
1992,101373,"Karsten Braasch",7,14,21,33.333333333333336
1992,101374,"Leonardo Lavalle",10,16,26,38.46153846153846
1992,101375,"Brian Devening",1,2,3,33.333333333333336
1992,101377,"Christian Bergstrom",23,22,45,51.111111111111114
1992,101381,"Aaron Krickstein",31,15,46,67.3913043478261
1992,101382,"Marcelo Filippini",25,21,46,54.34782608695652
1992,101383,"Stephane Sansoni",1,1,2,50
1992,101387,"Claudio Pistolesi",9,15,24,37.5
1992,101391,"Carl Uwe Steeb",34,27,61,55.73770491803279
1992,101398,"Neil Borwick",7,5,12,58.333333333333336
1992,101404,"Thomas Muster",39,23,62,62.903225806451616
1992,101407,"David Engel",4,6,10,40
1992,101409,"Jaime Yzaga",26,19,45,57.77777777777778
1992,101412,"Shuzo Matsuoka",20,16,36,55.55555555555556
1992,101414,"Boris Becker",50,16,66,75.75757575757575
1992,101416,"Joao Cunha Silva",6,7,13,46.15384615384615
1992,101421,"Veli Paloheimo",2,5,7,28.571428571428573
1992,101432,"Dimitri Poliakov",2,8,10,20
1992,101434,"Petr Korda",60,29,89,67.41573033707866
1992,101439,"Javier Sanchez",33,32,65,50.76923076923077
1992,101440,"Mark Koevermans",12,20,32,37.5
1992,101460,"Jose Francisco Altur",4,11,15,26.666666666666668
1992,101462,"Francisco Roig",18,22,40,45
1992,101463,"Bernd Karbacher",16,14,30,53.333333333333336
1992,101475,"Carlos Costa",39,21,60,65
1992,101481,"Omar Camporese",27,23,50,54
1992,101482,"Markus Zoecke",16,24,40,40
1992,101484,"Vladimir Gabrichidze",2,2,4,50
1992,101500,"Christian Saceanu",8,16,24,33.333333333333336
1992,101504,"Laurent Prades",1,3,4,25
1992,101507,"Tomas Carbonell",21,19,40,52.5
1992,101510,"Henrik Holm",25,15,40,62.5
1992,101511,"Horst Skoff",20,25,45,44.44444444444444
1992,101522,"Chi Wan Kim",1,1,2,50
1992,101524,"Stephan Rhode",1,1,2,50
1992,101529,"Michael Stich",45,21,66,68.18181818181819
1992,101532,"Francisco Clavet",39,29,68,57.35294117647059
1992,101534,"Libor Nemecek",2,3,5,40
1992,101543,"Jeff Tarango",28,24,52,53.84615384615385
1992,101549,"Rodolphe Gilbert",18,21,39,46.15384615384615
1992,101552,"Xavier Daufresne",4,6,10,40
1992,101580,"Roger Rasheed",1,1,2,50
1992,101582,"Gilbert Schaller",3,3,6,50
1992,101589,"Arnaud Boetsch",34,25,59,57.6271186440678
1992,101590,"Eui Jong Chang",1,3,4,25
1992,101593,"Chris Garner",2,3,5,40
1992,101594,"Carsten Arriens",8,5,13,61.53846153846154
1992,101601,"Brett Steven",10,8,18,55.55555555555556
1992,101606,"Alberto Mancini",26,21,47,55.319148936170215
1992,101609,"David Wheaton",30,23,53,56.60377358490566
1992,101611,"Cedric Pioline",31,27,58,53.44827586206897
1992,101613,"Malivai Washington",50,22,72,69.44444444444444
1992,101639,"Lan Bale",1,1,2,50
1992,101642,"Bart Wuyts",15,20,35,42.857142857142854
1992,101647,"Byron Black",10,18,28,35.714285714285715
1992,101649,"Guillermo Perez Roldan",24,18,42,57.142857142857146
1992,101659,"Jan Apell",3,6,9,33.333333333333336
1992,101660,"Francisco Montana",6,14,20,30
1992,101681,"Chris Wilkinson",2,4,6,33.333333333333336
1992,101685,"Markus Naewie",11,17,28,39.285714285714285
1992,101686,"Franco Davin",21,16,37,56.75675675675676
1992,101687,"David Dilucia",1,3,4,25
1992,101691,"Florian Krumrey",1,1,2,50
1992,101703,"Guillaume Raoux",14,16,30,46.666666666666664
1992,101710,"Martin Blackman",1,2,3,33.333333333333336
1992,101711,"Alex Obrien",3,5,8,37.5
1992,101715,"Jose Antonio Pepe Conde",1,4,5,20
1992,101716,"Javier Molina",1,1,2,50
1992,101717,"Diego Nargiso",19,22,41,46.34146341463415
1992,101719,"Frederic Fontang",9,27,36,25
1992,101721,"Markus Zillner",1,4,5,20
1992,101723,"Magnus Larsson",29,20,49,59.183673469387756
1992,101725,"Gabriel Markus",17,20,37,45.945945945945944
1992,101727,"Jason Stoltenberg",10,16,26,38.46153846153846
1992,101731,"Nuno Marques",1,2,3,33.333333333333336
1992,101733,"Jan Siemerink",22,27,49,44.89795918367347
1992,101735,"Richard Fromberg",14,23,37,37.83783783783784
1992,101736,"Andre Agassi",35,15,50,70
1992,101745,"Roberto Jabali",1,1,2,50
1992,101746,"Renzo Furlan",26,29,55,47.27272727272727
1992,101750,"Cristiano Caratti",7,18,25,28
1992,101761,"Jaime Oncins",27,19,46,58.69565217391305
1992,101765,"Tomas Anzari",1,2,3,33.333333333333336
1992,101767,"Lars Jonsson",9,23,32,28.125
1992,101772,"Andrei Cherkasov",35,31,66,53.03030303030303
1992,101774,"Todd Martin",22,19,41,53.65853658536585
1992,101775,"Frederik Fetterlein",1,4,5,20
1992,101776,"Sandon Stolle",19,20,39,48.717948717948715
1992,101780,"Alejo Mancisidor",2,2,4,50
1992,101783,"Mark Petchey",1,2,3,33.333333333333336
1992,101789,"Steve Bryan",2,6,8,25
1992,101792,"Slava Dosedel",3,3,6,50
1992,101793,"Jim Courier",68,16,84,80.95238095238095
1992,101797,"Jacco Eltingh",18,22,40,45
1992,101805,"David Nainkin",1,1,2,50
1992,101806,"Marc Kevin Goellner",5,10,15,33.333333333333336
1992,101820,"Marc Rosset",37,25,62,59.67741935483871
1992,101835,"Arne Thoms",8,16,24,33.333333333333336
1992,101843,"Sergi Bruguera",46,20,66,69.6969696969697
1992,101849,"Nicola Bruno",1,1,2,50
1992,101861,"Thomas Buchmayer",3,3,6,50
1992,101862,"Maurice Ruah",1,1,2,50
1992,101864,"Fernon Wibier",1,1,2,50
1992,101866,"David Rikl",5,7,12,41.666666666666664
1992,101889,"Todd Woodbridge",25,23,48,52.083333333333336
1992,101890,"Jonathan Stark",19,19,38,50
1992,101897,"Fernando Meligeni",3,4,7,42.857142857142854
1992,101900,"Nicklas Kulti",18,23,41,43.90243902439025
1992,101901,"Chuck Adams",9,15,24,37.5
1992,101912,"Felipe Rivera",1,2,3,33.333333333333336
1992,101914,"Lars Koslowski",10,20,30,33.333333333333336
1992,101917,"Grant Stafford",4,4,8,50
1992,101920,"Jamie Morgan",9,5,14,64.28571428571429
1992,101924,"Stefano Pescosolido",21,26,47,44.680851063829785
1992,101932,"Jared Palmer",2,4,6,33.333333333333336
1992,101937,"Robbie Koenig",2,4,6,33.333333333333336
1992,101945,"Thierry Guardiola",2,8,10,20
1992,101948,"Pete Sampras",69,18,87,79.3103448275862
1992,101955,"Luis Herrera",13,13,26,50
1992,101956,"Mark Knowles",1,1,2,50
1992,101957,"Milen Velev",2,1,3,66.66666666666667
1992,101961,"Martin Stringari",2,2,4,50
1992,101962,"Younes El Aynaoui",3,2,5,60
1992,101964,"Goran Ivanisevic",61,19,80,76.25
1992,101965,"Wayne Ferreira",49,25,74,66.21621621621621
1992,101990,"Richard Krajicek",47,24,71,66.19718309859155
1992,102000,"Aki Rahunen",1,1,2,50
1992,102001,"German Lopez",15,24,39,38.46153846153846
1992,102021,"Michael Chang",58,23,81,71.60493827160494
1992,102025,"Mikael Tillstrom",7,4,11,63.63636363636363
1992,102047,"Pier Gauthier",1,1,2,50
1992,102053,"Brian Macphie",2,4,6,33.333333333333336
1992,102061,"Kevin Ullyett",2,2,4,50
1992,102110,"Daniel Nestor",1,3,4,25
1992,102146,"Jordi Burillo",2,7,9,22.22222222222222
1992,102147,"Oliver Fernandez",1,1,2,50
1992,102148,"Fabrice Santoro",28,23,51,54.90196078431372
1992,102154,"Marcos Ondruska",11,10,21,52.38095238095238
1992,102167,"Juan Albert Viloca Puig",1,3,4,25
1992,102184,"David Prinosil",9,9,18,50
1992,102201,"Lionel Roux",2,3,5,40
1992,102202,"Kenneth Carlsen",10,8,18,55.55555555555556
1992,102205,"Sebastien Lareau",1,2,3,33.333333333333336
1992,102235,"Tommy Ho",4,4,8,50
1992,102238,"Alberto Berasategui",8,11,19,42.10526315789474
1992,102257,"Greg Rusedski",2,2,4,50
1992,102277,"Bing Chao Lin",1,2,3,33.333333333333336
1992,102304,"Grant Doyle",1,7,8,12.5
1992,102338,"Yevgeny Kafelnikov",1,4,5,20
1992,102358,"Thomas Enqvist",16,9,25,64
1992,102368,"Brian Dunn",1,4,5,20
1992,102374,"Alex Corretja",11,13,24,45.833333333333336
1992,102375,"Dinu Pescariu",1,2,3,33.333333333333336
1992,102378,"Juan Gisbert Jr",1,3,4,25
1992,102446,"Andrei Medvedev",32,12,44,72.72727272727273
1992,210013,"Martin Damm Sr",8,15,23,34.78260869565217
1993,100284,"Jimmy Connors",3,5,8,37.5
1993,100628,"Michiel Schapers",3,8,11,27.272727272727273
1993,100653,"Andres Gomez",2,6,8,25
1993,100656,"Ivan Lendl",33,23,56,58.92857142857143
1993,100713,"John Fitzgerald",4,5,9,44.44444444444444
1993,100728,"Todd Nelson",2,3,5,40
1993,100752,"Ramesh Krishnan",2,2,4,50
1993,100757,"Anders Jarryd",15,18,33,45.45454545454545
1993,100763,"Brad Gilbert",31,26,57,54.3859649122807
1993,100770,"Peter Moraing",1,4,5,20
1993,100772,"Kelly Evernden",2,2,4,50
1993,100800,"Diego Perez",2,13,15,13.333333333333334
1993,100815,"David Pate",1,3,4,25
1993,100829,"Jan Gunnarsson",1,1,2,50
1993,100837,"Jeremy Bates",12,17,29,41.37931034482759
1993,100870,"Christo Van Rensburg",12,17,29,41.37931034482759
1993,100923,"Wally Masur",35,22,57,61.40350877192982
1993,100936,"Henri Leconte",13,13,26,50
1993,100944,"Mikael Pernfors",19,15,34,55.88235294117647
1993,100954,"Luiz Mattar",19,22,41,46.34146341463415
1993,100955,"Yahiya Doumbia",1,1,2,50
1993,100972,"Todd Witsken",4,10,14,28.571428571428573
1993,101016,"Marcos Aurelio Gorriz",9,23,32,28.125
1993,101022,"Kelly Jones",7,6,13,53.84615384615385
1993,101026,"Jim Grabb",6,9,15,40
1993,101030,"Goran Prpic",12,14,26,46.15384615384615
1993,101058,"Francisco Yunis",1,1,2,50
1993,101061,"Jimmy Arias",5,4,9,55.55555555555556
1993,101062,"Mats Wilander",3,7,10,30
1993,101063,"Jordi Arrese",20,22,42,47.61904761904762
1993,101066,"Richard Matuszewski",5,9,14,35.714285714285715
1993,101071,"Tom Nijssen",4,7,11,36.36363636363637
1993,101073,"Martin Jaite",1,4,5,20
1993,101084,"Jakob Hlasek",22,26,48,45.833333333333336
1993,101086,"Ronald Agenor",17,25,42,40.476190476190474
1993,101096,"Gary Muller",1,5,6,16.666666666666668
1993,101097,"Rick Leach",1,1,2,50
1993,101098,"Guy Forget",8,8,16,50
1993,101120,"Karel Novacek",41,23,64,64.0625
1993,101123,"Alexander Mronz",2,4,6,33.333333333333336
1993,101124,"Paolo Cane",3,7,10,30
1993,101126,"Chris Pridham",11,15,26,42.30769230769231
1993,101133,"Patrick Baur",5,9,14,35.714285714285715
1993,101142,"Emilio Sanchez",28,26,54,51.851851851851855
1993,101145,"Jonathan Canter",2,1,3,66.66666666666667
1993,101147,"Claudio Mezzadri",12,23,35,34.285714285714285
1993,101149,"Morten Christensen",1,1,2,50
1993,101150,"Gianluca Pozzi",13,26,39,33.333333333333336
1993,101154,"Simon Youl",1,10,11,9.090909090909092
1993,101179,"Jean Philippe Fleurian",1,4,5,20
1993,101185,"Mark Woodforde",28,20,48,58.333333333333336
1993,101191,"Richey Reneberg",37,26,63,58.73015873015873
1993,101195,"Amos Mansdorf",40,24,64,62.5
1993,101196,"Derrick Rostagno",17,21,38,44.73684210526316
1993,101214,"Bryan Shelton",19,25,44,43.18181818181818
1993,101222,"Stefan Edberg",59,24,83,71.08433734939759
1993,101224,"Kenny Thorne",5,13,18,27.77777777777778
1993,101226,"Johan Carlsson",2,2,4,50
1993,101230,"Andrei Chesnokov",38,30,68,55.88235294117647
1993,101233,"Alex Antonitsch",14,18,32,43.75
1993,101234,"Patrik Kuhnen",13,22,35,37.142857142857146
1993,101235,"Paul Haarhuis",30,26,56,53.57142857142857
1993,101243,"Roberto Azar",3,16,19,15.789473684210526
1993,101249,"Andrei Olhovskiy",26,29,55,47.27272727272727
1993,101262,"Rikard Bergh",1,2,3,33.333333333333336
1993,101265,"Patrick McEnroe",26,20,46,56.52173913043478
1993,101270,"Thomas Gollwitzer",2,1,3,66.66666666666667
1993,101276,"Horacio De La Pena",17,16,33,51.515151515151516
1993,101279,"Philippe Pech",1,1,2,50
1993,101284,"Lars Anders Wahlgren",1,5,6,16.666666666666668
1993,101285,"Thierry Champion",3,12,15,20
1993,101298,"Jonas Svensson",34,28,62,54.83870967741935
1993,101312,"Robbie Weiss",8,22,30,26.666666666666668
1993,101318,"Javier Frana",21,10,31,67.74193548387096
1993,101320,"Magnus Gustafsson",50,29,79,63.29113924050633
1993,101324,"Ulf Stenlund",2,1,3,66.66666666666667
1993,101332,"Gilad Bloom",2,4,6,33.333333333333336
1993,101334,"Alexander Volkov",44,31,75,58.666666666666664
1993,101337,"Martin Strelba",2,10,12,16.666666666666668
1993,101339,"Agustin Moreno",1,2,3,33.333333333333336
1993,101348,"Dave Randall",5,6,11,45.45454545454545
1993,101353,"Lionel Barthez",2,1,3,66.66666666666667
1993,101354,"Andrew Sznajder",1,6,7,14.285714285714286
1993,101356,"Buff Farrow",1,1,2,50
1993,101358,"Olivier Delaitre",15,23,38,39.473684210526315
1993,101360,"Mark Keil",1,2,3,33.333333333333336
1993,101362,"Stephane Simian",18,26,44,40.90909090909091
1993,101368,"Christian Miniussi",3,4,7,42.857142857142854
1993,101369,"Bent Ove Pedersen",1,2,3,33.333333333333336
1993,101373,"Karsten Braasch",14,16,30,46.666666666666664
1993,101374,"Leonardo Lavalle",4,9,13,30.76923076923077
1993,101375,"Brian Devening",1,5,6,16.666666666666668
1993,101377,"Christian Bergstrom",23,23,46,50
1993,101381,"Aaron Krickstein",26,19,45,57.77777777777778
1993,101382,"Marcelo Filippini",17,26,43,39.53488372093023
1993,101387,"Claudio Pistolesi",6,7,13,46.15384615384615
1993,101391,"Carl Uwe Steeb",20,22,42,47.61904761904762
1993,101398,"Neil Borwick",13,15,28,46.42857142857143
1993,101404,"Thomas Muster",77,21,98,78.57142857142857
1993,101407,"David Engel",1,2,3,33.333333333333336
1993,101409,"Jaime Yzaga",30,21,51,58.8235294117647
1993,101412,"Shuzo Matsuoka",15,15,30,50
1993,101414,"Boris Becker",42,22,64,65.625
1993,101416,"Joao Cunha Silva",9,18,27,33.333333333333336
1993,101422,"Mark Kaplan",2,4,6,33.333333333333336
1993,101430,"Sergio Cortes",5,8,13,38.46153846153846
1993,101432,"Dimitri Poliakov",6,5,11,54.54545454545455
1993,101434,"Petr Korda",53,23,76,69.73684210526316
1993,101439,"Javier Sanchez",39,31,70,55.714285714285715
1993,101459,"Tomas Nydahl",3,4,7,42.857142857142854
1993,101460,"Jose Francisco Altur",10,16,26,38.46153846153846
1993,101462,"Francisco Roig",6,14,20,30
1993,101463,"Bernd Karbacher",18,28,46,39.130434782608695
1993,101468,"Gerard Solves",5,4,9,55.55555555555556
1993,101473,"Jozsef Krocsko",1,3,4,25
1993,101475,"Carlos Costa",43,25,68,63.23529411764706
1993,101477,"Chris Bailey",3,6,9,33.333333333333336
1993,101481,"Omar Camporese",12,12,24,50
1993,101482,"Markus Zoecke",9,14,23,39.130434782608695
1993,101490,"Daniel Orsanic",6,9,15,40
1993,101500,"Christian Saceanu",1,12,13,7.6923076923076925
1993,101504,"Laurent Prades",1,1,2,50
1993,101507,"Tomas Carbonell",18,28,46,39.130434782608695
1993,101510,"Henrik Holm",25,29,54,46.2962962962963
1993,101511,"Horst Skoff",17,18,35,48.57142857142857
1993,101515,"Donald Johnson",1,1,2,50
1993,101529,"Michael Stich",69,21,90,76.66666666666667
1993,101531,"Mario Visconti",2,3,5,40
1993,101532,"Francisco Clavet",21,26,47,44.680851063829785
1993,101534,"Libor Nemecek",2,3,5,40
1993,101543,"Jeff Tarango",24,26,50,48
1993,101549,"Rodolphe Gilbert",18,28,46,39.130434782608695
1993,101561,"Nicklas Utgren",1,1,2,50
1993,101576,"Ryuso Tsujino",1,2,3,33.333333333333336
1993,101582,"Gilbert Schaller",12,21,33,36.36363636363637
1993,101584,"Keith Evans",1,3,4,25
1993,101589,"Arnaud Boetsch",43,25,68,63.23529411764706
1993,101593,"Chris Garner",3,5,8,37.5
1993,101594,"Carsten Arriens",4,8,12,33.333333333333336
1993,101601,"Brett Steven",30,28,58,51.724137931034484
1993,101606,"Alberto Mancini",11,22,33,33.333333333333336
1993,101609,"David Wheaton",27,25,52,51.92307692307692
1993,101611,"Cedric Pioline",51,27,78,65.38461538461539
1993,101613,"Malivai Washington",37,23,60,61.666666666666664
1993,101639,"Lan Bale",1,2,3,33.333333333333336
1993,101642,"Bart Wuyts",8,20,28,28.571428571428573
1993,101647,"Byron Black",19,20,39,48.717948717948715
1993,101649,"Guillermo Perez Roldan",19,11,30,63.333333333333336
1993,101659,"Jan Apell",1,8,9,11.11111111111111
1993,101660,"Francisco Montana",4,8,12,33.333333333333336
1993,101681,"Chris Wilkinson",6,7,13,46.15384615384615
1993,101685,"Markus Naewie",9,14,23,39.130434782608695
1993,101686,"Franco Davin",11,21,32,34.375
1993,101703,"Guillaume Raoux",27,28,55,49.09090909090909
1993,101711,"Alex Obrien",12,21,33,36.36363636363637
1993,101717,"Diego Nargiso",8,23,31,25.806451612903224
1993,101719,"Frederic Fontang",3,8,11,27.272727272727273
1993,101722,"Han Cheol Shin",1,1,2,50
1993,101723,"Magnus Larsson",31,26,57,54.3859649122807
1993,101725,"Gabriel Markus",11,19,30,36.666666666666664
1993,101727,"Jason Stoltenberg",23,21,44,52.27272727272727
1993,101733,"Jan Siemerink",24,25,49,48.97959183673469
1993,101735,"Richard Fromberg",34,30,64,53.125
1993,101736,"Andre Agassi",32,11,43,74.4186046511628
1993,101746,"Renzo Furlan",26,28,54,48.148148148148145
1993,101750,"Cristiano Caratti",1,6,7,14.285714285714286
1993,101751,"Ross Matheson",1,3,4,25
1993,101761,"Jaime Oncins",11,23,34,32.35294117647059
1993,101767,"Lars Jonsson",8,17,25,32
1993,101772,"Andrei Cherkasov",34,31,65,52.30769230769231
1993,101774,"Todd Martin",45,23,68,66.17647058823529
1993,101776,"Sandon Stolle",8,19,27,29.62962962962963
1993,101783,"Mark Petchey",1,3,4,25
1993,101788,"Doug Flach",6,8,14,42.857142857142854
1993,101789,"Steve Bryan",7,9,16,43.75
1993,101792,"Slava Dosedel",16,15,31,51.61290322580645
1993,101793,"Jim Courier",58,17,75,77.33333333333333
1993,101797,"Jacco Eltingh",22,26,48,45.833333333333336
1993,101805,"David Nainkin",4,5,9,44.44444444444444
1993,101806,"Marc Kevin Goellner",33,25,58,56.89655172413793
1993,101809,"Nicolas Pereira",4,11,15,26.666666666666668
1993,101820,"Marc Rosset",46,23,69,66.66666666666667
1993,101829,"Federico Sanchez",5,5,10,50
1993,101833,"Michael Tebbutt",3,5,8,37.5
1993,101835,"Arne Thoms",5,8,13,38.46153846153846
1993,101843,"Sergi Bruguera",63,23,86,73.25581395348837
1993,101844,"Heath Denman",1,3,4,25
1993,101861,"Thomas Buchmayer",2,2,4,50
1993,101862,"Maurice Ruah",1,2,3,33.333333333333336
1993,101864,"Fernon Wibier",1,4,5,20
1993,101866,"David Rikl",7,13,20,35
1993,101868,"Dick Norman",1,1,2,50
1993,101871,"Alexander Reichel",2,1,3,66.66666666666667
1993,101888,"Daniel Vacek",14,23,37,37.83783783783784
1993,101889,"Todd Woodbridge",19,20,39,48.717948717948715
1993,101890,"Jonathan Stark",28,23,51,54.90196078431372
1993,101897,"Fernando Meligeni",6,7,13,46.15384615384615
1993,101900,"Nicklas Kulti",27,24,51,52.94117647058823
1993,101901,"Chuck Adams",25,25,50,50
1993,101902,"Stephane Huet",1,3,4,25
1993,101912,"Felipe Rivera",1,2,3,33.333333333333336
1993,101914,"Lars Koslowski",2,5,7,28.571428571428573
1993,101917,"Grant Stafford",17,14,31,54.83870967741935
1993,101920,"Jamie Morgan",24,25,49,48.97959183673469
1993,101924,"Stefano Pescosolido",14,14,28,50
1993,101926,"Andrei Merinov",3,2,5,60
1993,101932,"Jared Palmer",9,14,23,39.130434782608695
1993,101948,"Pete Sampras",85,16,101,84.15841584158416
1993,101955,"Luis Herrera",9,15,24,37.5
1993,101956,"Mark Knowles",3,3,6,50
1993,101961,"Martin Stringari",2,7,9,22.22222222222222
1993,101962,"Younes El Aynaoui",16,14,30,53.333333333333336
1993,101964,"Goran Ivanisevic",50,21,71,70.4225352112676
1993,101965,"Wayne Ferreira",38,25,63,60.317460317460316
1993,101990,"Richard Krajicek",36,20,56,64.28571428571429
1993,101991,"Mauricio Hadad",3,6,9,33.333333333333336
1993,102010,"Clinton Marsh",1,1,2,50
1993,102019,"Dirk Dier",2,4,6,33.333333333333336
1993,102021,"Michael Chang",66,21,87,75.86206896551724
1993,102028,"Massimo Valeri",2,3,5,40
1993,102029,"Filip Dewulf",5,6,11,45.45454545454545
1993,102030,"Andrew Foster",3,2,5,60
1993,102031,"Sandor Noszaly",1,2,3,33.333333333333336
1993,102035,"Jonas Bjorkman",6,8,14,42.857142857142854
1993,102053,"Brian Macphie",3,5,8,37.5
1993,102061,"Kevin Ullyett",2,2,4,50
1993,102088,"Joern Renzenbrink",8,11,19,42.10526315789474
1993,102090,"Ofer Sela",1,1,2,50
1993,102104,"Christian Ruud",1,2,3,33.333333333333336
1993,102110,"Daniel Nestor",2,5,7,28.571428571428573
1993,102133,"Laurence Tieleman",4,4,8,50
1993,102135,"Emilio Benfele Alvarez",1,4,5,20
1993,102139,"Eyal Ran",2,2,4,50
1993,102146,"Jordi Burillo",18,17,35,51.42857142857143
1993,102147,"Oliver Fernandez",4,5,9,44.44444444444444
1993,102148,"Fabrice Santoro",24,28,52,46.15384615384615
1993,102153,"German Puentes",1,1,2,50
1993,102154,"Marcos Ondruska",26,29,55,47.27272727272727
1993,102158,"Patrick Rafter",11,11,22,50
1993,102162,"Chris Woodruff",1,2,3,33.333333333333336
1993,102167,"Juan Albert Viloca Puig",1,1,2,50
1993,102169,"Michael Joyce",3,4,7,42.857142857142854
1993,102184,"David Prinosil",16,25,41,39.02439024390244
1993,102198,"Paul Kilderry",2,2,4,50
1993,102202,"Kenneth Carlsen",17,27,44,38.63636363636363
1993,102205,"Sebastien Lareau",2,3,5,40
1993,102215,"Joshua Eagle",1,1,2,50
1993,102223,"Karim Alami",2,2,4,50
1993,102226,"David Witt",5,7,12,41.666666666666664
1993,102227,"Sargis Sargsian",1,1,2,50
1993,102233,"Leander Paes",1,3,4,25
1993,102235,"Tommy Ho",7,14,21,33.333333333333336
1993,102238,"Alberto Berasategui",28,19,47,59.57446808510638
1993,102247,"Andrea Gaudenzi",17,10,27,62.96296296296296
1993,102257,"Greg Rusedski",16,9,25,64
1993,102263,"Yong Il Yoon",1,1,2,50
1993,102338,"Yevgeny Kafelnikov",10,10,20,50
1993,102344,"Karol Kucera",1,3,4,25
1993,102348,"Hideki Kaneko",1,2,3,33.333333333333336
1993,102358,"Thomas Enqvist",18,23,41,43.90243902439025
1993,102367,"Nicolas Kischkewitz",1,1,2,50
1993,102368,"Brian Dunn",1,2,3,33.333333333333336
1993,102374,"Alex Corretja",24,23,47,51.06382978723404
1993,102375,"Dinu Pescariu",2,1,3,66.66666666666667
1993,102378,"Juan Gisbert Jr",3,6,9,33.333333333333336
1993,102394,"Johan Van Herck",1,1,2,50
1993,102434,"Vincent Spadea",1,5,6,16.666666666666668
1993,102446,"Andrei Medvedev",58,24,82,70.73170731707317
1993,102457,"Miles Maclagan",1,1,2,50
1993,102521,"Hendrik Dreekmann",2,5,7,28.571428571428573
1993,102562,"Jiri Novak",1,1,2,50
1993,102563,"Thomas Johansson",2,1,3,66.66666666666667
1993,102610,"Albert Costa",2,2,4,50
1993,102650,"Roberto Carretero",1,2,3,33.333333333333336
1993,102881,"David Skoch",1,1,2,50
1993,102903,"Eyal Erlich",1,1,2,50
1993,108043,"Ralph Kok",1,1,2,50
1993,210013,"Martin Damm Sr",16,21,37,43.24324324324324
1994,100284,"Jimmy Connors",1,3,4,25
1994,100656,"Ivan Lendl",28,18,46,60.869565217391305
1994,100757,"Anders Jarryd",12,12,24,50
1994,100763,"Brad Gilbert",18,20,38,47.36842105263158
1994,100770,"Peter Moraing",1,1,2,50
1994,100815,"David Pate",1,1,2,50
1994,100837,"Jeremy Bates",16,16,32,50
1994,100865,"Marcelo Ingaramo",1,1,2,50
1994,100870,"Christo Van Rensburg",7,8,15,46.666666666666664
1994,100876,"Bong Soo Kim",1,2,3,33.333333333333336
1994,100923,"Wally Masur",12,20,32,37.5
1994,100926,"Ken Flach",1,1,2,50
1994,100936,"Henri Leconte",16,16,32,50
1994,100954,"Luiz Mattar",20,18,38,52.63157894736842
1994,100962,"Thomas Hogstedt",2,3,5,40
1994,100997,"Roger Smith",5,6,11,45.45454545454545
1994,101016,"Marcos Aurelio Gorriz",2,1,3,66.66666666666667
1994,101026,"Jim Grabb",18,20,38,47.36842105263158
1994,101027,"Jaroslav Bulant",1,1,2,50
1994,101061,"Jimmy Arias",3,4,7,42.857142857142854
1994,101062,"Mats Wilander",17,20,37,45.945945945945944
1994,101063,"Jordi Arrese",23,23,46,50
1994,101066,"Richard Matuszewski",1,6,7,14.285714285714286
1994,101084,"Jakob Hlasek",22,24,46,47.82608695652174
1994,101086,"Ronald Agenor",15,23,38,39.473684210526315
1994,101096,"Gary Muller",1,2,3,33.333333333333336
1994,101097,"Rick Leach",1,2,3,33.333333333333336
1994,101098,"Guy Forget",22,17,39,56.41025641025641
1994,101106,"Peter Lundgren",1,4,5,20
1994,101120,"Karel Novacek",37,31,68,54.411764705882355
1994,101123,"Alexander Mronz",13,14,27,48.148148148148145
1994,101124,"Paolo Cane",6,10,16,37.5
1994,101133,"Patrick Baur",3,2,5,60
1994,101142,"Emilio Sanchez",17,26,43,39.53488372093023
1994,101149,"Morten Christensen",1,1,2,50
1994,101150,"Gianluca Pozzi",11,18,29,37.93103448275862
1994,101154,"Simon Youl",2,6,8,25
1994,101179,"Jean Philippe Fleurian",19,21,40,47.5
1994,101185,"Mark Woodforde",29,26,55,52.72727272727273
1994,101190,"Darren Cahill",5,9,14,35.714285714285715
1994,101191,"Richey Reneberg",33,24,57,57.89473684210526
1994,101195,"Amos Mansdorf",20,25,45,44.44444444444444
1994,101205,"Grant Connell",2,4,6,33.333333333333336
1994,101214,"Bryan Shelton",18,21,39,46.15384615384615
1994,101222,"Stefan Edberg",54,25,79,68.35443037974683
1994,101224,"Kenny Thorne",2,5,7,28.571428571428573
1994,101230,"Andrei Chesnokov",38,30,68,55.88235294117647
1994,101233,"Alex Antonitsch",12,21,33,36.36363636363637
1994,101234,"Patrik Kuhnen",6,8,14,42.857142857142854
1994,101235,"Paul Haarhuis",26,22,48,54.166666666666664
1994,101249,"Andrei Olhovskiy",23,27,50,46
1994,101265,"Patrick McEnroe",19,22,41,46.34146341463415
1994,101270,"Thomas Gollwitzer",1,3,4,25
1994,101276,"Horacio De La Pena",6,12,18,33.333333333333336
1994,101284,"Lars Anders Wahlgren",3,5,8,37.5
1994,101285,"Thierry Champion",2,6,8,25
1994,101298,"Jonas Svensson",9,17,26,34.61538461538461
1994,101311,"Kent Kinnear",3,3,6,50
1994,101312,"Robbie Weiss",13,22,35,37.142857142857146
1994,101318,"Javier Frana",15,11,26,57.69230769230769
1994,101320,"Magnus Gustafsson",28,11,39,71.7948717948718
1994,101332,"Gilad Bloom",2,3,5,40
1994,101334,"Alexander Volkov",37,32,69,53.6231884057971
1994,101348,"Dave Randall",2,1,3,66.66666666666667
1994,101349,"Adam Malik",2,1,3,66.66666666666667
1994,101358,"Olivier Delaitre",22,23,45,48.888888888888886
1994,101362,"Stephane Simian",7,19,26,26.923076923076923
1994,101368,"Christian Miniussi",3,2,5,60
1994,101373,"Karsten Braasch",26,31,57,45.6140350877193
1994,101377,"Christian Bergstrom",15,17,32,46.875
1994,101381,"Aaron Krickstein",30,26,56,53.57142857142857
1994,101382,"Marcelo Filippini",22,15,37,59.45945945945946
1994,101391,"Carl Uwe Steeb",8,18,26,30.76923076923077
1994,101398,"Neil Borwick",1,14,15,6.666666666666667
1994,101404,"Thomas Muster",54,26,80,67.5
1994,101407,"David Engel",1,3,4,25
1994,101409,"Jaime Yzaga",28,27,55,50.90909090909091
1994,101412,"Shuzo Matsuoka",8,14,22,36.36363636363637
1994,101414,"Boris Becker",50,17,67,74.6268656716418
1994,101416,"Joao Cunha Silva",1,4,5,20
1994,101417,"Mario Rincon",1,1,2,50
1994,101422,"Mark Kaplan",2,1,3,66.66666666666667
1994,101430,"Sergio Cortes",2,5,7,28.571428571428573
1994,101432,"Dimitri Poliakov",6,13,19,31.57894736842105
1994,101434,"Petr Korda",35,21,56,62.5
1994,101439,"Javier Sanchez",25,33,58,43.10344827586207
1994,101441,"Martin Sinner",2,3,5,40
1994,101459,"Tomas Nydahl",10,12,22,45.45454545454545
1994,101460,"Jose Francisco Altur",3,7,10,30
1994,101462,"Francisco Roig",7,9,16,43.75
1994,101463,"Bernd Karbacher",34,27,61,55.73770491803279
1994,101468,"Gerard Solves",3,12,15,20
1994,101473,"Jozsef Krocsko",1,2,3,33.333333333333336
1994,101475,"Carlos Costa",39,26,65,60
1994,101477,"Chris Bailey",1,3,4,25
1994,101481,"Omar Camporese",3,14,17,17.647058823529413
1994,101482,"Markus Zoecke",15,16,31,48.38709677419355
1994,101490,"Daniel Orsanic",5,8,13,38.46153846153846
1994,101495,"Miguel Tobon",3,1,4,75
1994,101500,"Christian Saceanu",2,2,4,50
1994,101507,"Tomas Carbonell",28,27,55,50.90909090909091
1994,101510,"Henrik Holm",18,24,42,42.857142857142854
1994,101511,"Horst Skoff",11,14,25,44
1994,101515,"Donald Johnson",1,3,4,25
1994,101529,"Michael Stich",57,22,79,72.15189873417721
1994,101532,"Francisco Clavet",27,19,46,58.69565217391305
1994,101534,"Libor Nemecek",1,4,5,20
1994,101543,"Jeff Tarango",23,27,50,46
1994,101549,"Rodolphe Gilbert",10,24,34,29.41176470588235
1994,101552,"Xavier Daufresne",5,13,18,27.77777777777778
1994,101561,"Nicklas Utgren",2,3,5,40
1994,101567,"Hendrik Jan Davids",1,3,4,25
1994,101582,"Gilbert Schaller",23,26,49,46.93877551020408
1994,101589,"Arnaud Boetsch",26,25,51,50.98039215686274
1994,101594,"Carsten Arriens",3,5,8,37.5
1994,101597,"Louis Gloria",3,8,11,27.272727272727273
1994,101601,"Brett Steven",21,24,45,46.666666666666664
1994,101606,"Alberto Mancini",2,5,7,28.571428571428573
1994,101609,"David Wheaton",28,18,46,60.869565217391305
1994,101611,"Cedric Pioline",30,30,60,50
1994,101612,"Roland Burtscher",2,5,7,28.571428571428573
1994,101613,"Malivai Washington",36,23,59,61.016949152542374
1994,101636,"Wade Mcguire",3,5,8,37.5
1994,101647,"Byron Black",22,26,48,45.833333333333336
1994,101659,"Jan Apell",17,17,34,50
1994,101660,"Francisco Montana",1,2,3,33.333333333333336
1994,101681,"Chris Wilkinson",2,5,7,28.571428571428573
1994,101682,"David Adams",8,10,18,44.44444444444444
1994,101685,"Markus Naewie",1,3,4,25
1994,101686,"Franco Davin",18,20,38,47.36842105263158
1994,101696,"Federico Mordegan",2,1,3,66.66666666666667
1994,101703,"Guillaume Raoux",15,20,35,42.857142857142854
1994,101704,"Ellis Ferreira",3,4,7,42.857142857142854
1994,101711,"Alex Obrien",17,24,41,41.46341463414634
1994,101717,"Diego Nargiso",10,18,28,35.714285714285715
1994,101719,"Frederic Fontang",1,5,6,16.666666666666668
1994,101720,"Agustin Garizzio",1,1,2,50
1994,101722,"Han Cheol Shin",1,1,2,50
1994,101723,"Magnus Larsson",36,21,57,63.1578947368421
1994,101725,"Gabriel Markus",15,14,29,51.724137931034484
1994,101727,"Jason Stoltenberg",38,25,63,60.317460317460316
1994,101733,"Jan Siemerink",16,19,35,45.714285714285715
1994,101735,"Richard Fromberg",25,28,53,47.16981132075472
1994,101736,"Andre Agassi",52,14,66,78.78787878787878
1994,101745,"Roberto Jabali",7,6,13,53.84615384615385
1994,101746,"Renzo Furlan",30,27,57,52.63157894736842
1994,101750,"Cristiano Caratti",8,11,19,42.10526315789474
1994,101761,"Jaime Oncins",1,7,8,12.5
1994,101767,"Lars Jonsson",19,25,44,43.18181818181818
1994,101772,"Andrei Cherkasov",8,27,35,22.857142857142858
1994,101774,"Todd Martin",50,19,69,72.46376811594203
1994,101776,"Sandon Stolle",4,6,10,40
1994,101780,"Alejo Mancisidor",1,3,4,25
1994,101783,"Mark Petchey",15,22,37,40.54054054054054
1994,101788,"Doug Flach",4,17,21,19.047619047619047
1994,101789,"Steve Bryan",13,26,39,33.333333333333336
1994,101792,"Slava Dosedel",36,23,59,61.016949152542374
1994,101793,"Jim Courier",43,19,62,69.35483870967742
1994,101797,"Jacco Eltingh",40,23,63,63.492063492063494
1994,101805,"David Nainkin",3,10,13,23.076923076923077
1994,101806,"Marc Kevin Goellner",21,27,48,43.75
1994,101809,"Nicolas Pereira",10,14,24,41.666666666666664
1994,101811,"Bill Barber",1,1,2,50
1994,101816,"Steve Campbell",1,1,2,50
1994,101820,"Marc Rosset",46,27,73,63.013698630136986
1994,101822,"Luis Lobo",1,1,2,50
1994,101826,"Alex Lopez Moron",2,1,3,66.66666666666667
1994,101829,"Federico Sanchez",3,5,8,37.5
1994,101833,"Michael Tebbutt",9,11,20,45
1994,101835,"Arne Thoms",3,3,6,50
1994,101843,"Sergi Bruguera",63,24,87,72.41379310344827
1994,101858,"Gilles Bastie",1,1,2,50
1994,101862,"Maurice Ruah",12,24,36,33.333333333333336
1994,101864,"Fernon Wibier",2,4,6,33.333333333333336
1994,101865,"Albert Chang",3,5,8,37.5
1994,101866,"David Rikl",19,28,47,40.42553191489362
1994,101869,"Juan Luis Tati Rascon",1,3,4,25
1994,101876,"Massimo Ardinghi",1,1,2,50
1994,101888,"Daniel Vacek",25,27,52,48.07692307692308
1994,101889,"Todd Woodbridge",15,19,34,44.11764705882353
1994,101890,"Jonathan Stark",26,23,49,53.06122448979592
1994,101892,"Axel Finnberg",1,3,4,25
1994,101897,"Fernando Meligeni",14,19,33,42.42424242424242
1994,101900,"Nicklas Kulti",20,26,46,43.47826086956522
1994,101901,"Chuck Adams",26,24,50,52
1994,101917,"Grant Stafford",11,21,32,34.375
1994,101920,"Jamie Morgan",17,20,37,45.945945945945944
1994,101924,"Stefano Pescosolido",17,25,42,40.476190476190474
1994,101929,"Joost Winnink",1,2,3,33.333333333333336
1994,101932,"Jared Palmer",28,20,48,58.333333333333336
1994,101945,"Thierry Guardiola",2,5,7,28.571428571428573
1994,101948,"Pete Sampras",76,10,86,88.37209302325581
1994,101956,"Mark Knowles",2,7,9,22.22222222222222
1994,101962,"Younes El Aynaoui",15,27,42,35.714285714285715
1994,101964,"Goran Ivanisevic",62,26,88,70.45454545454545
1994,101965,"Wayne Ferreira",66,25,91,72.52747252747253
1994,101968,"Ola Kristiansson",1,2,3,33.333333333333336
1994,101990,"Richard Krajicek",32,13,45,71.11111111111111
1994,101991,"Mauricio Hadad",8,14,22,36.36363636363637
1994,102006,"Brent Larkham",4,8,12,33.333333333333336
1994,102021,"Michael Chang",67,21,88,76.13636363636364
1994,102024,"Hernan Gumy",2,4,6,33.333333333333336
1994,102025,"Mikael Tillstrom",4,2,6,66.66666666666667
1994,102029,"Filip Dewulf",4,9,13,30.76923076923077
1994,102030,"Andrew Foster",1,2,3,33.333333333333336
1994,102031,"Sandor Noszaly",4,3,7,57.142857142857146
1994,102035,"Jonas Bjorkman",31,26,57,54.3859649122807
1994,102053,"Brian Macphie",3,4,7,42.857142857142854
1994,102060,"Ignacio Martinez",1,1,2,50
1994,102088,"Joern Renzenbrink",17,19,36,47.22222222222222
1994,102104,"Christian Ruud",2,4,6,33.333333333333336
1994,102110,"Daniel Nestor",5,5,10,50
1994,102118,"Radomir Vasek",2,3,5,40
1994,102135,"Emilio Benfele Alvarez",4,4,8,50
1994,102146,"Jordi Burillo",20,30,50,40
1994,102147,"Oliver Fernandez",1,3,4,25
1994,102148,"Fabrice Santoro",24,18,42,57.142857142857146
1994,102154,"Marcos Ondruska",15,17,32,46.875
1994,102158,"Patrick Rafter",43,26,69,62.31884057971015
1994,102167,"Juan Albert Viloca Puig",6,5,11,54.54545454545455
1994,102169,"Michael Joyce",2,5,7,28.571428571428573
1994,102184,"David Prinosil",8,13,21,38.095238095238095
1994,102198,"Paul Kilderry",3,6,9,33.333333333333336
1994,102201,"Lionel Roux",14,14,28,50
1994,102202,"Kenneth Carlsen",20,21,41,48.78048780487805
1994,102205,"Sebastien Lareau",3,13,16,18.75
1994,102215,"Joshua Eagle",1,4,5,20
1994,102219,"Juan Garat",1,4,5,20
1994,102223,"Karim Alami",12,19,31,38.70967741935484
1994,102226,"David Witt",6,5,11,54.54545454545455
1994,102233,"Leander Paes",2,3,5,40
1994,102234,"Oliver Gross",12,11,23,52.17391304347826
1994,102235,"Tommy Ho",2,10,12,16.666666666666668
1994,102238,"Alberto Berasategui",64,26,90,71.11111111111111
1994,102243,"Marcelo Charpentier",1,1,2,50
1994,102247,"Andrea Gaudenzi",36,29,65,55.38461538461539
1994,102250,"Emanuel Couto",1,1,2,50
1994,102257,"Greg Rusedski",21,29,50,42
1994,102259,"Jerome Golmard",1,1,2,50
1994,102277,"Bing Chao Lin",2,1,3,66.66666666666667
1994,102286,"Wayne Black",2,2,4,50
1994,102318,"Andrei Pavel",1,1,2,50
1994,102338,"Yevgeny Kafelnikov",60,28,88,68.18181818181819
1994,102344,"Karol Kucera",13,13,26,50
1994,102351,"Oscar Martinez",11,8,19,57.89473684210526
1994,102358,"Thomas Enqvist",23,19,42,54.76190476190476
1994,102368,"Brian Dunn",1,3,4,25
1994,102372,"Sule Ladipo",1,1,2,50
1994,102374,"Alex Corretja",44,22,66,66.66666666666667
1994,102375,"Dinu Pescariu",1,1,2,50
1994,102378,"Juan Gisbert Jr",1,2,3,33.333333333333336
1994,102394,"Johan Van Herck",1,3,4,25
1994,102419,"Christophe Van Garsse",3,1,4,75
1994,102434,"Vincent Spadea",11,13,24,45.833333333333336
1994,102437,"Adrian Voinea",2,4,6,33.333333333333336
1994,102446,"Andrei Medvedev",34,18,52,65.38461538461539
1994,102450,"Tim Henman",3,5,8,37.5
1994,102477,"Gaston Etlis",1,4,5,20
1994,102491,"Alex Radulescu",1,2,3,33.333333333333336
1994,102521,"Hendrik Dreekmann",15,22,37,40.54054054054054
1994,102536,"James Greenhalgh",1,1,2,50
1994,102588,"Lars Rehmann",6,7,13,46.15384615384615
1994,102610,"Albert Costa",15,18,33,45.45454545454545
1994,102644,"Franco Squillari",1,1,2,50
1994,102650,"Roberto Carretero",1,5,6,16.666666666666668
1994,102687,"Herbert Wiltschnig",1,2,3,33.333333333333336
1994,102701,"Marcelo Rios",12,11,23,52.17391304347826
1994,102753,"Wolfgang Schranz",2,3,5,40
1994,102851,"Giorgio Galimberti",1,1,2,50
1994,102854,"Sjeng Schalken",1,2,3,33.333333333333336
1994,102881,"David Skoch",1,1,2,50
1994,102882,"Mark Philippoussis",1,3,4,25
1994,102968,"Jonathan Erlich",1,1,2,50
1994,103009,"Razvan Sabau",1,2,3,33.333333333333336
1994,210013,"Martin Damm Sr",15,24,39,38.46153846153846
1995,100284,"Jimmy Connors",2,2,4,50
1995,100676,"Yannick Noah",1,3,4,25
1995,100757,"Anders Jarryd",13,17,30,43.333333333333336
1995,100763,"Brad Gilbert",1,5,6,16.666666666666668
1995,100837,"Jeremy Bates",12,22,34,35.294117647058826
1995,100923,"Wally Masur",3,9,12,25
1995,100936,"Henri Leconte",8,14,22,36.36363636363637
1995,100943,"Girts Dzelde",1,1,2,50
1995,100954,"Luiz Mattar",2,8,10,20
1995,100955,"Yahiya Doumbia",5,NA,NA,NA
1995,101026,"Jim Grabb",6,17,23,26.08695652173913
1995,101062,"Mats Wilander",21,19,40,52.5
1995,101063,"Jordi Arrese",16,20,36,44.44444444444444
1995,101084,"Jakob Hlasek",32,27,59,54.23728813559322
1995,101086,"Ronald Agenor",8,12,20,40
1995,101098,"Guy Forget",19,24,43,44.18604651162791
1995,101106,"Peter Lundgren",1,1,2,50
1995,101120,"Karel Novacek",13,24,37,35.13513513513514
1995,101123,"Alexander Mronz",7,18,25,28
1995,101133,"Patrick Baur",6,8,14,42.857142857142854
1995,101138,"Pat Cash",5,7,12,41.666666666666664
1995,101142,"Emilio Sanchez",13,22,35,37.142857142857146
1995,101150,"Gianluca Pozzi",10,21,31,32.25806451612903
1995,101179,"Jean Philippe Fleurian",4,9,13,30.76923076923077
1995,101185,"Mark Woodforde",31,25,56,55.357142857142854
1995,101191,"Richey Reneberg",22,23,45,48.888888888888886
1995,101196,"Derrick Rostagno",13,9,22,59.09090909090909
1995,101214,"Bryan Shelton",11,22,33,33.333333333333336
1995,101222,"Stefan Edberg",39,19,58,67.24137931034483
1995,101224,"Kenny Thorne",1,9,10,10
1995,101230,"Andrei Chesnokov",16,23,39,41.02564102564103
1995,101233,"Alex Antonitsch",1,5,6,16.666666666666668
1995,101234,"Patrik Kuhnen",4,7,11,36.36363636363637
1995,101235,"Paul Haarhuis",33,24,57,57.89473684210526
1995,101249,"Andrei Olhovskiy",12,21,33,36.36363636363637
1995,101263,"Luke Jensen",3,7,10,30
1995,101265,"Patrick McEnroe",29,25,54,53.7037037037037
1995,101280,"Mikael Stadling",1,1,2,50
1995,101285,"Thierry Champion",4,3,7,57.142857142857146
1995,101311,"Kent Kinnear",1,3,4,25
1995,101318,"Javier Frana",22,15,37,59.45945945945946
1995,101320,"Magnus Gustafsson",11,11,22,50
1995,101334,"Alexander Volkov",33,27,60,55
1995,101353,"Lionel Barthez",1,4,5,20
1995,101358,"Olivier Delaitre",17,27,44,38.63636363636363
1995,101365,"Paul Wekesa",8,20,28,28.571428571428573
1995,101370,"Paolo Pambianco",1,1,2,50
1995,101373,"Karsten Braasch",9,17,26,34.61538461538461
1995,101374,"Leonardo Lavalle",1,2,3,33.333333333333336
1995,101377,"Christian Bergstrom",2,5,7,28.571428571428573
1995,101381,"Aaron Krickstein",16,24,40,40
1995,101382,"Marcelo Filippini",15,20,35,42.857142857142854
1995,101391,"Carl Uwe Steeb",12,16,28,42.857142857142854
1995,101404,"Thomas Muster",84,17,101,83.16831683168317
1995,101406,"Wojtek Kowalski",1,5,6,16.666666666666668
1995,101409,"Jaime Yzaga",13,24,37,35.13513513513514
1995,101412,"Shuzo Matsuoka",16,17,33,48.484848484848484
1995,101414,"Boris Becker",51,18,69,73.91304347826087
1995,101420,"Vaclav Roubicek",1,2,3,33.333333333333336
1995,101430,"Sergio Cortes",2,2,4,50
1995,101432,"Dimitri Poliakov",2,6,8,25
1995,101434,"Petr Korda",25,23,48,52.083333333333336
1995,101439,"Javier Sanchez",33,32,65,50.76923076923077
1995,101441,"Martin Sinner",16,22,38,42.10526315789474
1995,101460,"Jose Francisco Altur",1,1,2,50
1995,101463,"Bernd Karbacher",25,26,51,49.01960784313726
1995,101468,"Gerard Solves",3,6,9,33.333333333333336
1995,101475,"Carlos Costa",30,22,52,57.69230769230769
1995,101479,"Tj Middleton",2,1,3,66.66666666666667
1995,101481,"Omar Camporese",6,4,10,60
1995,101482,"Markus Zoecke",3,16,19,15.789473684210526
1995,101492,"Sander Groen",3,4,7,42.857142857142854
1995,101495,"Miguel Tobon",4,1,5,80
1995,101507,"Tomas Carbonell",26,26,52,50
1995,101510,"Henrik Holm",15,15,30,50
1995,101511,"Horst Skoff",2,13,15,13.333333333333334
1995,101515,"Donald Johnson",2,7,9,22.22222222222222
1995,101529,"Michael Stich",42,18,60,70
1995,101532,"Francisco Clavet",31,27,58,53.44827586206897
1995,101534,"Libor Nemecek",1,2,3,33.333333333333336
1995,101543,"Jeff Tarango",18,24,42,42.857142857142854
1995,101549,"Rodolphe Gilbert",7,12,19,36.8421052631579
1995,101552,"Xavier Daufresne",1,1,2,50
1995,101567,"Hendrik Jan Davids",1,6,7,14.285714285714286
1995,101582,"Gilbert Schaller",43,28,71,60.563380281690144
1995,101589,"Arnaud Boetsch",45,33,78,57.69230769230769
1995,101591,"Danny Sapsford",2,11,13,15.384615384615385
1995,101594,"Carsten Arriens",9,11,20,45
1995,101597,"Louis Gloria",2,8,10,20
1995,101601,"Brett Steven",32,24,56,57.142857142857146
1995,101609,"David Wheaton",28,24,52,53.84615384615385
1995,101611,"Cedric Pioline",24,27,51,47.05882352941177
1995,101613,"Malivai Washington",28,28,56,50
1995,101626,"Stephen Noteboom",1,1,2,50
1995,101636,"Wade Mcguire",3,5,8,37.5
1995,101647,"Byron Black",28,24,52,53.84615384615385
1995,101659,"Jan Apell",17,15,32,53.125
1995,101660,"Francisco Montana",1,3,4,25
1995,101672,"Michael Geserer",2,2,4,50
1995,101681,"Chris Wilkinson",5,7,12,41.666666666666664
1995,101682,"David Adams",1,6,7,14.285714285714286
1995,101686,"Franco Davin",4,9,13,30.76923076923077
1995,101701,"Bing Pan",3,2,5,60
1995,101703,"Guillaume Raoux",17,22,39,43.58974358974359
1995,101704,"Ellis Ferreira",1,2,3,33.333333333333336
1995,101711,"Alex Obrien",7,17,24,29.166666666666668
1995,101717,"Diego Nargiso",5,10,15,33.333333333333336
1995,101723,"Magnus Larsson",34,15,49,69.38775510204081
1995,101727,"Jason Stoltenberg",22,25,47,46.808510638297875
1995,101731,"Nuno Marques",6,15,21,28.571428571428573
1995,101732,"Pietro Pennisi",1,1,2,50
1995,101733,"Jan Siemerink",37,29,66,56.06060606060606
1995,101735,"Richard Fromberg",18,20,38,47.36842105263158
1995,101736,"Andre Agassi",71,9,80,88.75
1995,101746,"Renzo Furlan",37,31,68,54.411764705882355
1995,101750,"Cristiano Caratti",12,17,29,41.37931034482759
1995,101761,"Jaime Oncins",1,2,3,33.333333333333336
1995,101767,"Lars Jonsson",6,10,16,37.5
1995,101772,"Andrei Cherkasov",2,5,7,28.571428571428573
1995,101774,"Todd Martin",45,24,69,65.21739130434783
1995,101775,"Frederik Fetterlein",10,12,22,45.45454545454545
1995,101776,"Sandon Stolle",7,9,16,43.75
1995,101780,"Alejo Mancisidor",2,10,12,16.666666666666668
1995,101783,"Mark Petchey",7,15,22,31.818181818181817
1995,101789,"Steve Bryan",1,4,5,20
1995,101792,"Slava Dosedel",27,25,52,51.92307692307692
1995,101793,"Jim Courier",59,20,79,74.68354430379746
1995,101797,"Jacco Eltingh",25,28,53,47.16981132075472
1995,101805,"David Nainkin",4,5,9,44.44444444444444
1995,101806,"Marc Kevin Goellner",23,24,47,48.93617021276596
1995,101809,"Nicolas Pereira",14,18,32,43.75
1995,101816,"Steve Campbell",6,7,13,46.15384615384615
1995,101820,"Marc Rosset",38,21,59,64.40677966101696
1995,101826,"Alex Lopez Moron",11,15,26,42.30769230769231
1995,101833,"Michael Tebbutt",18,21,39,46.15384615384615
1995,101835,"Arne Thoms",4,4,8,50
1995,101843,"Sergi Bruguera",37,19,56,66.07142857142857
1995,101864,"Fernon Wibier",1,3,4,25
1995,101865,"Albert Chang",3,6,9,33.333333333333336
1995,101866,"David Rikl",7,13,20,35
1995,101868,"Dick Norman",7,7,14,50
1995,101888,"Daniel Vacek",30,31,61,49.18032786885246
1995,101889,"Todd Woodbridge",32,22,54,59.25925925925926
1995,101890,"Jonathan Stark",18,24,42,42.857142857142854
1995,101897,"Fernando Meligeni",22,18,40,55
1995,101900,"Nicklas Kulti",6,8,14,42.857142857142854
1995,101901,"Chuck Adams",6,5,11,54.54545454545455
1995,101917,"Grant Stafford",2,7,9,22.22222222222222
1995,101920,"Jamie Morgan",9,17,26,34.61538461538461
1995,101924,"Stefano Pescosolido",20,17,37,54.054054054054056
1995,101929,"Joost Winnink",5,8,13,38.46153846153846
1995,101932,"Jared Palmer",17,20,37,45.945945945945944
1995,101945,"Thierry Guardiola",5,12,17,29.41176470588235
1995,101948,"Pete Sampras",66,17,83,79.51807228915662
1995,101955,"Luis Herrera",4,6,10,40
1995,101956,"Mark Knowles",3,4,7,42.857142857142854
1995,101962,"Younes El Aynaoui",4,5,9,44.44444444444444
1995,101964,"Goran Ivanisevic",45,22,67,67.16417910447761
1995,101965,"Wayne Ferreira",55,25,80,68.75
1995,101980,"Howard Joffe",1,1,2,50
1995,101990,"Richard Krajicek",40,23,63,63.492063492063494
1995,101991,"Mauricio Hadad",17,11,28,60.714285714285715
1995,102021,"Michael Chang",65,19,84,77.38095238095238
1995,102024,"Hernan Gumy",25,17,42,59.523809523809526
1995,102025,"Mikael Tillstrom",4,3,7,57.142857142857146
1995,102029,"Filip Dewulf",14,12,26,53.84615384615385
1995,102031,"Sandor Noszaly",8,14,22,36.36363636363637
1995,102035,"Jonas Bjorkman",34,27,61,55.73770491803279
1995,102053,"Brian Macphie",2,3,5,40
1995,102061,"Kevin Ullyett",1,1,2,50
1995,102085,"Sasa Hirszon",1,5,6,16.666666666666668
1995,102087,"Oleg Ogorodov",4,5,9,44.44444444444444
1995,102088,"Joern Renzenbrink",6,17,23,26.08695652173913
1995,102104,"Christian Ruud",15,24,39,38.46153846153846
1995,102110,"Daniel Nestor",3,5,8,37.5
1995,102113,"Daniele Musa",2,4,6,33.333333333333336
1995,102118,"Radomir Vasek",10,16,26,38.46153846153846
1995,102132,"Ivan Baron",1,1,2,50
1995,102133,"Laurence Tieleman",2,4,6,33.333333333333336
1995,102135,"Emilio Benfele Alvarez",3,6,9,33.333333333333336
1995,102139,"Eyal Ran",2,4,6,33.333333333333336
1995,102146,"Jordi Burillo",18,22,40,45
1995,102148,"Fabrice Santoro",16,25,41,39.02439024390244
1995,102154,"Marcos Ondruska",16,19,35,45.714285714285715
1995,102158,"Patrick Rafter",31,24,55,56.36363636363637
1995,102162,"Chris Woodruff",1,2,3,33.333333333333336
1995,102169,"Michael Joyce",13,16,29,44.827586206896555
1995,102184,"David Prinosil",19,18,37,51.351351351351354
1995,102192,"Luis Adrian Morejon",3,2,5,60
1995,102198,"Paul Kilderry",3,6,9,33.333333333333336
1995,102201,"Lionel Roux",16,27,43,37.2093023255814
1995,102202,"Kenneth Carlsen",25,22,47,53.191489361702125
1995,102205,"Sebastien Lareau",12,17,29,41.37931034482759
1995,102212,"Corrado Borroni",2,2,4,50
1995,102223,"Karim Alami",15,14,29,51.724137931034484
1995,102227,"Sargis Sargsian",2,2,4,50
1995,102233,"Leander Paes",3,9,12,25
1995,102234,"Oliver Gross",9,14,23,39.130434782608695
1995,102235,"Tommy Ho",14,16,30,46.666666666666664
1995,102238,"Alberto Berasategui",36,29,65,55.38461538461539
1995,102243,"Marcelo Charpentier",1,4,5,20
1995,102247,"Andrea Gaudenzi",31,25,56,55.357142857142854
1995,102250,"Emanuel Couto",3,5,8,37.5
1995,102257,"Greg Rusedski",34,25,59,57.6271186440678
1995,102259,"Jerome Golmard",6,11,17,35.294117647058826
1995,102271,"Hicham Arazi",1,5,6,16.666666666666668
1995,102286,"Wayne Black",3,5,8,37.5
1995,102287,"Albert Portas",4,3,7,57.142857142857146
1995,102300,"Gouichi Motomura",1,2,3,33.333333333333336
1995,102304,"Grant Doyle",1,2,3,33.333333333333336
1995,102318,"Andrei Pavel",2,3,5,40
1995,102336,"Kotaro Miyachi",2,2,4,50
1995,102338,"Yevgeny Kafelnikov",69,29,98,70.40816326530613
1995,102339,"Kris Goossens",6,8,14,42.857142857142854
1995,102344,"Karol Kucera",21,27,48,43.75
1995,102351,"Oscar Martinez",7,17,24,29.166666666666668
1995,102358,"Thomas Enqvist",63,22,85,74.11764705882354
1995,102368,"Brian Dunn",1,3,4,25
1995,102372,"Sule Ladipo",1,1,2,50
1995,102374,"Alex Corretja",25,27,52,48.07692307692308
1995,102375,"Dinu Pescariu",1,3,4,25
1995,102394,"Johan Van Herck",3,6,9,33.333333333333336
1995,102397,"Jose Imaz Ruiz",1,2,3,33.333333333333336
1995,102401,"Scott Draper",13,13,26,50
1995,102434,"Vincent Spadea",21,28,49,42.857142857142854
1995,102437,"Adrian Voinea",13,19,32,40.625
1995,102446,"Andrei Medvedev",39,26,65,60
1995,102450,"Tim Henman",7,7,14,50
1995,102456,"Felix Mantilla",10,5,15,66.66666666666667
1995,102457,"Miles Maclagan",1,1,2,50
1995,102466,"Jan Kroslak",8,11,19,42.10526315789474
1995,102477,"Gaston Etlis",5,9,14,35.714285714285715
1995,102484,"Massimo Calvelli",1,1,2,50
1995,102491,"Alex Radulescu",4,5,9,44.44444444444444
1995,102497,"Mashiska Washington",3,2,5,60
1995,102519,"Marcio Carlsson",1,1,2,50
1995,102521,"Hendrik Dreekmann",14,17,31,45.16129032258065
1995,102524,"Neville Godwin",2,3,5,40
1995,102539,"Bohdan Ulihrach",29,20,49,59.183673469387756
1995,102562,"Jiri Novak",5,9,14,35.714285714285715
1995,102563,"Thomas Johansson",1,3,4,25
1995,102588,"Lars Rehmann",9,10,19,47.36842105263158
1995,102610,"Albert Costa",33,22,55,60
1995,102650,"Roberto Carretero",4,6,10,40
1995,102654,"Steven Downs",1,1,2,50
1995,102669,"Noam Behr",1,1,2,50
1995,102694,"Lars Burgsmuller",1,3,4,25
1995,102701,"Marcelo Rios",38,20,58,65.51724137931035
1995,102703,"Hyung Taik Lee",1,1,2,50
1995,102716,"Maxime Huard",2,1,3,66.66666666666667
1995,102765,"Nicolas Escude",1,2,3,33.333333333333336
1995,102776,"Andrew Ilie",5,5,10,50
1995,102796,"Magnus Norman",3,2,5,60
1995,102836,"Rogier Wassen",1,2,3,33.333333333333336
1995,102839,"Nicolas Lapentti",5,NA,NA,NA
1995,102845,"Carlos Moya",11,7,18,61.111111111111114
1995,102854,"Sjeng Schalken",17,14,31,54.83870967741935
1995,102869,"Galo Blanco",3,4,7,42.857142857142854
1995,102881,"David Skoch",1,1,2,50
1995,102882,"Mark Philippoussis",25,17,42,59.523809523809526
1995,102925,"Justin Gimelstob",1,1,2,50
1995,103009,"Razvan Sabau",1,2,3,33.333333333333336
1995,103017,"Nicolas Kiefer",3,3,6,50
1995,103060,"Alejandro Hernandez",1,2,3,33.333333333333336
1995,103151,"Mariano Zabaleta",2,2,4,50
1995,103181,"Jiri Vanek",1,1,2,50
1995,210013,"Martin Damm Sr",15,22,37,40.54054054054054
1996,100757,"Anders Jarryd",1,8,9,11.11111111111111
1996,101016,"Marcos Aurelio Gorriz",6,7,13,46.15384615384615
1996,101026,"Jim Grabb",6,10,16,37.5
1996,101062,"Mats Wilander",7,11,18,38.888888888888886
1996,101084,"Jakob Hlasek",23,28,51,45.09803921568628
1996,101098,"Guy Forget",24,23,47,51.06382978723404
1996,101120,"Karel Novacek",1,3,4,25
1996,101133,"Patrick Baur",3,12,15,20
1996,101142,"Emilio Sanchez",7,16,23,30.434782608695652
1996,101150,"Gianluca Pozzi",7,14,21,33.333333333333336
1996,101179,"Jean Philippe Fleurian",9,15,24,37.5
1996,101185,"Mark Woodforde",32,25,57,56.14035087719298
1996,101191,"Richey Reneberg",38,25,63,60.317460317460316
1996,101196,"Derrick Rostagno",2,5,7,28.571428571428573
1996,101214,"Bryan Shelton",6,8,14,42.857142857142854
1996,101222,"Stefan Edberg",44,25,69,63.768115942028984
1996,101230,"Andrei Chesnokov",11,22,33,33.333333333333336
1996,101234,"Patrik Kuhnen",1,2,3,33.333333333333336
1996,101235,"Paul Haarhuis",31,29,60,51.666666666666664
1996,101249,"Andrei Olhovskiy",21,19,40,52.5
1996,101263,"Luke Jensen",3,9,12,25
1996,101265,"Patrick McEnroe",4,6,10,40
1996,101285,"Thierry Champion",1,5,6,16.666666666666668
1996,101318,"Javier Frana",25,21,46,54.34782608695652
1996,101320,"Magnus Gustafsson",37,17,54,68.51851851851852
1996,101334,"Alexander Volkov",13,22,35,37.142857142857146
1996,101358,"Olivier Delaitre",2,8,10,20
1996,101362,"Stephane Simian",6,10,16,37.5
1996,101374,"Leonardo Lavalle",1,1,2,50
1996,101382,"Marcelo Filippini",14,15,29,48.275862068965516
1996,101391,"Carl Uwe Steeb",7,21,28,25
1996,101404,"Thomas Muster",65,21,86,75.5813953488372
1996,101406,"Wojtek Kowalski",3,3,6,50
1996,101409,"Jaime Yzaga",2,2,4,50
1996,101412,"Shuzo Matsuoka",12,24,36,33.333333333333336
1996,101414,"Boris Becker",42,15,57,73.6842105263158
1996,101416,"Joao Cunha Silva",3,12,15,20
1996,101434,"Petr Korda",40,17,57,70.17543859649123
1996,101439,"Javier Sanchez",30,33,63,47.61904761904762
1996,101441,"Martin Sinner",7,12,19,36.8421052631579
1996,101459,"Tomas Nydahl",1,3,4,25
1996,101462,"Francisco Roig",4,4,8,50
1996,101463,"Bernd Karbacher",19,25,44,43.18181818181818
1996,101468,"Gerard Solves",1,4,5,20
1996,101473,"Jozsef Krocsko",1,2,3,33.333333333333336
1996,101475,"Carlos Costa",25,25,50,50
1996,101481,"Omar Camporese",5,13,18,27.77777777777778
1996,101490,"Daniel Orsanic",1,1,2,50
1996,101507,"Tomas Carbonell",21,25,46,45.65217391304348
1996,101510,"Henrik Holm",2,4,6,33.333333333333336
1996,101515,"Donald Johnson",1,2,3,33.333333333333336
1996,101529,"Michael Stich",25,15,40,62.5
1996,101532,"Francisco Clavet",37,28,65,56.92307692307692
1996,101543,"Jeff Tarango",14,18,32,43.75
1996,101567,"Hendrik Jan Davids",4,6,10,40
1996,101582,"Gilbert Schaller",18,25,43,41.86046511627907
1996,101584,"Keith Evans",1,1,2,50
1996,101589,"Arnaud Boetsch",28,26,54,51.851851851851855
1996,101591,"Danny Sapsford",5,6,11,45.45454545454545
1996,101594,"Carsten Arriens",1,2,3,33.333333333333336
1996,101600,"Daniel Courcol",2,2,4,50
1996,101601,"Brett Steven",15,13,28,53.57142857142857
1996,101608,"Tom Kempers",2,3,5,40
1996,101609,"David Wheaton",12,15,27,44.44444444444444
1996,101611,"Cedric Pioline",38,21,59,64.40677966101696
1996,101613,"Malivai Washington",33,23,56,58.92857142857143
1996,101636,"Wade Mcguire",1,5,6,16.666666666666668
1996,101647,"Byron Black",35,27,62,56.45161290322581
1996,101649,"Guillermo Perez Roldan",1,6,7,14.285714285714286
1996,101659,"Jan Apell",3,9,12,25
1996,101660,"Francisco Montana",2,5,7,28.571428571428573
1996,101681,"Chris Wilkinson",3,9,12,25
1996,101687,"David Dilucia",1,2,3,33.333333333333336
1996,101688,"Geoff Grant",1,2,3,33.333333333333336
1996,101703,"Guillaume Raoux",21,22,43,48.83720930232558
1996,101711,"Alex Obrien",18,10,28,64.28571428571429
1996,101717,"Diego Nargiso",2,8,10,20
1996,101719,"Frederic Fontang",1,2,3,33.333333333333336
1996,101723,"Magnus Larsson",27,25,52,51.92307692307692
1996,101727,"Jason Stoltenberg",33,26,59,55.932203389830505
1996,101731,"Nuno Marques",7,14,21,33.333333333333336
1996,101733,"Jan Siemerink",35,28,63,55.55555555555556
1996,101735,"Richard Fromberg",18,21,39,46.15384615384615
1996,101736,"Andre Agassi",38,14,52,73.07692307692308
1996,101745,"Roberto Jabali",1,4,5,20
1996,101746,"Renzo Furlan",32,27,59,54.23728813559322
1996,101750,"Cristiano Caratti",8,15,23,34.78260869565217
1996,101766,"Bill Behrens",2,3,5,40
1996,101767,"Lars Jonsson",3,6,9,33.333333333333336
1996,101772,"Andrei Cherkasov",3,12,15,20
1996,101774,"Todd Martin",51,21,72,70.83333333333333
1996,101775,"Frederik Fetterlein",7,19,26,26.923076923076923
1996,101776,"Sandon Stolle",24,20,44,54.54545454545455
1996,101783,"Mark Petchey",5,7,12,41.666666666666664
1996,101788,"Doug Flach",3,2,5,60
1996,101789,"Steve Bryan",5,5,10,50
1996,101792,"Slava Dosedel",21,13,34,61.76470588235294
1996,101793,"Jim Courier",28,17,45,62.22222222222222
1996,101797,"Jacco Eltingh",4,12,16,25
1996,101800,"Daniele Balducci",1,1,2,50
1996,101805,"David Nainkin",5,10,15,33.333333333333336
1996,101806,"Marc Kevin Goellner",25,24,49,51.02040816326531
1996,101809,"Nicolas Pereira",15,20,35,42.857142857142854
1996,101814,"Colin Beecher",1,2,3,33.333333333333336
1996,101816,"Steve Campbell",2,7,9,22.22222222222222
1996,101819,"Frederic Vitoux",2,5,7,28.571428571428573
1996,101820,"Marc Rosset",37,28,65,56.92307692307692
1996,101821,"Peter Tramacchi",2,4,6,33.333333333333336
1996,101822,"Luis Lobo",1,1,2,50
1996,101833,"Michael Tebbutt",13,16,29,44.827586206896555
1996,101843,"Sergi Bruguera",26,21,47,55.319148936170215
1996,101864,"Fernon Wibier",3,3,6,50
1996,101866,"David Rikl",10,21,31,32.25806451612903
1996,101868,"Dick Norman",1,10,11,9.090909090909092
1996,101869,"Juan Luis Tati Rascon",1,2,3,33.333333333333336
1996,101885,"Wayne Arthurs",1,2,3,33.333333333333336
1996,101888,"Daniel Vacek",23,29,52,44.23076923076923
1996,101889,"Todd Woodbridge",34,24,58,58.62068965517241
1996,101890,"Jonathan Stark",19,16,35,54.285714285714285
1996,101897,"Fernando Meligeni",17,18,35,48.57142857142857
1996,101900,"Nicklas Kulti",14,16,30,46.666666666666664
1996,101901,"Chuck Adams",5,7,12,41.666666666666664
1996,101904,"Chris Haggard",1,1,2,50
1996,101917,"Grant Stafford",10,13,23,43.47826086956522
1996,101924,"Stefano Pescosolido",13,25,38,34.21052631578947
1996,101929,"Joost Winnink",2,2,4,50
1996,101932,"Jared Palmer",4,7,11,36.36363636363637
1996,101937,"Robbie Koenig",1,3,4,25
1996,101938,"Bernardo Mota",2,3,5,40
1996,101945,"Thierry Guardiola",2,4,6,33.333333333333336
1996,101948,"Pete Sampras",66,12,78,84.61538461538461
1996,101956,"Mark Knowles",10,17,27,37.03703703703704
1996,101958,"Pierre Bouteyre",1,1,2,50
1996,101962,"Younes El Aynaoui",15,22,37,40.54054054054054
1996,101964,"Goran Ivanisevic",76,25,101,75.24752475247524
1996,101965,"Wayne Ferreira",48,25,73,65.75342465753425
1996,101969,"Orlin Stanoytchev",2,1,3,66.66666666666667
1996,101976,"Federico Dondo",1,1,2,50
1996,101990,"Richard Krajicek",46,27,73,63.013698630136986
1996,101991,"Mauricio Hadad",11,14,25,44
1996,101997,"Marzio Martelli",3,2,5,60
1996,102018,"Tamer El Sawy",1,4,5,20
1996,102019,"Dirk Dier",3,7,10,30
1996,102021,"Michael Chang",63,19,82,76.82926829268293
1996,102024,"Hernan Gumy",28,28,56,50
1996,102025,"Mikael Tillstrom",24,19,43,55.81395348837209
1996,102029,"Filip Dewulf",19,32,51,37.254901960784316
1996,102031,"Sandor Noszaly",4,21,25,16
1996,102035,"Jonas Bjorkman",23,25,48,47.916666666666664
1996,102053,"Brian Macphie",3,4,7,42.857142857142854
1996,102085,"Sasa Hirszon",2,3,5,40
1996,102087,"Oleg Ogorodov",8,17,25,32
1996,102088,"Joern Renzenbrink",3,7,10,30
1996,102104,"Christian Ruud",24,24,48,50
1996,102110,"Daniel Nestor",11,13,24,45.833333333333336
1996,102113,"Daniele Musa",1,2,3,33.333333333333336
1996,102133,"Laurence Tieleman",1,3,4,25
1996,102135,"Emilio Benfele Alvarez",8,8,16,50
1996,102139,"Eyal Ran",3,5,8,37.5
1996,102146,"Jordi Burillo",14,21,35,40
1996,102148,"Fabrice Santoro",6,12,18,33.333333333333336
1996,102152,"Pablo Campana",2,3,5,40
1996,102154,"Marcos Ondruska",17,20,37,45.945945945945944
1996,102158,"Patrick Rafter",25,20,45,55.55555555555556
1996,102162,"Chris Woodruff",20,18,38,52.63157894736842
1996,102167,"Juan Albert Viloca Puig",5,7,12,41.666666666666664
1996,102169,"Michael Joyce",19,22,41,46.34146341463415
1996,102179,"Antony Dupuis",1,1,2,50
1996,102184,"David Prinosil",24,27,51,47.05882352941177
1996,102192,"Luis Adrian Morejon",5,12,17,29.41176470588235
1996,102201,"Lionel Roux",14,19,33,42.42424242424242
1996,102202,"Kenneth Carlsen",19,23,42,45.23809523809524
1996,102205,"Sebastien Lareau",15,15,30,50
1996,102214,"Oscar Ortiz",1,3,4,25
1996,102220,"Patrik Fredriksson",5,9,14,35.714285714285715
1996,102223,"Karim Alami",16,21,37,43.24324324324324
1996,102227,"Sargis Sargsian",4,6,10,40
1996,102233,"Leander Paes",13,11,24,54.166666666666664
1996,102234,"Oliver Gross",4,6,10,40
1996,102235,"Tommy Ho",1,2,3,33.333333333333336
1996,102238,"Alberto Berasategui",46,26,72,63.888888888888886
1996,102243,"Marcelo Charpentier",3,5,8,37.5
1996,102247,"Andrea Gaudenzi",26,27,53,49.056603773584904
1996,102252,"Ignacio Truyol",4,6,10,40
1996,102257,"Greg Rusedski",38,26,64,59.375
1996,102259,"Jerome Golmard",3,14,17,17.647058823529413
1996,102269,"Jeff Salzenstein",1,1,2,50
1996,102271,"Hicham Arazi",12,17,29,41.37931034482759
1996,102284,"Filippo Messori",1,3,4,25
1996,102286,"Wayne Black",3,5,8,37.5
1996,102318,"Andrei Pavel",3,3,6,50
1996,102336,"Kotaro Miyachi",1,1,2,50
1996,102338,"Yevgeny Kafelnikov",76,25,101,75.24752475247524
1996,102339,"Kris Goossens",4,18,22,18.181818181818183
1996,102344,"Karol Kucera",18,25,43,41.86046511627907
1996,102351,"Oscar Martinez",1,2,3,33.333333333333336
1996,102358,"Thomas Enqvist",52,28,80,65
1996,102363,"Filippo Veglio",1,2,3,33.333333333333336
1996,102374,"Alex Corretja",37,26,63,58.73015873015873
1996,102375,"Dinu Pescariu",2,5,7,28.571428571428573
1996,102394,"Johan Van Herck",16,20,36,44.44444444444444
1996,102401,"Scott Draper",18,24,42,42.857142857142854
1996,102405,"Mahesh Bhupathi",1,1,2,50
1996,102413,"Andy Zingman",1,2,3,33.333333333333336
1996,102433,"Mose Navarra",2,1,3,66.66666666666667
1996,102434,"Vincent Spadea",27,22,49,55.10204081632653
1996,102437,"Adrian Voinea",28,25,53,52.83018867924528
1996,102446,"Andrei Medvedev",32,22,54,59.25925925925926
1996,102450,"Tim Henman",38,25,63,60.317460317460316
1996,102456,"Felix Mantilla",48,27,75,64
1996,102463,"Lucas Arnold Ker",3,2,5,60
1996,102465,"Gabriel Silberstein",1,1,2,50
1996,102466,"Jan Kroslak",15,18,33,45.45454545454545
1996,102477,"Gaston Etlis",2,10,12,16.666666666666668
1996,102491,"Alex Radulescu",12,14,26,46.15384615384615
1996,102521,"Hendrik Dreekmann",22,19,41,53.65853658536585
1996,102522,"Fabio Maggi",2,3,5,40
1996,102524,"Neville Godwin",7,6,13,53.84615384615385
1996,102539,"Bohdan Ulihrach",35,33,68,51.470588235294116
1996,102562,"Jiri Novak",30,24,54,55.55555555555556
1996,102563,"Thomas Johansson",28,21,49,57.142857142857146
1996,102571,"Gregory Carraz",1,3,4,25
1996,102584,"Alexandre Strambini",1,1,2,50
1996,102585,"Sebastian Prieto",1,1,2,50
1996,102610,"Albert Costa",49,28,77,63.63636363636363
1996,102614,"Victor Sendin",1,2,3,33.333333333333336
1996,102615,"Dennis Van Scheppingen",4,5,9,44.44444444444444
1996,102644,"Franco Squillari",7,7,14,50
1996,102650,"Roberto Carretero",11,14,25,44
1996,102655,"Jimy Szymanski",2,6,8,25
1996,102687,"Herbert Wiltschnig",1,4,5,20
1996,102694,"Lars Burgsmuller",6,6,12,50
1996,102701,"Marcelo Rios",53,25,78,67.94871794871794
1996,102743,"Ben Ellwood",1,2,3,33.333333333333336
1996,102776,"Andrew Ilie",1,3,4,25
1996,102796,"Magnus Norman",13,10,23,56.52173913043478
1996,102831,"Jacobo Diaz",2,4,6,33.333333333333336
1996,102835,"Luke Milligan",2,2,4,50
1996,102839,"Nicolas Lapentti",11,19,30,36.666666666666664
1996,102845,"Carlos Moya",42,28,70,60
1996,102854,"Sjeng Schalken",25,26,51,49.01960784313726
1996,102856,"Gustavo Kuerten",8,10,18,44.44444444444444
1996,102863,"Takao Suzuki",1,1,2,50
1996,102869,"Galo Blanco",11,16,27,40.74074074074074
1996,102881,"David Skoch",1,3,4,25
1996,102882,"Mark Philippoussis",33,23,56,58.92857142857143
1996,102887,"Ramon Delgado",2,2,4,50
1996,102897,"Nir Welgreen",1,2,3,33.333333333333336
1996,102905,"Stefan Koubek",1,2,3,33.333333333333336
1996,102925,"Justin Gimelstob",3,9,12,25
1996,102950,"Fernando Vicente",3,3,6,50
1996,103017,"Nicolas Kiefer",5,8,13,38.46153846153846
1996,103060,"Alejandro Hernandez",5,5,10,50
1996,103118,"Ion Moldovan",2,1,3,66.66666666666667
1996,103151,"Mariano Zabaleta",9,8,17,52.94117647058823
1996,103163,"Tommy Haas",4,3,7,57.142857142857146
1996,103182,"Markus Hipfl",1,2,3,33.333333333333336
1996,103252,"Alberto Martin",2,3,5,40
1996,103344,"Ivan Ljubicic",1,1,2,50
1996,103420,"Michal Tabara",2,2,4,50
1996,210013,"Martin Damm Sr",34,29,63,53.96825396825397
1997,101016,"Marcos Aurelio Gorriz",2,11,13,15.384615384615385
1997,101026,"Jim Grabb",2,7,9,22.22222222222222
1997,101133,"Patrick Baur",2,3,5,40
1997,101138,"Pat Cash",2,7,9,22.22222222222222
1997,101150,"Gianluca Pozzi",3,7,10,30
1997,101179,"Jean Philippe Fleurian",4,5,9,44.44444444444444
1997,101185,"Mark Woodforde",25,28,53,47.16981132075472
1997,101191,"Richey Reneberg",18,20,38,47.36842105263158
1997,101214,"Bryan Shelton",4,6,10,40
1997,101230,"Andrei Chesnokov",2,4,6,33.333333333333336
1997,101235,"Paul Haarhuis",20,27,47,42.5531914893617
1997,101263,"Luke Jensen",2,5,7,28.571428571428573
1997,101265,"Patrick McEnroe",2,11,13,15.384615384615385
1997,101285,"Thierry Champion",5,14,19,26.31578947368421
1997,101318,"Javier Frana",6,9,15,40
1997,101320,"Magnus Gustafsson",26,20,46,56.52173913043478
1997,101334,"Alexander Volkov",8,12,20,40
1997,101358,"Olivier Delaitre",10,13,23,43.47826086956522
1997,101362,"Stephane Simian",8,15,23,34.78260869565217
1997,101373,"Karsten Braasch",2,3,5,40
1997,101382,"Marcelo Filippini",26,21,47,55.319148936170215
1997,101404,"Thomas Muster",43,23,66,65.15151515151516
1997,101412,"Shuzo Matsuoka",2,3,5,40
1997,101414,"Boris Becker",17,13,30,56.666666666666664
1997,101417,"Mario Rincon",1,1,2,50
1997,101434,"Petr Korda",54,25,79,68.35443037974683
1997,101439,"Javier Sanchez",35,33,68,51.470588235294116
1997,101441,"Martin Sinner",9,14,23,39.130434782608695
1997,101459,"Tomas Nydahl",7,11,18,38.888888888888886
1997,101462,"Francisco Roig",3,7,10,30
1997,101463,"Bernd Karbacher",5,11,16,31.25
1997,101468,"Gerard Solves",6,6,12,50
1997,101473,"Jozsef Krocsko",1,3,4,25
1997,101475,"Carlos Costa",20,23,43,46.51162790697674
1997,101481,"Omar Camporese",1,8,9,11.11111111111111
1997,101495,"Miguel Tobon",1,1,2,50
1997,101507,"Tomas Carbonell",8,13,21,38.095238095238095
1997,101510,"Henrik Holm",2,5,7,28.571428571428573
1997,101515,"Donald Johnson",1,1,2,50
1997,101529,"Michael Stich",17,13,30,56.666666666666664
1997,101532,"Francisco Clavet",41,24,65,63.07692307692308
1997,101543,"Jeff Tarango",31,29,60,51.666666666666664
1997,101549,"Rodolphe Gilbert",1,2,3,33.333333333333336
1997,101567,"Hendrik Jan Davids",1,2,3,33.333333333333336
1997,101582,"Gilbert Schaller",12,17,29,41.37931034482759
1997,101589,"Arnaud Boetsch",13,22,35,37.142857142857146
1997,101591,"Danny Sapsford",3,3,6,50
1997,101594,"Carsten Arriens",2,2,4,50
1997,101601,"Brett Steven",24,17,41,58.53658536585366
1997,101609,"David Wheaton",10,8,18,55.55555555555556
1997,101611,"Cedric Pioline",37,25,62,59.67741935483871
1997,101613,"Malivai Washington",5,5,10,50
1997,101647,"Byron Black",27,24,51,52.94117647058823
1997,101659,"Jan Apell",1,2,3,33.333333333333336
1997,101675,"Martin Rodriguez",1,2,3,33.333333333333336
1997,101681,"Chris Wilkinson",4,6,10,40
1997,101687,"David Dilucia",1,1,2,50
1997,101688,"Geoff Grant",1,5,6,16.666666666666668
1997,101703,"Guillaume Raoux",26,26,52,50
1997,101711,"Alex Obrien",21,28,49,42.857142857142854
1997,101717,"Diego Nargiso",2,3,5,40
1997,101719,"Frederic Fontang",3,5,8,37.5
1997,101723,"Magnus Larsson",39,23,62,62.903225806451616
1997,101727,"Jason Stoltenberg",21,15,36,58.333333333333336
1997,101731,"Nuno Marques",3,8,11,27.272727272727273
1997,101733,"Jan Siemerink",19,29,48,39.583333333333336
1997,101735,"Richard Fromberg",19,25,44,43.18181818181818
1997,101736,"Andre Agassi",10,12,22,45.45454545454545
1997,101746,"Renzo Furlan",18,27,45,40
1997,101750,"Cristiano Caratti",1,6,7,14.285714285714286
1997,101767,"Lars Jonsson",2,7,9,22.22222222222222
1997,101772,"Andrei Cherkasov",5,10,15,33.333333333333336
1997,101774,"Todd Martin",13,7,20,65
1997,101775,"Frederik Fetterlein",6,8,14,42.857142857142854
1997,101776,"Sandon Stolle",22,19,41,53.65853658536585
1997,101783,"Mark Petchey",2,3,5,40
1997,101788,"Doug Flach",11,14,25,44
1997,101792,"Slava Dosedel",24,18,42,57.142857142857146
1997,101793,"Jim Courier",34,19,53,64.15094339622641
1997,101797,"Jacco Eltingh",1,5,6,16.666666666666668
1997,101805,"David Nainkin",2,2,4,50
1997,101806,"Marc Kevin Goellner",22,34,56,39.285714285714285
1997,101812,"Raviv Weidenfeld",1,2,3,33.333333333333336
1997,101816,"Steve Campbell",8,8,16,50
1997,101820,"Marc Rosset",32,31,63,50.79365079365079
1997,101821,"Peter Tramacchi",1,1,2,50
1997,101823,"Gerald Mandl",1,1,2,50
1997,101833,"Michael Tebbutt",6,11,17,35.294117647058826
1997,101843,"Sergi Bruguera",49,28,77,63.63636363636363
1997,101864,"Fernon Wibier",6,10,16,37.5
1997,101866,"David Rikl",3,4,7,42.857142857142854
1997,101868,"Dick Norman",4,4,8,50
1997,101888,"Daniel Vacek",19,26,45,42.22222222222222
1997,101889,"Todd Woodbridge",32,20,52,61.53846153846154
1997,101890,"Jonathan Stark",17,23,40,42.5
1997,101897,"Fernando Meligeni",24,19,43,55.81395348837209
1997,101900,"Nicklas Kulti",9,17,26,34.61538461538461
1997,101917,"Grant Stafford",21,20,41,51.21951219512195
1997,101926,"Andrei Merinov",2,5,7,28.571428571428573
1997,101931,"Marcus Hilpert",1,1,2,50
1997,101938,"Bernardo Mota",1,2,3,33.333333333333336
1997,101947,"Vincenzo Santopadre",1,1,2,50
1997,101948,"Pete Sampras",55,11,66,83.33333333333333
1997,101955,"Luis Herrera",3,5,8,37.5
1997,101962,"Younes El Aynaoui",2,2,4,50
1997,101964,"Goran Ivanisevic",53,21,74,71.62162162162163
1997,101965,"Wayne Ferreira",26,22,48,54.166666666666664
1997,101969,"Orlin Stanoytchev",1,13,14,7.142857142857143
1997,101990,"Richard Krajicek",50,19,69,72.46376811594203
1997,101997,"Marzio Martelli",10,13,23,43.47826086956522
1997,102001,"German Lopez",1,1,2,50
1997,102002,"Davide Scala",6,7,13,46.15384615384615
1997,102018,"Tamer El Sawy",1,5,6,16.666666666666668
1997,102021,"Michael Chang",55,19,74,74.32432432432432
1997,102024,"Hernan Gumy",22,27,49,44.89795918367347
1997,102025,"Mikael Tillstrom",18,22,40,45
1997,102029,"Filip Dewulf",19,23,42,45.23809523809524
1997,102035,"Jonas Bjorkman",66,25,91,72.52747252747253
1997,102050,"Marco Meneschincheri",1,1,2,50
1997,102053,"Brian Macphie",3,4,7,42.857142857142854
1997,102061,"Kevin Ullyett",4,7,11,36.36363636363637
1997,102076,"Mark Merklein",3,4,7,42.857142857142854
1997,102087,"Oleg Ogorodov",4,11,15,26.666666666666668
1997,102103,"Michael Sell",1,1,2,50
1997,102104,"Christian Ruud",23,25,48,47.916666666666664
1997,102106,"Davide Sanguinetti",5,11,16,31.25
1997,102110,"Daniel Nestor",9,17,26,34.61538461538461
1997,102118,"Radomir Vasek",3,5,8,37.5
1997,102135,"Emilio Benfele Alvarez",15,19,34,44.11764705882353
1997,102139,"Eyal Ran",5,12,17,29.41176470588235
1997,102145,"Francisco Cabello",1,2,3,33.333333333333336
1997,102146,"Jordi Burillo",8,10,18,44.44444444444444
1997,102148,"Fabrice Santoro",32,23,55,58.18181818181818
1997,102154,"Marcos Ondruska",12,16,28,42.857142857142854
1997,102158,"Patrick Rafter",63,26,89,70.78651685393258
1997,102162,"Chris Woodruff",35,21,56,62.5
1997,102167,"Juan Albert Viloca Puig",20,26,46,43.47826086956522
1997,102169,"Michael Joyce",4,11,15,26.666666666666668
1997,102184,"David Prinosil",16,28,44,36.36363636363637
1997,102201,"Lionel Roux",18,24,42,42.857142857142854
1997,102202,"Kenneth Carlsen",24,26,50,48
1997,102205,"Sebastien Lareau",8,15,23,34.78260869565217
1997,102215,"Joshua Eagle",1,3,4,25
1997,102220,"Patrik Fredriksson",4,18,22,18.181818181818183
1997,102223,"Karim Alami",23,27,50,46
1997,102226,"David Witt",2,1,3,66.66666666666667
1997,102227,"Sargis Sargsian",18,23,41,43.90243902439025
1997,102233,"Leander Paes",13,18,31,41.935483870967744
1997,102234,"Oliver Gross",7,10,17,41.1764705882353
1997,102235,"Tommy Ho",3,4,7,42.857142857142854
1997,102238,"Alberto Berasategui",39,27,66,59.09090909090909
1997,102243,"Marcelo Charpentier",2,7,9,22.22222222222222
1997,102247,"Andrea Gaudenzi",14,20,34,41.1764705882353
1997,102257,"Greg Rusedski",53,23,76,69.73684210526316
1997,102259,"Jerome Golmard",12,16,28,42.857142857142854
1997,102269,"Jeff Salzenstein",4,9,13,30.76923076923077
1997,102271,"Hicham Arazi",28,27,55,50.90909090909091
1997,102284,"Filippo Messori",1,2,3,33.333333333333336
1997,102286,"Wayne Black",4,6,10,40
1997,102287,"Albert Portas",22,17,39,56.41025641025641
1997,102301,"Sebastien Leblanc",1,1,2,50
1997,102304,"Grant Doyle",2,3,5,40
1997,102318,"Andrei Pavel",8,16,24,33.333333333333336
1997,102338,"Yevgeny Kafelnikov",54,26,80,67.5
1997,102344,"Karol Kucera",33,27,60,55
1997,102348,"Hideki Kaneko",1,1,2,50
1997,102358,"Thomas Enqvist",35,22,57,61.40350877192982
1997,102359,"Andrew Richardson",4,4,8,50
1997,102374,"Alex Corretja",49,23,72,68.05555555555556
1997,102375,"Dinu Pescariu",3,13,16,18.75
1997,102394,"Johan Van Herck",12,18,30,40
1997,102401,"Scott Draper",23,20,43,53.48837209302326
1997,102405,"Mahesh Bhupathi",1,5,6,16.666666666666668
1997,102419,"Christophe Van Garsse",5,5,10,50
1997,102434,"Vincent Spadea",20,26,46,43.47826086956522
1997,102437,"Adrian Voinea",12,20,32,37.5
1997,102446,"Andrei Medvedev",30,23,53,56.60377358490566
1997,102450,"Tim Henman",47,23,70,67.14285714285714
1997,102456,"Felix Mantilla",53,22,75,70.66666666666667
1997,102457,"Miles Maclagan",1,1,2,50
1997,102463,"Lucas Arnold Ker",5,6,11,45.45454545454545
1997,102464,"Todd Larkham",1,4,5,20
1997,102465,"Gabriel Silberstein",2,3,5,40
1997,102466,"Jan Kroslak",18,14,32,56.25
1997,102472,"Marcello Craca",8,10,18,44.44444444444444
1997,102477,"Gaston Etlis",8,9,17,47.05882352941177
1997,102483,"David Caballero",1,1,2,50
1997,102491,"Alex Radulescu",23,27,50,46
1997,102494,"Tomas Behrend",1,1,2,50
1997,102506,"Quino Munoz",2,2,4,50
1997,102521,"Hendrik Dreekmann",15,20,35,42.857142857142854
1997,102524,"Neville Godwin",7,13,20,35
1997,102533,"Jens Knippschild",10,9,19,52.63157894736842
1997,102539,"Bohdan Ulihrach",26,30,56,46.42857142857143
1997,102548,"Juan Antonio Marin",9,13,22,40.90909090909091
1997,102562,"Jiri Novak",20,19,39,51.282051282051285
1997,102563,"Thomas Johansson",32,27,59,54.23728813559322
1997,102585,"Sebastian Prieto",1,2,3,33.333333333333336
1997,102610,"Albert Costa",44,20,64,68.75
1997,102615,"Dennis Van Scheppingen",10,15,25,40
1997,102644,"Franco Squillari",6,9,15,40
1997,102650,"Roberto Carretero",2,13,15,13.333333333333334
1997,102694,"Lars Burgsmuller",3,3,6,50
1997,102701,"Marcelo Rios",54,26,80,67.5
1997,102730,"Ivo Heuberger",1,3,4,25
1997,102743,"Ben Ellwood",2,4,6,33.333333333333336
1997,102765,"Nicolas Escude",6,6,12,50
1997,102770,"John Van Lottum",6,3,9,66.66666666666667
1997,102783,"Rainer Schuettler",5,2,7,71.42857142857143
1997,102785,"Glenn Weiner",2,2,4,50
1997,102796,"Magnus Norman",42,26,68,61.76470588235294
1997,102821,"Cecil Mamiit",2,7,9,22.22222222222222
1997,102831,"Jacobo Diaz",6,8,14,42.857142857142854
1997,102839,"Nicolas Lapentti",17,18,35,48.57142857142857
1997,102845,"Carlos Moya",53,29,82,64.63414634146342
1997,102854,"Sjeng Schalken",16,25,41,39.02439024390244
1997,102856,"Gustavo Kuerten",34,23,57,59.64912280701754
1997,102863,"Takao Suzuki",1,1,2,50
1997,102869,"Galo Blanco",16,20,36,44.44444444444444
1997,102875,"Luke Smith",2,3,5,40
1997,102881,"David Skoch",1,3,4,25
1997,102882,"Mark Philippoussis",46,19,65,70.76923076923077
1997,102887,"Ramon Delgado",2,6,8,25
1997,102897,"Nir Welgreen",1,2,3,33.333333333333336
1997,102903,"Eyal Erlich",1,2,3,33.333333333333336
1997,102905,"Stefan Koubek",4,2,6,66.66666666666667
1997,102910,"Salvador Navarro",1,2,3,33.333333333333336
1997,102911,"Andrei Stoliarov",2,2,4,50
1997,102925,"Justin Gimelstob",17,23,40,42.5
1997,102950,"Fernando Vicente",9,12,21,42.857142857142854
1997,102987,"Andre Sa",2,1,3,66.66666666666667
1997,102998,"Jan Michael Gambill",3,5,8,37.5
1997,103009,"Razvan Sabau",2,5,7,28.571428571428573
1997,103017,"Nicolas Kiefer",26,16,42,61.904761904761905
1997,103031,"Julian Alonso",21,11,32,65.625
1997,103060,"Alejandro Hernandez",2,6,8,25
1997,103084,"Guillermo Canas",1,4,5,20
1997,103096,"Arnaud Clement",11,9,20,55
1997,103103,"Dominik Hrbaty",24,23,47,51.06382978723404
1997,103114,"Martin Lee",3,3,6,50
1997,103163,"Tommy Haas",22,17,39,56.41025641025641
1997,103216,"Clemens Trimmel",1,1,2,50
1997,103239,"Marcus Sarstrand",1,1,2,50
1997,103252,"Alberto Martin",9,13,22,40.90909090909091
1997,103264,"Mariano Puerta",2,1,3,66.66666666666667
1997,103344,"Ivan Ljubicic",1,4,5,20
1997,210013,"Martin Damm Sr",24,26,50,48
1998,101061,"Jimmy Arias",1,1,2,50
1998,101086,"Ronald Agenor",1,1,2,50
1998,101150,"Gianluca Pozzi",22,27,49,44.89795918367347
1998,101185,"Mark Woodforde",25,25,50,50
1998,101191,"Richey Reneberg",11,15,26,42.30769230769231
1998,101230,"Andrei Chesnokov",2,3,5,40
1998,101235,"Paul Haarhuis",20,20,40,50
1998,101265,"Patrick McEnroe",1,2,3,33.333333333333336
1998,101320,"Magnus Gustafsson",37,21,58,63.793103448275865
1998,101353,"Lionel Barthez",1,1,2,50
1998,101358,"Olivier Delaitre",7,8,15,46.666666666666664
1998,101373,"Karsten Braasch",3,4,7,42.857142857142854
1998,101374,"Leonardo Lavalle",1,1,2,50
1998,101382,"Marcelo Filippini",5,16,21,23.80952380952381
1998,101404,"Thomas Muster",32,20,52,61.53846153846154
1998,101414,"Boris Becker",15,11,26,57.69230769230769
1998,101434,"Petr Korda",34,21,55,61.81818181818182
1998,101439,"Javier Sanchez",8,26,34,23.529411764705884
1998,101441,"Martin Sinner",8,14,22,36.36363636363637
1998,101459,"Tomas Nydahl",7,18,25,28
1998,101462,"Francisco Roig",3,3,6,50
1998,101463,"Bernd Karbacher",5,8,13,38.46153846153846
1998,101468,"Gerard Solves",3,2,5,60
1998,101475,"Carlos Costa",21,24,45,46.666666666666664
1998,101507,"Tomas Carbonell",5,5,10,50
1998,101532,"Francisco Clavet",43,26,69,62.31884057971015
1998,101543,"Jeff Tarango",24,29,53,45.283018867924525
1998,101549,"Rodolphe Gilbert",1,1,2,50
1998,101582,"Gilbert Schaller",1,4,5,20
1998,101589,"Arnaud Boetsch",2,7,9,22.22222222222222
1998,101601,"Brett Steven",17,20,37,45.945945945945944
1998,101609,"David Wheaton",6,10,16,37.5
1998,101611,"Cedric Pioline",39,28,67,58.208955223880594
1998,101613,"Malivai Washington",10,11,21,47.61904761904762
1998,101647,"Byron Black",37,25,62,59.67741935483871
1998,101659,"Jan Apell",1,3,4,25
1998,101675,"Martin Rodriguez",2,6,8,25
1998,101681,"Chris Wilkinson",3,6,9,33.333333333333336
1998,101687,"David Dilucia",3,3,6,50
1998,101688,"Geoff Grant",5,5,10,50
1998,101703,"Guillaume Raoux",24,27,51,47.05882352941177
1998,101711,"Alex Obrien",8,15,23,34.78260869565217
1998,101717,"Diego Nargiso",4,6,10,40
1998,101723,"Magnus Larsson",19,16,35,54.285714285714285
1998,101727,"Jason Stoltenberg",32,23,55,58.18181818181818
1998,101733,"Jan Siemerink",38,24,62,61.29032258064516
1998,101735,"Richard Fromberg",26,31,57,45.6140350877193
1998,101736,"Andre Agassi",66,17,83,79.51807228915662
1998,101746,"Renzo Furlan",2,8,10,20
1998,101750,"Cristiano Caratti",3,3,6,50
1998,101761,"Jaime Oncins",1,2,3,33.333333333333336
1998,101774,"Todd Martin",43,20,63,68.25396825396825
1998,101776,"Sandon Stolle",6,12,18,33.333333333333336
1998,101788,"Doug Flach",3,3,6,50
1998,101792,"Slava Dosedel",24,22,46,52.17391304347826
1998,101793,"Jim Courier",19,20,39,48.717948717948715
1998,101805,"David Nainkin",7,9,16,43.75
1998,101806,"Marc Kevin Goellner",11,25,36,30.555555555555557
1998,101816,"Steve Campbell",15,25,40,37.5
1998,101820,"Marc Rosset",27,27,54,50
1998,101821,"Peter Tramacchi",1,5,6,16.666666666666668
1998,101823,"Gerald Mandl",1,2,3,33.333333333333336
1998,101826,"Alex Lopez Moron",2,4,6,33.333333333333336
1998,101833,"Michael Tebbutt",12,15,27,44.44444444444444
1998,101843,"Sergi Bruguera",12,27,39,30.76923076923077
1998,101860,"Mark Draper",1,2,3,33.333333333333336
1998,101862,"Maurice Ruah",2,1,3,66.66666666666667
1998,101885,"Wayne Arthurs",4,3,7,57.142857142857146
1998,101888,"Daniel Vacek",25,29,54,46.2962962962963
1998,101889,"Todd Woodbridge",21,23,44,47.72727272727273
1998,101890,"Jonathan Stark",4,11,15,26.666666666666668
1998,101897,"Fernando Meligeni",18,20,38,47.36842105263158
1998,101900,"Nicklas Kulti",3,3,6,50
1998,101902,"Stephane Huet",4,3,7,57.142857142857146
1998,101917,"Grant Stafford",12,21,33,36.36363636363637
1998,101924,"Stefano Pescosolido",3,6,9,33.333333333333336
1998,101926,"Andrei Merinov",1,1,2,50
1998,101947,"Vincenzo Santopadre",8,8,16,50
1998,101948,"Pete Sampras",61,18,79,77.21518987341773
1998,101956,"Mark Knowles",2,3,5,40
1998,101962,"Younes El Aynaoui",5,2,7,71.42857142857143
1998,101964,"Goran Ivanisevic",44,28,72,61.111111111111114
1998,101965,"Wayne Ferreira",33,24,57,57.89473684210526
1998,101982,"Jordi Mas",1,1,2,50
1998,101990,"Richard Krajicek",45,16,61,73.77049180327869
1998,101991,"Mauricio Hadad",2,2,4,50
1998,101997,"Marzio Martelli",4,11,15,26.666666666666668
1998,102002,"Davide Scala",2,4,6,33.333333333333336
1998,102021,"Michael Chang",35,18,53,66.0377358490566
1998,102024,"Hernan Gumy",6,10,16,37.5
1998,102025,"Mikael Tillstrom",20,21,41,48.78048780487805
1998,102028,"Massimo Valeri",1,1,2,50
1998,102029,"Filip Dewulf",22,21,43,51.16279069767442
1998,102035,"Jonas Bjorkman",35,26,61,57.377049180327866
1998,102053,"Brian Macphie",10,10,20,50
1998,102103,"Michael Sell",2,8,10,20
1998,102104,"Christian Ruud",2,13,15,13.333333333333334
1998,102106,"Davide Sanguinetti",29,27,56,51.785714285714285
1998,102110,"Daniel Nestor",11,17,28,39.285714285714285
1998,102118,"Radomir Vasek",5,11,16,31.25
1998,102131,"Alistair Hunt",1,1,2,50
1998,102133,"Laurence Tieleman",10,7,17,58.8235294117647
1998,102135,"Emilio Benfele Alvarez",7,12,19,36.8421052631579
1998,102139,"Eyal Ran",1,3,4,25
1998,102146,"Jordi Burillo",11,21,32,34.375
1998,102148,"Fabrice Santoro",29,28,57,50.87719298245614
1998,102154,"Marcos Ondruska",2,10,12,16.666666666666668
1998,102158,"Patrick Rafter",58,20,78,74.35897435897436
1998,102167,"Juan Albert Viloca Puig",8,21,29,27.586206896551722
1998,102169,"Michael Joyce",2,2,4,50
1998,102180,"Charles Auffray",1,3,4,25
1998,102184,"David Prinosil",20,25,45,44.44444444444444
1998,102192,"Luis Adrian Morejon",2,3,5,40
1998,102201,"Lionel Roux",5,13,18,27.77777777777778
1998,102202,"Kenneth Carlsen",22,23,45,48.888888888888886
1998,102205,"Sebastien Lareau",19,19,38,50
1998,102223,"Karim Alami",19,21,40,47.5
1998,102227,"Sargis Sargsian",18,25,43,41.86046511627907
1998,102231,"Alex Calatrava",11,18,29,37.93103448275862
1998,102233,"Leander Paes",13,10,23,56.52173913043478
1998,102234,"Oliver Gross",8,14,22,36.36363636363637
1998,102238,"Alberto Berasategui",32,24,56,57.142857142857146
1998,102247,"Andrea Gaudenzi",30,24,54,55.55555555555556
1998,102251,"Mariano Hood",1,3,4,25
1998,102257,"Greg Rusedski",50,22,72,69.44444444444444
1998,102259,"Jerome Golmard",23,22,45,51.111111111111114
1998,102271,"Hicham Arazi",23,28,51,45.09803921568628
1998,102286,"Wayne Black",17,24,41,41.46341463414634
1998,102287,"Albert Portas",13,24,37,35.13513513513514
1998,102300,"Gouichi Motomura",2,2,4,50
1998,102306,"Michael Kohlmann",4,6,10,40
1998,102318,"Andrei Pavel",22,21,43,51.16279069767442
1998,102336,"Kotaro Miyachi",1,1,2,50
1998,102338,"Yevgeny Kafelnikov",55,29,84,65.47619047619048
1998,102344,"Karol Kucera",51,27,78,65.38461538461539
1998,102358,"Thomas Enqvist",35,15,50,70
1998,102359,"Andrew Richardson",1,5,6,16.666666666666668
1998,102369,"Julien Boutter",1,2,3,33.333333333333336
1998,102374,"Alex Corretja",53,20,73,72.6027397260274
1998,102375,"Dinu Pescariu",5,15,20,25
1998,102394,"Johan Van Herck",9,20,29,31.03448275862069
1998,102397,"Jose Imaz Ruiz",2,4,6,33.333333333333336
1998,102401,"Scott Draper",23,17,40,57.5
1998,102410,"David Caldwell",2,1,3,66.66666666666667
1998,102419,"Christophe Van Garsse",6,5,11,54.54545454545455
1998,102434,"Vincent Spadea",28,27,55,50.90909090909091
1998,102436,"Borut Urh",1,1,2,50
1998,102437,"Adrian Voinea",11,9,20,55
1998,102446,"Andrei Medvedev",22,22,44,50
1998,102450,"Tim Henman",55,29,84,65.47619047619048
1998,102456,"Felix Mantilla",43,26,69,62.31884057971015
1998,102463,"Lucas Arnold Ker",10,16,26,38.46153846153846
1998,102464,"Todd Larkham",1,2,3,33.333333333333336
1998,102466,"Jan Kroslak",9,11,20,45
1998,102472,"Marcello Craca",3,12,15,20
1998,102473,"Thomas Schiessling",3,2,5,60
1998,102477,"Gaston Etlis",2,1,3,66.66666666666667
1998,102506,"Quino Munoz",2,2,4,50
1998,102519,"Marcio Carlsson",3,4,7,42.857142857142854
1998,102521,"Hendrik Dreekmann",16,16,32,50
1998,102524,"Neville Godwin",7,7,14,50
1998,102533,"Jens Knippschild",8,15,23,34.78260869565217
1998,102538,"Tuomas Ketola",2,9,11,18.181818181818183
1998,102539,"Bohdan Ulihrach",31,28,59,52.54237288135593
1998,102548,"Juan Antonio Marin",20,27,47,42.5531914893617
1998,102562,"Jiri Novak",20,21,41,48.78048780487805
1998,102563,"Thomas Johansson",46,30,76,60.526315789473685
1998,102567,"George Bastl",1,3,4,25
1998,102585,"Sebastian Prieto",1,1,2,50
1998,102588,"Lars Rehmann",1,2,3,33.333333333333336
1998,102607,"Juan Balcells",2,1,3,66.66666666666667
1998,102610,"Albert Costa",47,26,73,64.38356164383562
1998,102615,"Dennis Van Scheppingen",11,16,27,40.74074074074074
1998,102623,"Thomas Larsen",1,1,2,50
1998,102629,"Oscar Burrieza",2,10,12,16.666666666666668
1998,102644,"Franco Squillari",17,19,36,47.22222222222222
1998,102650,"Roberto Carretero",1,1,2,50
1998,102652,"Christian Vinck",5,15,20,25
1998,102667,"Satoshi Iwabuchi",1,1,2,50
1998,102694,"Lars Burgsmuller",7,12,19,36.8421052631579
1998,102701,"Marcelo Rios",66,18,84,78.57142857142857
1998,102722,"Attila Savolt",2,2,4,50
1998,102723,"Eduardo Medica",1,1,2,50
1998,102730,"Ivo Heuberger",6,12,18,33.333333333333336
1998,102743,"Ben Ellwood",1,3,4,25
1998,102753,"Wolfgang Schranz",1,4,5,20
1998,102765,"Nicolas Escude",22,22,44,50
1998,102770,"John Van Lottum",15,21,36,41.666666666666664
1998,102776,"Andrew Ilie",14,14,28,50
1998,102783,"Rainer Schuettler",12,15,27,44.44444444444444
1998,102785,"Glenn Weiner",1,2,3,33.333333333333336
1998,102791,"Bobby Kokavec",1,1,2,50
1998,102796,"Magnus Norman",26,29,55,47.27272727272727
1998,102811,"Dusan Vemic",1,2,3,33.333333333333336
1998,102831,"Jacobo Diaz",7,9,16,43.75
1998,102834,"Paul Goldstein",1,3,4,25
1998,102836,"Rogier Wassen",1,1,2,50
1998,102839,"Nicolas Lapentti",16,29,45,35.55555555555556
1998,102845,"Carlos Moya",46,25,71,64.78873239436619
1998,102851,"Giorgio Galimberti",1,2,3,33.333333333333336
1998,102854,"Sjeng Schalken",22,30,52,42.30769230769231
1998,102856,"Gustavo Kuerten",39,24,63,61.904761904761905
1998,102862,"Allen Belobrajdic",1,3,4,25
1998,102863,"Takao Suzuki",2,2,4,50
1998,102869,"Galo Blanco",20,25,45,44.44444444444444
1998,102882,"Mark Philippoussis",33,20,53,62.264150943396224
1998,102887,"Ramon Delgado",22,22,44,50
1998,102905,"Stefan Koubek",2,4,6,33.333333333333336
1998,102925,"Justin Gimelstob",14,15,29,48.275862068965516
1998,102939,"Jean Baptiste Perlant",2,4,6,33.333333333333336
1998,102944,"Stefano Cobolli",1,1,2,50
1998,102950,"Fernando Vicente",20,20,40,50
1998,102987,"Andre Sa",1,5,6,16.666666666666668
1998,102998,"Jan Michael Gambill",31,23,54,57.407407407407405
1998,103003,"Jean Francois Bachelot",1,2,3,33.333333333333336
1998,103017,"Nicolas Kiefer",33,27,60,55
1998,103018,"Max Mirnyi",1,2,3,33.333333333333336
1998,103031,"Julian Alonso",16,31,47,34.04255319148936
1998,103060,"Alejandro Hernandez",2,5,7,28.571428571428573
1998,103066,"Mark Nielsen",1,1,2,50
1998,103084,"Guillermo Canas",6,14,20,30
1998,103096,"Arnaud Clement",13,25,38,34.21052631578947
1998,103103,"Dominik Hrbaty",31,28,59,52.54237288135593
1998,103110,"Daniele Bracciali",2,1,3,66.66666666666667
1998,103118,"Ion Moldovan",1,3,4,25
1998,103151,"Mariano Zabaleta",14,8,22,63.63636363636363
1998,103163,"Tommy Haas",38,26,64,59.375
1998,103166,"Vladimir Voltchkov",3,3,6,50
1998,103171,"Raemon Sluiter",1,4,5,20
1998,103182,"Markus Hipfl",3,3,6,50
1998,103184,"Bob Bryan",2,4,6,33.333333333333336
1998,103193,"Peter Wessels",1,2,3,33.333333333333336
1998,103202,"Oscar Serrano",3,5,8,37.5
1998,103206,"Sebastien Grosjean",16,19,35,45.714285714285715
1998,103248,"Harel Levy",3,2,5,60
1998,103252,"Alberto Martin",1,7,8,12.5
1998,103264,"Mariano Puerta",21,12,33,63.63636363636363
1998,103280,"Martin Verkerk",1,1,2,50
1998,103324,"Arnaud Di Pasquale",11,10,21,52.38095238095238
1998,103420,"Michal Tabara",1,1,2,50
1998,103498,"Marat Safin",16,16,32,50
1998,103598,"Xavier Malisse",8,6,14,57.142857142857146
1998,103720,"Lleyton Hewitt",10,9,19,52.63157894736842
1998,103758,"Taylor Dent",1,3,4,25
1998,103819,"Roger Federer",2,3,5,40
1998,210013,"Martin Damm Sr",20,27,47,42.5531914893617
1999,101086,"Ronald Agenor",3,7,10,30
1999,101150,"Gianluca Pozzi",16,26,42,38.095238095238095
1999,101185,"Mark Woodforde",10,19,29,34.48275862068966
1999,101191,"Richey Reneberg",7,10,17,41.1764705882353
1999,101235,"Paul Haarhuis",6,15,21,28.571428571428573
1999,101320,"Magnus Gustafsson",22,18,40,55
1999,101373,"Karsten Braasch",1,2,3,33.333333333333336
1999,101382,"Marcelo Filippini",6,12,18,33.333333333333336
1999,101404,"Thomas Muster",5,11,16,31.25
1999,101414,"Boris Becker",10,7,17,58.8235294117647
1999,101434,"Petr Korda",6,12,18,33.333333333333336
1999,101439,"Javier Sanchez",1,3,4,25
1999,101463,"Bernd Karbacher",13,17,30,43.333333333333336
1999,101475,"Carlos Costa",1,10,11,9.090909090909092
1999,101515,"Donald Johnson",1,2,3,33.333333333333336
1999,101532,"Francisco Clavet",30,27,57,52.63157894736842
1999,101543,"Jeff Tarango",21,24,45,46.666666666666664
1999,101549,"Rodolphe Gilbert",1,4,5,20
1999,101589,"Arnaud Boetsch",1,2,3,33.333333333333336
1999,101591,"Danny Sapsford",2,1,3,66.66666666666667
1999,101601,"Brett Steven",4,6,10,40
1999,101611,"Cedric Pioline",37,30,67,55.223880597014926
1999,101647,"Byron Black",24,23,47,51.06382978723404
1999,101675,"Martin Rodriguez",8,20,28,28.571428571428573
1999,101681,"Chris Wilkinson",1,3,4,25
1999,101688,"Geoff Grant",1,6,7,14.285714285714286
1999,101703,"Guillaume Raoux",10,20,30,33.333333333333336
1999,101711,"Alex Obrien",3,6,9,33.333333333333336
1999,101717,"Diego Nargiso",1,5,6,16.666666666666668
1999,101723,"Magnus Larsson",16,18,34,47.05882352941177
1999,101727,"Jason Stoltenberg",18,18,36,50
1999,101731,"Nuno Marques",1,2,3,33.333333333333336
1999,101733,"Jan Siemerink",17,25,42,40.476190476190474
1999,101735,"Richard Fromberg",15,16,31,48.38709677419355
1999,101736,"Andre Agassi",63,14,77,81.81818181818181
1999,101746,"Renzo Furlan",3,5,8,37.5
1999,101750,"Cristiano Caratti",1,3,4,25
1999,101772,"Andrei Cherkasov",3,6,9,33.333333333333336
1999,101774,"Todd Martin",42,17,59,71.1864406779661
1999,101775,"Frederik Fetterlein",1,1,2,50
1999,101776,"Sandon Stolle",3,4,7,42.857142857142854
1999,101792,"Slava Dosedel",15,12,27,55.55555555555556
1999,101793,"Jim Courier",29,20,49,59.183673469387756
1999,101806,"Marc Kevin Goellner",3,4,7,42.857142857142854
1999,101820,"Marc Rosset",26,27,53,49.056603773584904
1999,101821,"Peter Tramacchi",1,1,2,50
1999,101826,"Alex Lopez Moron",2,3,5,40
1999,101833,"Michael Tebbutt",2,3,5,40
1999,101885,"Wayne Arthurs",12,11,23,52.17391304347826
1999,101888,"Daniel Vacek",29,31,60,48.333333333333336
1999,101889,"Todd Woodbridge",8,16,24,33.333333333333336
1999,101890,"Jonathan Stark",3,4,7,42.857142857142854
1999,101897,"Fernando Meligeni",27,26,53,50.943396226415096
1999,101900,"Nicklas Kulti",10,9,19,52.63157894736842
1999,101902,"Stephane Huet",3,8,11,27.272727272727273
1999,101924,"Stefano Pescosolido",2,2,4,50
1999,101932,"Jared Palmer",1,1,2,50
1999,101947,"Vincenzo Santopadre",7,14,21,33.333333333333336
1999,101948,"Pete Sampras",40,10,50,80
1999,101962,"Younes El Aynaoui",27,23,50,54
1999,101964,"Goran Ivanisevic",22,26,48,45.833333333333336
1999,101965,"Wayne Ferreira",27,25,52,51.92307692307692
1999,101969,"Orlin Stanoytchev",5,9,14,35.714285714285715
1999,101990,"Richard Krajicek",42,20,62,67.74193548387096
1999,102021,"Michael Chang",27,22,49,55.10204081632653
1999,102023,"Petr Luxa",1,5,6,16.666666666666668
1999,102024,"Hernan Gumy",14,16,30,46.666666666666664
1999,102025,"Mikael Tillstrom",15,18,33,45.45454545454545
1999,102029,"Filip Dewulf",1,3,4,25
1999,102035,"Jonas Bjorkman",24,23,47,51.06382978723404
1999,102050,"Marco Meneschincheri",1,2,3,33.333333333333336
1999,102061,"Kevin Ullyett",6,4,10,60
1999,102086,"Igor Kornienko",2,3,5,40
1999,102103,"Michael Sell",2,3,5,40
1999,102104,"Christian Ruud",22,17,39,56.41025641025641
1999,102106,"Davide Sanguinetti",8,23,31,25.806451612903224
1999,102110,"Daniel Nestor",18,16,34,52.94117647058823
1999,102117,"Eduardo Nicolas",3,3,6,50
1999,102133,"Laurence Tieleman",14,21,35,40
1999,102145,"Francisco Cabello",1,2,3,33.333333333333336
1999,102148,"Fabrice Santoro",36,25,61,59.01639344262295
1999,102153,"German Puentes",6,7,13,46.15384615384615
1999,102158,"Patrick Rafter",34,17,51,66.66666666666667
1999,102162,"Chris Woodruff",22,19,41,53.65853658536585
1999,102167,"Juan Albert Viloca Puig",1,3,4,25
1999,102179,"Antony Dupuis",9,10,19,47.36842105263158
1999,102184,"David Prinosil",22,23,45,48.888888888888886
1999,102201,"Lionel Roux",2,4,6,33.333333333333336
1999,102202,"Kenneth Carlsen",19,19,38,50
1999,102205,"Sebastien Lareau",12,18,30,40
1999,102223,"Karim Alami",26,22,48,54.166666666666664
1999,102227,"Sargis Sargsian",21,23,44,47.72727272727273
1999,102231,"Alex Calatrava",2,10,12,16.666666666666668
1999,102233,"Leander Paes",3,9,12,25
1999,102234,"Oliver Gross",6,14,20,30
1999,102238,"Alberto Berasategui",20,20,40,50
1999,102247,"Andrea Gaudenzi",13,14,27,48.148148148148145
1999,102251,"Mariano Hood",1,1,2,50
1999,102257,"Greg Rusedski",47,24,71,66.19718309859155
1999,102259,"Jerome Golmard",21,12,33,63.63636363636363
1999,102271,"Hicham Arazi",27,27,54,50
1999,102286,"Wayne Black",9,15,24,37.5
1999,102287,"Albert Portas",14,18,32,43.75
1999,102300,"Gouichi Motomura",2,3,5,40
1999,102306,"Michael Kohlmann",5,13,18,27.77777777777778
1999,102318,"Andrei Pavel",28,24,52,53.84615384615385
1999,102338,"Yevgeny Kafelnikov",59,29,88,67.04545454545455
1999,102344,"Karol Kucera",40,21,61,65.57377049180327
1999,102348,"Hideki Kaneko",1,1,2,50
1999,102358,"Thomas Enqvist",48,26,74,64.86486486486487
1999,102369,"Julien Boutter",1,5,6,16.666666666666668
1999,102374,"Alex Corretja",36,22,58,62.06896551724138
1999,102375,"Dinu Pescariu",3,10,13,23.076923076923077
1999,102394,"Johan Van Herck",3,4,7,42.857142857142854
1999,102395,"Ville Liukko",2,5,7,28.571428571428573
1999,102401,"Scott Draper",11,17,28,39.285714285714285
1999,102419,"Christophe Van Garsse",1,1,2,50
1999,102422,"Michael Hill",1,3,4,25
1999,102433,"Mose Navarra",1,6,7,14.285714285714286
1999,102434,"Vincent Spadea",33,27,60,55
1999,102436,"Borut Urh",1,1,2,50
1999,102437,"Adrian Voinea",14,21,35,40
1999,102446,"Andrei Medvedev",22,23,45,48.888888888888886
1999,102450,"Tim Henman",41,28,69,59.42028985507246
1999,102455,"Lorenzo Manta",6,6,12,50
1999,102456,"Felix Mantilla",33,21,54,61.111111111111114
1999,102463,"Lucas Arnold Ker",1,5,6,16.666666666666668
1999,102466,"Jan Kroslak",13,26,39,33.333333333333336
1999,102469,"Solon Peppas",1,1,2,50
1999,102494,"Tomas Behrend",1,1,2,50
1999,102497,"Mashiska Washington",1,2,3,33.333333333333336
1999,102519,"Marcio Carlsson",1,3,4,25
1999,102521,"Hendrik Dreekmann",11,15,26,42.30769230769231
1999,102524,"Neville Godwin",1,2,3,33.333333333333336
1999,102533,"Jens Knippschild",15,15,30,50
1999,102538,"Tuomas Ketola",1,6,7,14.285714285714286
1999,102539,"Bohdan Ulihrach",12,22,34,35.294117647058826
1999,102548,"Juan Antonio Marin",19,21,40,47.5
1999,102558,"Eric Taino",1,2,3,33.333333333333336
1999,102562,"Jiri Novak",28,26,54,51.851851851851855
1999,102563,"Thomas Johansson",21,25,46,45.65217391304348
1999,102567,"George Bastl",6,7,13,46.15384615384615
1999,102574,"Gabriel Trifu",2,1,3,66.66666666666667
1999,102607,"Juan Balcells",1,2,3,33.333333333333336
1999,102610,"Albert Costa",40,22,62,64.51612903225806
1999,102615,"Dennis Van Scheppingen",1,4,5,20
1999,102629,"Oscar Burrieza",1,1,2,50
1999,102642,"Cyril Saulnier",1,3,4,25
1999,102644,"Franco Squillari",18,24,42,42.857142857142854
1999,102650,"Roberto Carretero",1,2,3,33.333333333333336
1999,102652,"Christian Vinck",2,4,6,33.333333333333336
1999,102687,"Herbert Wiltschnig",1,1,2,50
1999,102689,"Martin Spottl",2,1,3,66.66666666666667
1999,102694,"Lars Burgsmuller",7,8,15,46.666666666666664
1999,102701,"Marcelo Rios",45,16,61,73.77049180327869
1999,102703,"Hyung Taik Lee",1,2,3,33.333333333333336
1999,102720,"Tomas Zib",4,4,8,50
1999,102723,"Eduardo Medica",1,3,4,25
1999,102730,"Ivo Heuberger",1,2,3,33.333333333333336
1999,102753,"Wolfgang Schranz",2,1,3,66.66666666666667
1999,102765,"Nicolas Escude",20,17,37,54.054054054054056
1999,102770,"John Van Lottum",21,22,43,48.83720930232558
1999,102776,"Andrew Ilie",28,29,57,49.12280701754386
1999,102783,"Rainer Schuettler",23,28,51,45.09803921568628
1999,102796,"Magnus Norman",43,21,64,67.1875
1999,102800,"Nenad Zimonjic",2,3,5,40
1999,102809,"Axel Pretzsch",5,9,14,35.714285714285715
1999,102817,"Edwin Kempes",1,2,3,33.333333333333336
1999,102821,"Cecil Mamiit",16,18,34,47.05882352941177
1999,102831,"Jacobo Diaz",2,7,9,22.22222222222222
1999,102834,"Paul Goldstein",12,15,27,44.44444444444444
1999,102835,"Luke Milligan",1,2,3,33.333333333333336
1999,102839,"Nicolas Lapentti",52,24,76,68.42105263157895
1999,102845,"Carlos Moya",37,23,60,61.666666666666664
1999,102854,"Sjeng Schalken",28,26,54,51.851851851851855
1999,102856,"Gustavo Kuerten",47,24,71,66.19718309859155
1999,102860,"Agustin Calleri",3,3,6,50
1999,102863,"Takao Suzuki",1,9,10,10
1999,102869,"Galo Blanco",14,19,33,42.42424242424242
1999,102872,"James Sekulov",3,1,4,75
1999,102880,"Alexander Popp",1,1,2,50
1999,102882,"Mark Philippoussis",33,16,49,67.34693877551021
1999,102887,"Ramon Delgado",11,21,32,34.375
1999,102905,"Stefan Koubek",29,25,54,53.7037037037037
1999,102910,"Salvador Navarro",1,1,2,50
1999,102911,"Andrei Stoliarov",1,1,2,50
1999,102925,"Justin Gimelstob",17,26,43,39.53488372093023
1999,102950,"Fernando Vicente",25,29,54,46.2962962962963
1999,102965,"Jamie Delgado",1,2,3,33.333333333333336
1999,102966,"Fredrik Jonsson",3,7,10,30
1999,102987,"Andre Sa",1,4,5,20
1999,102998,"Jan Michael Gambill",25,25,50,50
1999,103017,"Nicolas Kiefer",54,23,77,70.12987012987013
1999,103018,"Max Mirnyi",14,13,27,51.851851851851855
1999,103031,"Julian Alonso",9,11,20,45
1999,103082,"Markus Hantschk",2,4,6,33.333333333333336
1999,103084,"Guillermo Canas",15,23,38,39.473684210526315
1999,103096,"Arnaud Clement",22,25,47,46.808510638297875
1999,103103,"Dominik Hrbaty",38,29,67,56.71641791044776
1999,103114,"Martin Lee",1,2,3,33.333333333333336
1999,103151,"Mariano Zabaleta",28,29,57,49.12280701754386
1999,103157,"Arvind Parmar",1,2,3,33.333333333333336
1999,103163,"Tommy Haas",46,25,71,64.78873239436619
1999,103182,"Markus Hipfl",15,15,30,50
1999,103184,"Bob Bryan",2,5,7,28.571428571428573
1999,103193,"Peter Wessels",12,15,27,44.44444444444444
1999,103206,"Sebastien Grosjean",35,25,60,58.333333333333336
1999,103248,"Harel Levy",1,1,2,50
1999,103250,"Rodolphe Cadart",1,1,2,50
1999,103252,"Alberto Martin",27,21,48,56.25
1999,103264,"Mariano Puerta",14,26,40,35
1999,103285,"Radek Stepanek",2,4,6,33.333333333333336
1999,103292,"Gaston Gaudio",8,15,23,34.78260869565217
1999,103294,"Christophe Rochus",1,2,3,33.333333333333336
1999,103324,"Arnaud Di Pasquale",24,26,50,48
1999,103344,"Ivan Ljubicic",11,12,23,47.82608695652174
1999,103387,"Paradorn Srichaphan",10,7,17,58.8235294117647
1999,103420,"Michal Tabara",3,1,4,75
1999,103444,"Jean Rene Lisnard",1,2,3,33.333333333333336
1999,103451,"Bjorn Phau",3,2,5,60
1999,103484,"James Blake",1,4,5,20
1999,103498,"Marat Safin",36,29,65,55.38461538461539
1999,103507,"Juan Carlos Ferrero",16,8,24,66.66666666666667
1999,103598,"Xavier Malisse",8,9,17,47.05882352941177
1999,103602,"Fernando Gonzalez",1,1,2,50
1999,103709,"Kristian Pless",1,2,3,33.333333333333336
1999,103714,"Andreas Vinciguerra",9,6,15,60
1999,103720,"Lleyton Hewitt",40,18,58,68.96551724137932
1999,103781,"Jurgen Melzer",1,1,2,50
1999,103819,"Roger Federer",12,14,26,46.15384615384615
1999,103990,"Tommy Robredo",2,2,4,50
1999,210013,"Martin Damm Sr",7,16,23,30.434782608695652
2000,101086,"Ronald Agenor",6,16,22,27.272727272727273
2000,101150,"Gianluca Pozzi",27,23,50,54
2000,101185,"Mark Woodforde",3,7,10,30
2000,101191,"Richey Reneberg",1,1,2,50
2000,101320,"Magnus Gustafsson",17,14,31,54.83870967741935
2000,101373,"Karsten Braasch",2,1,3,66.66666666666667
2000,101532,"Francisco Clavet",28,30,58,48.275862068965516
2000,101543,"Jeff Tarango",11,25,36,30.555555555555557
2000,101609,"David Wheaton",1,3,4,25
2000,101611,"Cedric Pioline",32,19,51,62.745098039215684
2000,101647,"Byron Black",27,24,51,52.94117647058823
2000,101675,"Martin Rodriguez",5,7,12,41.666666666666664
2000,101711,"Alex Obrien",3,5,8,37.5
2000,101717,"Diego Nargiso",8,4,12,66.66666666666667
2000,101723,"Magnus Larsson",13,6,19,68.42105263157895
2000,101727,"Jason Stoltenberg",21,14,35,60
2000,101733,"Jan Siemerink",7,14,21,33.333333333333336
2000,101735,"Richard Fromberg",18,21,39,46.15384615384615
2000,101736,"Andre Agassi",36,15,51,70.58823529411765
2000,101746,"Renzo Furlan",3,4,7,42.857142857142854
2000,101750,"Cristiano Caratti",1,4,5,20
2000,101772,"Andrei Cherkasov",1,3,4,25
2000,101774,"Todd Martin",14,12,26,53.84615384615385
2000,101792,"Slava Dosedel",17,21,38,44.73684210526316
2000,101793,"Jim Courier",4,5,9,44.44444444444444
2000,101806,"Marc Kevin Goellner",5,8,13,38.46153846153846
2000,101820,"Marc Rosset",31,25,56,55.357142857142854
2000,101826,"Alex Lopez Moron",1,9,10,10
2000,101843,"Sergi Bruguera",17,15,32,53.125
2000,101885,"Wayne Arthurs",13,18,31,41.935483870967744
2000,101888,"Daniel Vacek",4,13,17,23.529411764705884
2000,101889,"Todd Woodbridge",4,6,10,40
2000,101897,"Fernando Meligeni",14,21,35,40
2000,101902,"Stephane Huet",5,16,21,23.80952380952381
2000,101917,"Grant Stafford",1,1,2,50
2000,101932,"Jared Palmer",2,2,4,50
2000,101945,"Thierry Guardiola",2,7,9,22.22222222222222
2000,101948,"Pete Sampras",41,13,54,75.92592592592592
2000,101962,"Younes El Aynaoui",36,26,62,58.064516129032256
2000,101964,"Goran Ivanisevic",11,22,33,33.333333333333336
2000,101965,"Wayne Ferreira",41,22,63,65.07936507936508
2000,101969,"Orlin Stanoytchev",7,20,27,25.925925925925927
2000,101990,"Richard Krajicek",26,15,41,63.41463414634146
2000,101997,"Marzio Martelli",1,1,2,50
2000,102021,"Michael Chang",42,26,68,61.76470588235294
2000,102024,"Hernan Gumy",10,19,29,34.48275862068966
2000,102025,"Mikael Tillstrom",19,18,37,51.351351351351354
2000,102029,"Filip Dewulf",1,3,4,25
2000,102035,"Jonas Bjorkman",30,25,55,54.54545454545455
2000,102053,"Brian Macphie",1,1,2,50
2000,102061,"Kevin Ullyett",3,6,9,33.333333333333336
2000,102103,"Michael Sell",1,1,2,50
2000,102104,"Christian Ruud",8,17,25,32
2000,102106,"Davide Sanguinetti",17,21,38,44.73684210526316
2000,102110,"Daniel Nestor",6,9,15,40
2000,102133,"Laurence Tieleman",10,19,29,34.48275862068966
2000,102135,"Emilio Benfele Alvarez",6,7,13,46.15384615384615
2000,102143,"Nicolas Thomann",2,2,4,50
2000,102148,"Fabrice Santoro",34,27,61,55.73770491803279
2000,102153,"German Puentes",1,2,3,33.333333333333336
2000,102158,"Patrick Rafter",32,18,50,64
2000,102162,"Chris Woodruff",18,23,41,43.90243902439025
2000,102167,"Juan Albert Viloca Puig",2,3,5,40
2000,102179,"Antony Dupuis",4,13,17,23.529411764705884
2000,102184,"David Prinosil",22,18,40,55
2000,102201,"Lionel Roux",4,4,8,50
2000,102205,"Sebastien Lareau",5,11,16,31.25
2000,102223,"Karim Alami",24,29,53,45.283018867924525
2000,102227,"Sargis Sargsian",15,26,41,36.58536585365854
2000,102231,"Alex Calatrava",20,10,30,66.66666666666667
2000,102233,"Leander Paes",3,6,9,33.333333333333336
2000,102238,"Alberto Berasategui",4,14,18,22.22222222222222
2000,102243,"Marcelo Charpentier",1,3,4,25
2000,102247,"Andrea Gaudenzi",8,16,24,33.333333333333336
2000,102251,"Mariano Hood",2,2,4,50
2000,102257,"Greg Rusedski",19,20,39,48.717948717948715
2000,102259,"Jerome Golmard",30,24,54,55.55555555555556
2000,102263,"Yong Il Yoon",2,1,3,66.66666666666667
2000,102269,"Jeff Salzenstein",1,3,4,25
2000,102271,"Hicham Arazi",31,26,57,54.3859649122807
2000,102286,"Wayne Black",8,9,17,47.05882352941177
2000,102287,"Albert Portas",22,23,45,48.888888888888886
2000,102300,"Gouichi Motomura",1,4,5,20
2000,102306,"Michael Kohlmann",2,3,5,40
2000,102318,"Andrei Pavel",33,27,60,55
2000,102338,"Yevgeny Kafelnikov",66,33,99,66.66666666666667
2000,102344,"Karol Kucera",27,22,49,55.10204081632653
2000,102358,"Thomas Enqvist",51,24,75,68
2000,102369,"Julien Boutter",10,16,26,38.46153846153846
2000,102374,"Alex Corretja",52,19,71,73.2394366197183
2000,102375,"Dinu Pescariu",1,1,2,50
2000,102381,"Werner Eschauer",1,2,3,33.333333333333336
2000,102395,"Ville Liukko",2,2,4,50
2000,102401,"Scott Draper",2,5,7,28.571428571428573
2000,102422,"Michael Hill",1,2,3,33.333333333333336
2000,102434,"Vincent Spadea",3,27,30,10
2000,102437,"Adrian Voinea",9,20,29,31.03448275862069
2000,102443,"Barry Cowan",3,8,11,27.272727272727273
2000,102446,"Andrei Medvedev",20,17,37,54.054054054054056
2000,102450,"Tim Henman",55,24,79,69.62025316455696
2000,102455,"Lorenzo Manta",4,11,15,26.666666666666668
2000,102456,"Felix Mantilla",16,16,32,50
2000,102466,"Jan Kroslak",5,10,15,33.333333333333336
2000,102477,"Gaston Etlis",2,9,11,18.181818181818183
2000,102494,"Tomas Behrend",7,11,18,38.888888888888886
2000,102524,"Neville Godwin",3,4,7,42.857142857142854
2000,102533,"Jens Knippschild",7,13,20,35
2000,102538,"Tuomas Ketola",3,5,8,37.5
2000,102539,"Bohdan Ulihrach",15,17,32,46.875
2000,102548,"Juan Antonio Marin",9,21,30,30
2000,102558,"Eric Taino",4,4,8,50
2000,102562,"Jiri Novak",24,26,50,48
2000,102563,"Thomas Johansson",22,26,48,45.833333333333336
2000,102567,"George Bastl",15,22,37,40.54054054054054
2000,102585,"Sebastian Prieto",1,2,3,33.333333333333336
2000,102607,"Juan Balcells",11,7,18,61.111111111111114
2000,102610,"Albert Costa",29,24,53,54.716981132075475
2000,102615,"Dennis Van Scheppingen",1,2,3,33.333333333333336
2000,102629,"Oscar Burrieza",1,3,4,25
2000,102642,"Cyril Saulnier",4,14,18,22.22222222222222
2000,102644,"Franco Squillari",33,24,57,57.89473684210526
2000,102650,"Roberto Carretero",2,1,3,66.66666666666667
2000,102652,"Christian Vinck",7,11,18,38.888888888888886
2000,102687,"Herbert Wiltschnig",1,2,3,33.333333333333336
2000,102694,"Lars Burgsmuller",2,5,7,28.571428571428573
2000,102701,"Marcelo Rios",28,23,51,54.90196078431372
2000,102703,"Hyung Taik Lee",7,5,12,58.333333333333336
2000,102720,"Tomas Zib",5,13,18,27.77777777777778
2000,102722,"Attila Savolt",3,6,9,33.333333333333336
2000,102730,"Ivo Heuberger",1,4,5,20
2000,102738,"Stefano Tarallo",1,1,2,50
2000,102753,"Wolfgang Schranz",1,1,2,50
2000,102765,"Nicolas Escude",26,23,49,53.06122448979592
2000,102768,"Federico Browne",4,5,9,44.44444444444444
2000,102770,"John Van Lottum",2,11,13,15.384615384615385
2000,102776,"Andrew Ilie",21,27,48,43.75
2000,102783,"Rainer Schuettler",22,28,50,44
2000,102796,"Magnus Norman",67,25,92,72.82608695652173
2000,102808,"Kalle Flygt",2,1,3,66.66666666666667
2000,102809,"Axel Pretzsch",2,5,7,28.571428571428573
2000,102817,"Edwin Kempes",3,2,5,60
2000,102821,"Cecil Mamiit",6,12,18,33.333333333333336
2000,102831,"Jacobo Diaz",1,11,12,8.333333333333334
2000,102834,"Paul Goldstein",20,23,43,46.51162790697674
2000,102839,"Nicolas Lapentti",40,28,68,58.8235294117647
2000,102845,"Carlos Moya",32,21,53,60.37735849056604
2000,102854,"Sjeng Schalken",35,26,61,57.377049180327866
2000,102856,"Gustavo Kuerten",62,19,81,76.54320987654322
2000,102860,"Agustin Calleri",11,5,16,68.75
2000,102863,"Takao Suzuki",1,1,2,50
2000,102869,"Galo Blanco",12,20,32,37.5
2000,102872,"James Sekulov",3,9,12,25
2000,102880,"Alexander Popp",9,10,19,47.36842105263158
2000,102882,"Mark Philippoussis",42,22,64,65.625
2000,102887,"Ramon Delgado",3,1,4,75
2000,102904,"Leos Friedl",1,2,3,33.333333333333336
2000,102905,"Stefan Koubek",26,27,53,49.056603773584904
2000,102910,"Salvador Navarro",1,1,2,50
2000,102911,"Andrei Stoliarov",5,9,14,35.714285714285715
2000,102925,"Justin Gimelstob",14,16,30,46.666666666666664
2000,102934,"Nicolas Coutelot",1,2,3,33.333333333333336
2000,102950,"Fernando Vicente",24,32,56,42.857142857142854
2000,102965,"Jamie Delgado",4,7,11,36.36363636363637
2000,102966,"Fredrik Jonsson",4,13,17,23.529411764705884
2000,102968,"Jonathan Erlich",1,1,2,50
2000,102987,"Andre Sa",12,17,29,41.37931034482759
2000,102998,"Jan Michael Gambill",33,26,59,55.932203389830505
2000,103003,"Jean Francois Bachelot",1,1,2,50
2000,103009,"Razvan Sabau",1,2,3,33.333333333333336
2000,103017,"Nicolas Kiefer",30,16,46,65.21739130434783
2000,103018,"Max Mirnyi",30,26,56,53.57142857142857
2000,103031,"Julian Alonso",4,9,13,30.76923076923077
2000,103045,"Reginald Willems",1,1,2,50
2000,103060,"Alejandro Hernandez",1,1,2,50
2000,103082,"Markus Hantschk",19,21,40,47.5
2000,103084,"Guillermo Canas",5,12,17,29.41176470588235
2000,103096,"Arnaud Clement",36,26,62,58.064516129032256
2000,103103,"Dominik Hrbaty",41,29,70,58.57142857142857
2000,103114,"Martin Lee",1,4,5,20
2000,103151,"Mariano Zabaleta",19,27,46,41.30434782608695
2000,103157,"Arvind Parmar",4,6,10,40
2000,103158,"Johan Ortegren",1,1,2,50
2000,103162,"Dejan Petrovic",2,4,6,33.333333333333336
2000,103163,"Tommy Haas",34,22,56,60.714285714285715
2000,103166,"Vladimir Voltchkov",14,8,22,63.63636363636363
2000,103171,"Raemon Sluiter",8,7,15,53.333333333333336
2000,103176,"David Sanchez",4,4,8,50
2000,103181,"Jiri Vanek",12,13,25,48
2000,103182,"Markus Hipfl",8,12,20,40
2000,103184,"Bob Bryan",4,7,11,36.36363636363637
2000,103185,"Mike Bryan",1,2,3,33.333333333333336
2000,103188,"Michael Russell",1,6,7,14.285714285714286
2000,103193,"Peter Wessels",7,5,12,58.333333333333336
2000,103198,"Justin Bower",1,1,2,50
2000,103201,"Adrian Garcia",2,2,4,50
2000,103206,"Sebastien Grosjean",42,27,69,60.869565217391305
2000,103225,"Simon Larose",1,1,2,50
2000,103240,"Kevin Kim",2,5,7,28.571428571428573
2000,103248,"Harel Levy",13,17,30,43.333333333333336
2000,103252,"Alberto Martin",21,29,50,42
2000,103264,"Mariano Puerta",39,21,60,65
2000,103270,"Kristian Capalik",1,1,2,50
2000,103292,"Gaston Gaudio",27,25,52,51.92307692307692
2000,103294,"Christophe Rochus",14,22,36,38.888888888888886
2000,103305,"Daniel Elsner",4,5,9,44.44444444444444
2000,103324,"Arnaud Di Pasquale",17,25,42,40.476190476190474
2000,103344,"Ivan Ljubicic",21,22,43,48.83720930232558
2000,103356,"Michel Kratochvil",7,9,16,43.75
2000,103373,"Sergio Roitman",1,1,2,50
2000,103387,"Paradorn Srichaphan",9,17,26,34.61538461538461
2000,103420,"Michal Tabara",2,6,8,25
2000,103428,"Juan Ignacio Chela",14,16,30,46.666666666666664
2000,103444,"Jean Rene Lisnard",1,6,7,14.285714285714286
2000,103454,"Nicolas Massu",24,25,49,48.97959183673469
2000,103457,"Petr Kralert",1,2,3,33.333333333333336
2000,103487,"Federico Luzzi",2,2,4,50
2000,103498,"Marat Safin",72,25,97,74.22680412371135
2000,103507,"Juan Carlos Ferrero",41,26,67,61.19402985074627
2000,103566,"Michael Llodra",5,7,12,41.666666666666664
2000,103598,"Xavier Malisse",7,7,14,50
2000,103602,"Fernando Gonzalez",8,5,13,61.53846153846154
2000,103694,"Olivier Rochus",8,4,12,66.66666666666667
2000,103709,"Kristian Pless",1,4,5,20
2000,103714,"Andreas Vinciguerra",27,21,48,56.25
2000,103720,"Lleyton Hewitt",55,17,72,76.38888888888889
2000,103751,"Jonas Froberg",1,1,2,50
2000,103758,"Taylor Dent",3,7,10,30
2000,103786,"Nikolay Davydenko",3,1,4,75
2000,103819,"Roger Federer",34,29,63,53.96825396825397
2000,103888,"Mardy Fish",3,4,7,42.857142857142854
2000,103908,"Paul Henri Mathieu",2,3,5,40
2000,103909,"Guillermo Coria",3,4,7,42.857142857142854
2000,104014,"Lee Childs",1,1,2,50
2000,104022,"Mikhail Youzhny",5,8,13,38.46153846153846
2000,104053,"Andy Roddick",4,5,9,44.44444444444444
2000,210013,"Martin Damm Sr",14,17,31,45.16129032258065
2001,101086,"Ronald Agenor",1,3,4,25
2001,101150,"Gianluca Pozzi",7,23,30,23.333333333333332
2001,101320,"Magnus Gustafsson",19,18,37,51.351351351351354
2001,101495,"Miguel Tobon",1,1,2,50
2001,101532,"Francisco Clavet",23,27,50,46
2001,101543,"Jeff Tarango",1,8,9,11.11111111111111
2001,101611,"Cedric Pioline",17,22,39,43.58974358974359
2001,101647,"Byron Black",8,13,21,38.095238095238095
2001,101723,"Magnus Larsson",10,10,20,50
2001,101727,"Jason Stoltenberg",7,7,14,50
2001,101733,"Jan Siemerink",12,17,29,41.37931034482759
2001,101735,"Richard Fromberg",1,8,9,11.11111111111111
2001,101736,"Andre Agassi",46,15,61,75.40983606557377
2001,101746,"Renzo Furlan",1,1,2,50
2001,101750,"Cristiano Caratti",1,3,4,25
2001,101774,"Todd Martin",13,11,24,54.166666666666664
2001,101792,"Slava Dosedel",5,16,21,23.80952380952381
2001,101806,"Marc Kevin Goellner",3,7,10,30
2001,101820,"Marc Rosset",12,23,35,34.285714285714285
2001,101833,"Michael Tebbutt",1,1,2,50
2001,101843,"Sergi Bruguera",15,21,36,41.666666666666664
2001,101885,"Wayne Arthurs",19,23,42,45.23809523809524
2001,101888,"Daniel Vacek",2,7,9,22.22222222222222
2001,101889,"Todd Woodbridge",4,6,10,40
2001,101897,"Fernando Meligeni",17,16,33,51.515151515151516
2001,101902,"Stephane Huet",1,5,6,16.666666666666668
2001,101947,"Vincenzo Santopadre",1,1,2,50
2001,101948,"Pete Sampras",35,16,51,68.62745098039215
2001,101962,"Younes El Aynaoui",31,23,54,57.407407407407405
2001,101964,"Goran Ivanisevic",28,21,49,57.142857142857146
2001,101965,"Wayne Ferreira",16,21,37,43.24324324324324
2001,101991,"Mauricio Hadad",2,1,3,66.66666666666667
2001,101997,"Marzio Martelli",1,2,3,33.333333333333336
2001,102021,"Michael Chang",16,21,37,43.24324324324324
2001,102024,"Hernan Gumy",1,1,2,50
2001,102035,"Jonas Bjorkman",23,24,47,48.93617021276596
2001,102087,"Oleg Ogorodov",1,1,2,50
2001,102104,"Christian Ruud",3,3,6,50
2001,102106,"Davide Sanguinetti",10,27,37,27.027027027027028
2001,102107,"Jan Frode Andersen",1,2,3,33.333333333333336
2001,102110,"Daniel Nestor",3,6,9,33.333333333333336
2001,102135,"Emilio Benfele Alvarez",1,6,7,14.285714285714286
2001,102143,"Nicolas Thomann",2,5,7,28.571428571428573
2001,102148,"Fabrice Santoro",35,26,61,57.377049180327866
2001,102153,"German Puentes",5,14,19,26.31578947368421
2001,102154,"Marcos Ondruska",1,2,3,33.333333333333336
2001,102158,"Patrick Rafter",44,16,60,73.33333333333333
2001,102162,"Chris Woodruff",11,17,28,39.285714285714285
2001,102167,"Juan Albert Viloca Puig",4,3,7,57.142857142857146
2001,102169,"Michael Joyce",1,2,3,33.333333333333336
2001,102179,"Antony Dupuis",11,20,31,35.483870967741936
2001,102184,"David Prinosil",7,22,29,24.137931034482758
2001,102202,"Kenneth Carlsen",9,7,16,56.25
2001,102205,"Sebastien Lareau",5,7,12,41.666666666666664
2001,102223,"Karim Alami",5,17,22,22.727272727272727
2001,102227,"Sargis Sargsian",16,19,35,45.714285714285715
2001,102231,"Alex Calatrava",18,29,47,38.297872340425535
2001,102233,"Leander Paes",1,2,3,33.333333333333336
2001,102234,"Oliver Gross",1,2,3,33.333333333333336
2001,102247,"Andrea Gaudenzi",17,19,36,47.22222222222222
2001,102257,"Greg Rusedski",37,24,61,60.65573770491803
2001,102259,"Jerome Golmard",27,21,48,56.25
2001,102263,"Yong Il Yoon",1,3,4,25
2001,102269,"Jeff Salzenstein",1,2,3,33.333333333333336
2001,102271,"Hicham Arazi",30,23,53,56.60377358490566
2001,102286,"Wayne Black",5,9,14,35.714285714285715
2001,102287,"Albert Portas",32,28,60,53.333333333333336
2001,102318,"Andrei Pavel",29,26,55,52.72727272727273
2001,102338,"Yevgeny Kafelnikov",67,27,94,71.27659574468085
2001,102344,"Karol Kucera",11,13,24,45.833333333333336
2001,102358,"Thomas Enqvist",33,22,55,60
2001,102369,"Julien Boutter",25,25,50,50
2001,102374,"Alex Corretja",33,20,53,62.264150943396224
2001,102381,"Werner Eschauer",2,3,5,40
2001,102401,"Scott Draper",2,6,8,25
2001,102434,"Vincent Spadea",1,3,4,25
2001,102437,"Adrian Voinea",11,11,22,50
2001,102443,"Barry Cowan",1,3,4,25
2001,102446,"Andrei Medvedev",9,16,25,36
2001,102450,"Tim Henman",49,20,69,71.01449275362319
2001,102456,"Felix Mantilla",26,20,46,56.52173913043478
2001,102466,"Jan Kroslak",1,2,3,33.333333333333336
2001,102477,"Gaston Etlis",1,1,2,50
2001,102494,"Tomas Behrend",5,8,13,38.46153846153846
2001,102524,"Neville Godwin",5,7,12,41.666666666666664
2001,102533,"Jens Knippschild",6,13,19,31.57894736842105
2001,102539,"Bohdan Ulihrach",34,26,60,56.666666666666664
2001,102548,"Juan Antonio Marin",6,5,11,54.54545454545455
2001,102562,"Jiri Novak",28,17,45,62.22222222222222
2001,102563,"Thomas Johansson",42,23,65,64.61538461538461
2001,102567,"George Bastl",10,15,25,40
2001,102574,"Gabriel Trifu",2,3,5,40
2001,102607,"Juan Balcells",18,23,41,43.90243902439025
2001,102610,"Albert Costa",27,22,49,55.10204081632653
2001,102642,"Cyril Saulnier",4,11,15,26.666666666666668
2001,102644,"Franco Squillari",22,29,51,43.13725490196079
2001,102652,"Christian Vinck",3,13,16,18.75
2001,102669,"Noam Behr",4,5,9,44.44444444444444
2001,102694,"Lars Burgsmuller",14,19,33,42.42424242424242
2001,102701,"Marcelo Rios",28,19,47,59.57446808510638
2001,102703,"Hyung Taik Lee",9,19,28,32.142857142857146
2001,102715,"Ignacio Hirigoyen",1,2,3,33.333333333333336
2001,102720,"Tomas Zib",3,11,14,21.428571428571427
2001,102722,"Attila Savolt",6,5,11,54.54545454545455
2001,102730,"Ivo Heuberger",6,9,15,40
2001,102765,"Nicolas Escude",28,23,51,54.90196078431372
2001,102768,"Federico Browne",1,2,3,33.333333333333336
2001,102770,"John Van Lottum",1,5,6,16.666666666666668
2001,102776,"Andrew Ilie",20,28,48,41.666666666666664
2001,102783,"Rainer Schuettler",33,31,64,51.5625
2001,102785,"Glenn Weiner",3,3,6,50
2001,102788,"Jan Vacek",8,6,14,57.142857142857146
2001,102796,"Magnus Norman",23,20,43,53.48837209302326
2001,102800,"Nenad Zimonjic",1,4,5,20
2001,102809,"Axel Pretzsch",2,4,6,33.333333333333336
2001,102817,"Edwin Kempes",6,12,18,33.333333333333336
2001,102821,"Cecil Mamiit",10,18,28,35.714285714285715
2001,102831,"Jacobo Diaz",9,14,23,39.130434782608695
2001,102834,"Paul Goldstein",5,10,15,33.333333333333336
2001,102836,"Rogier Wassen",1,2,3,33.333333333333336
2001,102839,"Nicolas Lapentti",30,22,52,57.69230769230769
2001,102845,"Carlos Moya",34,23,57,59.64912280701754
2001,102854,"Sjeng Schalken",36,27,63,57.142857142857146
2001,102855,"Jack Brasington",1,1,2,50
2001,102856,"Gustavo Kuerten",57,17,74,77.02702702702703
2001,102860,"Agustin Calleri",11,16,27,40.74074074074074
2001,102863,"Takao Suzuki",3,2,5,60
2001,102869,"Galo Blanco",20,23,43,46.51162790697674
2001,102880,"Alexander Popp",3,9,12,25
2001,102882,"Mark Philippoussis",10,8,18,55.55555555555556
2001,102887,"Ramon Delgado",8,7,15,53.333333333333336
2001,102905,"Stefan Koubek",20,22,42,47.61904761904762
2001,102911,"Andrei Stoliarov",17,24,41,41.46341463414634
2001,102921,"Ota Fukarek",1,4,5,20
2001,102925,"Justin Gimelstob",3,12,15,20
2001,102934,"Nicolas Coutelot",2,2,4,50
2001,102950,"Fernando Vicente",23,26,49,46.93877551020408
2001,102957,"Vadim Kutsenko",1,2,3,33.333333333333336
2001,102965,"Jamie Delgado",3,8,11,27.272727272727273
2001,102966,"Fredrik Jonsson",1,4,5,20
2001,102987,"Andre Sa",8,15,23,34.78260869565217
2001,102998,"Jan Michael Gambill",35,25,60,58.333333333333336
2001,103017,"Nicolas Kiefer",27,27,54,50
2001,103018,"Max Mirnyi",29,26,55,52.72727272727273
2001,103082,"Markus Hantschk",4,12,16,25
2001,103084,"Guillermo Canas",45,21,66,68.18181818181819
2001,103096,"Arnaud Clement",33,26,59,55.932203389830505
2001,103103,"Dominik Hrbaty",28,29,57,49.12280701754386
2001,103105,"Ruben Ramirez Hidalgo",1,1,2,50
2001,103114,"Martin Lee",9,10,19,47.36842105263158
2001,103133,"Olivier Mutis",1,1,2,50
2001,103151,"Mariano Zabaleta",18,18,36,50
2001,103153,"Gilles Elseneer",4,2,6,66.66666666666667
2001,103157,"Arvind Parmar",2,3,5,40
2001,103163,"Tommy Haas",55,22,77,71.42857142857143
2001,103166,"Vladimir Voltchkov",13,24,37,35.13513513513514
2001,103171,"Raemon Sluiter",7,12,19,36.8421052631579
2001,103174,"Noam Okun",2,4,6,33.333333333333336
2001,103176,"David Sanchez",12,19,31,38.70967741935484
2001,103178,"Johan Settergren",1,2,3,33.333333333333336
2001,103181,"Jiri Vanek",11,22,33,33.333333333333336
2001,103182,"Markus Hipfl",14,18,32,43.75
2001,103184,"Bob Bryan",4,11,15,26.666666666666668
2001,103185,"Mike Bryan",1,3,4,25
2001,103188,"Michael Russell",8,17,25,32
2001,103193,"Peter Wessels",11,11,22,50
2001,103202,"Oscar Serrano",3,3,6,50
2001,103204,"Hugo Armando",4,6,10,40
2001,103206,"Sebastien Grosjean",50,24,74,67.56756756756756
2001,103240,"Kevin Kim",1,3,4,25
2001,103248,"Harel Levy",15,25,40,37.5
2001,103252,"Alberto Martin",32,26,58,55.172413793103445
2001,103254,"Yves Allegro",1,1,2,50
2001,103264,"Mariano Puerta",3,13,16,18.75
2001,103270,"Kristian Capalik",2,3,5,40
2001,103292,"Gaston Gaudio",23,23,46,50
2001,103294,"Christophe Rochus",14,21,35,40
2001,103296,"Ivaylo Traykov",1,1,2,50
2001,103297,"Alex Kim",1,2,3,33.333333333333336
2001,103305,"Daniel Elsner",1,9,10,10
2001,103324,"Arnaud Di Pasquale",6,19,25,24
2001,103344,"Ivan Ljubicic",27,21,48,56.25
2001,103356,"Michel Kratochvil",27,24,51,52.94117647058823
2001,103387,"Paradorn Srichaphan",7,15,22,31.818181818181817
2001,103397,"Alexandre Simoni",8,9,17,47.05882352941177
2001,103403,"Takahiro Terachi",2,2,4,50
2001,103420,"Michal Tabara",20,19,39,51.282051282051285
2001,103428,"Juan Ignacio Chela",10,10,20,50
2001,103444,"Jean Rene Lisnard",2,3,5,40
2001,103451,"Bjorn Phau",2,4,6,33.333333333333336
2001,103454,"Nicolas Massu",21,27,48,43.75
2001,103484,"James Blake",11,9,20,55
2001,103487,"Federico Luzzi",8,8,16,50
2001,103498,"Marat Safin",45,25,70,64.28571428571429
2001,103507,"Juan Carlos Ferrero",56,20,76,73.6842105263158
2001,103566,"Michael Llodra",6,11,17,35.294117647058826
2001,103580,"Alexander Peya",2,2,4,50
2001,103581,"Flavio Saretta",5,3,8,62.5
2001,103594,"Oliver Marach",1,1,2,50
2001,103598,"Xavier Malisse",37,22,59,62.71186440677966
2001,103602,"Fernando Gonzalez",5,10,15,33.333333333333336
2001,103632,"Luis Horna",1,4,5,20
2001,103656,"Albert Montanes",12,8,20,60
2001,103672,"Ricardo Mello",2,1,3,66.66666666666667
2001,103694,"Olivier Rochus",9,19,28,32.142857142857146
2001,103709,"Kristian Pless",12,10,22,54.54545454545455
2001,103714,"Andreas Vinciguerra",29,27,56,51.785714285714285
2001,103720,"Lleyton Hewitt",73,17,90,81.11111111111111
2001,103758,"Taylor Dent",10,13,23,43.47826086956522
2001,103781,"Jurgen Melzer",1,1,2,50
2001,103786,"Nikolay Davydenko",6,15,21,28.571428571428573
2001,103789,"Irakli Labadze",4,7,11,36.36363636363637
2001,103813,"Jarkko Nieminen",4,1,5,80
2001,103819,"Roger Federer",46,20,66,69.6969696969697
2001,103821,"Danai Udomchoke",2,1,3,66.66666666666667
2001,103852,"Feliciano Lopez",2,5,7,28.571428571428573
2001,103888,"Mardy Fish",5,8,13,38.46153846153846
2001,103898,"Julien Benneteau",1,1,2,50
2001,103900,"David Nalbandian",17,9,26,65.38461538461539
2001,103909,"Guillermo Coria",26,15,41,63.41463414634146
2001,103917,"Nicolas Mahut",1,4,5,20
2001,103990,"Tommy Robredo",37,20,57,64.91228070175438
2001,104022,"Mikhail Youzhny",20,18,38,52.63157894736842
2001,104043,"Marc Lopez",5,2,7,71.42857142857143
2001,104053,"Andy Roddick",39,16,55,70.9090909090909
2001,104068,"Robby Ginepri",3,5,8,37.5
2001,104076,"Jose Acasuso",8,12,20,40
2001,104082,"Hiroki Kondo",1,1,2,50
2001,104098,"Dmitry Tursunov",3,1,4,75
2001,104196,"Carlos Cuadrado",1,1,2,50
2001,104417,"Robin Soderling",1,1,2,50
2001,210013,"Martin Damm Sr",1,7,8,12.5
2002,101532,"Francisco Clavet",11,22,33,33.333333333333336
2002,101611,"Cedric Pioline",10,16,26,38.46153846153846
2002,101647,"Byron Black",1,3,4,25
2002,101723,"Magnus Larsson",8,8,16,50
2002,101736,"Andre Agassi",54,12,66,81.81818181818181
2002,101746,"Renzo Furlan",1,3,4,25
2002,101774,"Todd Martin",24,16,40,60
2002,101820,"Marc Rosset",8,12,20,40
2002,101843,"Sergi Bruguera",1,3,4,25
2002,101868,"Dick Norman",1,5,6,16.666666666666668
2002,101885,"Wayne Arthurs",23,24,47,48.93617021276596
2002,101897,"Fernando Meligeni",19,23,42,45.23809523809524
2002,101948,"Pete Sampras",26,16,42,61.904761904761905
2002,101962,"Younes El Aynaoui",42,25,67,62.6865671641791
2002,101964,"Goran Ivanisevic",4,7,11,36.36363636363637
2002,101965,"Wayne Ferreira",24,18,42,57.142857142857146
2002,101990,"Richard Krajicek",7,6,13,53.84615384615385
2002,102021,"Michael Chang",7,18,25,28
2002,102035,"Jonas Bjorkman",21,22,43,48.83720930232558
2002,102087,"Oleg Ogorodov",3,5,8,37.5
2002,102106,"Davide Sanguinetti",22,21,43,51.16279069767442
2002,102143,"Nicolas Thomann",2,4,6,33.333333333333336
2002,102148,"Fabrice Santoro",27,25,52,51.92307692307692
2002,102179,"Antony Dupuis",14,23,37,37.83783783783784
2002,102184,"David Prinosil",2,2,4,50
2002,102201,"Lionel Roux",1,2,3,33.333333333333336
2002,102202,"Kenneth Carlsen",16,14,30,53.333333333333336
2002,102223,"Karim Alami",1,2,3,33.333333333333336
2002,102227,"Sargis Sargsian",13,19,32,40.625
2002,102231,"Alex Calatrava",6,10,16,37.5
2002,102234,"Oliver Gross",2,4,6,33.333333333333336
2002,102247,"Andrea Gaudenzi",11,26,37,29.72972972972973
2002,102257,"Greg Rusedski",33,16,49,67.34693877551021
2002,102259,"Jerome Golmard",14,13,27,51.851851851851855
2002,102271,"Hicham Arazi",14,21,35,40
2002,102287,"Albert Portas",9,23,32,28.125
2002,102300,"Gouichi Motomura",1,2,3,33.333333333333336
2002,102306,"Michael Kohlmann",7,14,21,33.333333333333336
2002,102318,"Andrei Pavel",40,26,66,60.60606060606061
2002,102338,"Yevgeny Kafelnikov",36,27,63,57.142857142857146
2002,102344,"Karol Kucera",18,16,34,52.94117647058823
2002,102358,"Thomas Enqvist",26,17,43,60.46511627906977
2002,102369,"Julien Boutter",16,25,41,39.02439024390244
2002,102374,"Alex Corretja",37,18,55,67.27272727272727
2002,102382,"Julian Knowle",4,14,18,22.22222222222222
2002,102401,"Scott Draper",2,5,7,28.571428571428573
2002,102434,"Vincent Spadea",13,17,30,43.333333333333336
2002,102437,"Adrian Voinea",18,20,38,47.36842105263158
2002,102443,"Barry Cowan",1,1,2,50
2002,102450,"Tim Henman",47,19,66,71.21212121212122
2002,102456,"Felix Mantilla",26,25,51,50.98039215686274
2002,102473,"Thomas Schiessling",1,1,2,50
2002,102477,"Gaston Etlis",3,3,6,50
2002,102497,"Mashiska Washington",1,1,2,50
2002,102524,"Neville Godwin",2,7,9,22.22222222222222
2002,102533,"Jens Knippschild",1,2,3,33.333333333333336
2002,102538,"Tuomas Ketola",1,3,4,25
2002,102539,"Bohdan Ulihrach",21,27,48,43.75
2002,102548,"Juan Antonio Marin",4,8,12,33.333333333333336
2002,102562,"Jiri Novak",50,27,77,64.93506493506493
2002,102563,"Thomas Johansson",27,23,50,54
2002,102565,"Alexander Waske",4,5,9,44.44444444444444
2002,102567,"George Bastl",3,9,12,25
2002,102571,"Gregory Carraz",2,5,7,28.571428571428573
2002,102607,"Juan Balcells",7,12,19,36.8421052631579
2002,102610,"Albert Costa",35,22,57,61.40350877192982
2002,102615,"Dennis Van Scheppingen",1,2,3,33.333333333333336
2002,102642,"Cyril Saulnier",3,8,11,27.272727272727273
2002,102644,"Franco Squillari",16,22,38,42.10526315789474
2002,102694,"Lars Burgsmuller",15,21,36,41.666666666666664
2002,102701,"Marcelo Rios",31,19,50,62
2002,102703,"Hyung Taik Lee",11,14,25,44
2002,102722,"Attila Savolt",14,22,36,38.888888888888886
2002,102730,"Ivo Heuberger",6,14,20,30
2002,102765,"Nicolas Escude",30,17,47,63.829787234042556
2002,102770,"John Van Lottum",4,4,8,50
2002,102783,"Rainer Schuettler",38,29,67,56.71641791044776
2002,102788,"Jan Vacek",10,24,34,29.41176470588235
2002,102796,"Magnus Norman",12,19,31,38.70967741935484
2002,102809,"Axel Pretzsch",2,6,8,25
2002,102821,"Cecil Mamiit",8,14,22,36.36363636363637
2002,102831,"Jacobo Diaz",1,6,7,14.285714285714286
2002,102834,"Paul Goldstein",1,3,4,25
2002,102839,"Nicolas Lapentti",32,27,59,54.23728813559322
2002,102845,"Carlos Moya",59,21,80,73.75
2002,102851,"Giorgio Galimberti",1,2,3,33.333333333333336
2002,102854,"Sjeng Schalken",36,27,63,57.142857142857146
2002,102855,"Jack Brasington",1,5,6,16.666666666666668
2002,102856,"Gustavo Kuerten",24,14,38,63.1578947368421
2002,102860,"Agustin Calleri",25,23,48,52.083333333333336
2002,102863,"Takao Suzuki",2,4,6,33.333333333333336
2002,102869,"Galo Blanco",8,19,27,29.62962962962963
2002,102880,"Alexander Popp",8,9,17,47.05882352941177
2002,102882,"Mark Philippoussis",14,14,28,50
2002,102887,"Ramon Delgado",8,20,28,28.571428571428573
2002,102902,"Thomas Blake",2,2,4,50
2002,102905,"Stefan Koubek",18,31,49,36.734693877551024
2002,102911,"Andrei Stoliarov",8,15,23,34.78260869565217
2002,102921,"Ota Fukarek",1,8,9,11.11111111111111
2002,102925,"Justin Gimelstob",5,6,11,45.45454545454545
2002,102934,"Nicolas Coutelot",8,13,21,38.095238095238095
2002,102950,"Fernando Vicente",23,28,51,45.09803921568628
2002,102957,"Vadim Kutsenko",1,1,2,50
2002,102967,"Marc Gicquel",1,1,2,50
2002,102968,"Jonathan Erlich",2,2,4,50
2002,102987,"Andre Sa",19,24,43,44.18604651162791
2002,102998,"Jan Michael Gambill",28,26,54,51.851851851851855
2002,102999,"Stefano Galvani",7,13,20,35
2002,103003,"Jean Francois Bachelot",2,4,6,33.333333333333336
2002,103007,"Mounir El Aarej",1,1,2,50
2002,103017,"Nicolas Kiefer",20,26,46,43.47826086956522
2002,103018,"Max Mirnyi",24,27,51,47.05882352941177
2002,103063,"Sebastien De Chaunac",1,2,3,33.333333333333336
2002,103066,"Mark Nielsen",1,1,2,50
2002,103084,"Guillermo Canas",44,23,67,65.67164179104478
2002,103096,"Arnaud Clement",31,24,55,56.36363636363637
2002,103103,"Dominik Hrbaty",22,28,50,44
2002,103114,"Martin Lee",4,17,21,19.047619047619047
2002,103145,"Amir Hadad",1,1,2,50
2002,103151,"Mariano Zabaleta",20,28,48,41.666666666666664
2002,103153,"Gilles Elseneer",2,2,4,50
2002,103157,"Arvind Parmar",2,3,5,40
2002,103163,"Tommy Haas",44,22,66,66.66666666666667
2002,103165,"Gorka Fraile",1,1,2,50
2002,103166,"Vladimir Voltchkov",9,6,15,60
2002,103171,"Raemon Sluiter",10,14,24,41.666666666666664
2002,103174,"Noam Okun",8,15,23,34.78260869565217
2002,103176,"David Sanchez",19,23,42,45.23809523809524
2002,103178,"Johan Settergren",1,1,2,50
2002,103181,"Jiri Vanek",2,4,6,33.333333333333336
2002,103182,"Markus Hipfl",11,17,28,39.285714285714285
2002,103184,"Bob Bryan",1,3,4,25
2002,103185,"Mike Bryan",1,2,3,33.333333333333336
2002,103188,"Michael Russell",5,15,20,25
2002,103206,"Sebastien Grosjean",37,20,57,64.91228070175438
2002,103240,"Kevin Kim",2,3,5,40
2002,103242,"Juan Giner",2,1,3,66.66666666666667
2002,103248,"Harel Levy",3,10,13,23.076923076923077
2002,103252,"Alberto Martin",23,24,47,48.93617021276596
2002,103254,"Yves Allegro",2,2,4,50
2002,103264,"Mariano Puerta",2,4,6,33.333333333333336
2002,103280,"Martin Verkerk",8,10,18,44.44444444444444
2002,103285,"Radek Stepanek",17,14,31,54.83870967741935
2002,103292,"Gaston Gaudio",39,17,56,69.64285714285714
2002,103294,"Christophe Rochus",10,21,31,32.25806451612903
2002,103297,"Alex Kim",4,11,15,26.666666666666668
2002,103318,"Zeljko Krajan",5,8,13,38.46153846153846
2002,103319,"Jeff Morrison",9,12,21,42.857142857142854
2002,103324,"Arnaud Di Pasquale",7,5,12,58.333333333333336
2002,103333,"Ivo Karlovic",1,2,3,33.333333333333336
2002,103344,"Ivan Ljubicic",27,27,54,50
2002,103356,"Michel Kratochvil",20,27,47,42.5531914893617
2002,103387,"Paradorn Srichaphan",46,23,69,66.66666666666667
2002,103395,"Julio Silva",1,2,3,33.333333333333336
2002,103397,"Alexandre Simoni",2,10,12,16.666666666666668
2002,103408,"Brian Vahaly",6,7,13,46.15384615384615
2002,103420,"Michal Tabara",4,7,11,36.36363636363637
2002,103428,"Juan Ignacio Chela",44,27,71,61.971830985915496
2002,103444,"Jean Rene Lisnard",5,5,10,50
2002,103451,"Bjorn Phau",1,6,7,14.285714285714286
2002,103454,"Nicolas Massu",27,19,46,58.69565217391305
2002,103484,"James Blake",34,23,57,59.64912280701754
2002,103487,"Federico Luzzi",1,6,7,14.285714285714286
2002,103498,"Marat Safin",50,25,75,66.66666666666667
2002,103507,"Juan Carlos Ferrero",47,24,71,66.19718309859155
2002,103566,"Michael Llodra",12,17,29,41.37931034482759
2002,103581,"Flavio Saretta",12,16,28,42.857142857142854
2002,103598,"Xavier Malisse",29,23,52,55.76923076923077
2002,103602,"Fernando Gonzalez",40,21,61,65.57377049180327
2002,103632,"Luis Horna",6,8,14,42.857142857142854
2002,103656,"Albert Montanes",17,24,41,41.46341463414634
2002,103694,"Olivier Rochus",17,22,39,43.58974358974359
2002,103709,"Kristian Pless",15,22,37,40.54054054054054
2002,103714,"Andreas Vinciguerra",3,12,15,20
2002,103720,"Lleyton Hewitt",61,16,77,79.22077922077922
2002,103758,"Taylor Dent",20,17,37,54.054054054054056
2002,103781,"Jurgen Melzer",10,9,19,52.63157894736842
2002,103786,"Nikolay Davydenko",12,24,36,33.333333333333336
2002,103789,"Irakli Labadze",10,20,30,33.333333333333336
2002,103812,"Victor Hanescu",3,3,6,50
2002,103813,"Jarkko Nieminen",25,26,51,49.01960784313726
2002,103819,"Roger Federer",55,22,77,71.42857142857143
2002,103837,"Didac Perez",1,3,4,25
2002,103852,"Feliciano Lopez",18,16,34,52.94117647058823
2002,103888,"Mardy Fish",11,11,22,50
2002,103900,"David Nalbandian",36,23,59,61.016949152542374
2002,103908,"Paul Henri Mathieu",23,14,37,62.16216216216216
2002,103909,"Guillermo Coria",22,16,38,57.89473684210526
2002,103912,"Mario Radic",1,2,3,33.333333333333336
2002,103970,"David Ferrer",10,6,16,62.5
2002,103971,"Karol Beck",2,3,5,40
2002,103990,"Tommy Robredo",32,25,57,56.14035087719298
2002,104022,"Mikhail Youzhny",30,22,52,57.69230769230769
2002,104026,"Joachim Johansson",1,1,2,50
2002,104043,"Marc Lopez",2,2,4,50
2002,104053,"Andy Roddick",52,20,72,72.22222222222223
2002,104068,"Robby Ginepri",6,12,18,33.333333333333336
2002,104076,"Jose Acasuso",23,19,42,54.76190476190476
2002,104166,"Alex Bogomolov Jr",1,2,3,33.333333333333336
2002,104269,"Fernando Verdasco",1,2,3,33.333333333333336
2002,104339,"Mario Ancic",3,7,10,30
2002,104417,"Robin Soderling",1,5,6,16.666666666666668
2002,104433,"Frank Dancevic",1,2,3,33.333333333333336
2002,104745,"Rafael Nadal",1,1,2,50
2002,104755,"Richard Gasquet",1,5,6,16.666666666666668
2002,210013,"Martin Damm Sr",1,2,3,33.333333333333336
2003,101532,"Francisco Clavet",2,4,6,33.333333333333336
2003,101723,"Magnus Larsson",1,2,3,33.333333333333336
2003,101736,"Andre Agassi",47,10,57,82.45614035087719
2003,101746,"Renzo Furlan",1,4,5,20
2003,101774,"Todd Martin",16,13,29,55.172413793103445
2003,101806,"Marc Kevin Goellner",1,1,2,50
2003,101820,"Marc Rosset",6,9,15,40
2003,101868,"Dick Norman",3,7,10,30
2003,101885,"Wayne Arthurs",12,24,36,33.333333333333336
2003,101897,"Fernando Meligeni",6,8,14,42.857142857142854
2003,101938,"Bernardo Mota",1,1,2,50
2003,101962,"Younes El Aynaoui",38,26,64,59.375
2003,101965,"Wayne Ferreira",24,19,43,55.81395348837209
2003,101990,"Richard Krajicek",11,10,21,52.38095238095238
2003,102021,"Michael Chang",2,10,12,16.666666666666668
2003,102035,"Jonas Bjorkman",30,20,50,60
2003,102106,"Davide Sanguinetti",16,21,37,43.24324324324324
2003,102110,"Daniel Nestor",1,1,2,50
2003,102143,"Nicolas Thomann",6,4,10,60
2003,102148,"Fabrice Santoro",17,21,38,44.73684210526316
2003,102169,"Michael Joyce",1,1,2,50
2003,102179,"Antony Dupuis",17,22,39,43.58974358974359
2003,102202,"Kenneth Carlsen",13,22,35,37.142857142857146
2003,102227,"Sargis Sargsian",28,26,54,51.851851851851855
2003,102247,"Andrea Gaudenzi",3,7,10,30
2003,102257,"Greg Rusedski",11,8,19,57.89473684210526
2003,102269,"Jeff Salzenstein",3,4,7,42.857142857142854
2003,102271,"Hicham Arazi",21,20,41,51.21951219512195
2003,102286,"Wayne Black",2,4,6,33.333333333333336
2003,102287,"Albert Portas",10,20,30,33.333333333333336
2003,102300,"Gouichi Motomura",1,2,3,33.333333333333336
2003,102318,"Andrei Pavel",8,11,19,42.10526315789474
2003,102338,"Yevgeny Kafelnikov",29,24,53,54.716981132075475
2003,102344,"Karol Kucera",24,18,42,57.142857142857146
2003,102358,"Thomas Enqvist",13,26,39,33.333333333333336
2003,102369,"Julien Boutter",8,7,15,53.333333333333336
2003,102374,"Alex Corretja",13,23,36,36.111111111111114
2003,102381,"Werner Eschauer",3,6,9,33.333333333333336
2003,102382,"Julian Knowle",2,6,8,25
2003,102401,"Scott Draper",13,16,29,44.827586206896555
2003,102434,"Vincent Spadea",34,25,59,57.6271186440678
2003,102437,"Adrian Voinea",8,19,27,29.62962962962963
2003,102450,"Tim Henman",30,16,46,65.21739130434783
2003,102456,"Felix Mantilla",27,22,49,55.10204081632653
2003,102464,"Todd Larkham",1,4,5,20
2003,102477,"Gaston Etlis",5,6,11,45.45454545454545
2003,102494,"Tomas Behrend",12,14,26,46.15384615384615
2003,102512,"Joseph Sirianni",1,1,2,50
2003,102538,"Tuomas Ketola",1,1,2,50
2003,102539,"Bohdan Ulihrach",3,6,9,33.333333333333336
2003,102548,"Juan Antonio Marin",1,3,4,25
2003,102558,"Eric Taino",5,6,11,45.45454545454545
2003,102562,"Jiri Novak",42,28,70,60
2003,102565,"Alexander Waske",2,18,20,10
2003,102571,"Gregory Carraz",14,12,26,53.84615384615385
2003,102610,"Albert Costa",23,20,43,53.48837209302326
2003,102615,"Dennis Van Scheppingen",6,6,12,50
2003,102642,"Cyril Saulnier",14,15,29,48.275862068965516
2003,102644,"Franco Squillari",16,19,35,45.714285714285715
2003,102667,"Satoshi Iwabuchi",1,1,2,50
2003,102694,"Lars Burgsmuller",16,23,39,41.02564102564103
2003,102701,"Marcelo Rios",13,8,21,61.904761904761905
2003,102703,"Hyung Taik Lee",18,23,41,43.90243902439025
2003,102720,"Tomas Zib",1,5,6,16.666666666666668
2003,102722,"Attila Savolt",5,11,16,31.25
2003,102730,"Ivo Heuberger",3,10,13,23.076923076923077
2003,102765,"Nicolas Escude",11,10,21,52.38095238095238
2003,102768,"Federico Browne",5,8,13,38.46153846153846
2003,102770,"John Van Lottum",10,14,24,41.666666666666664
2003,102780,"Frederic Niemeyer",1,4,5,20
2003,102783,"Rainer Schuettler",71,28,99,71.71717171717172
2003,102788,"Jan Vacek",5,13,18,27.77777777777778
2003,102796,"Magnus Norman",10,18,28,35.714285714285715
2003,102800,"Nenad Zimonjic",1,3,4,25
2003,102811,"Dusan Vemic",1,1,2,50
2003,102821,"Cecil Mamiit",3,15,18,16.666666666666668
2003,102834,"Paul Goldstein",4,5,9,44.44444444444444
2003,102839,"Nicolas Lapentti",20,22,42,47.61904761904762
2003,102845,"Carlos Moya",52,22,74,70.27027027027027
2003,102851,"Giorgio Galimberti",3,8,11,27.272727272727273
2003,102854,"Sjeng Schalken",39,23,62,62.903225806451616
2003,102856,"Gustavo Kuerten",40,19,59,67.79661016949153
2003,102860,"Agustin Calleri",33,23,56,58.92857142857143
2003,102863,"Takao Suzuki",4,3,7,57.142857142857146
2003,102869,"Galo Blanco",10,9,19,52.63157894736842
2003,102880,"Alexander Popp",9,8,17,52.94117647058823
2003,102882,"Mark Philippoussis",34,18,52,65.38461538461539
2003,102886,"Frantisek Cermak",5,7,12,41.666666666666664
2003,102887,"Ramon Delgado",4,6,10,40
2003,102905,"Stefan Koubek",19,24,43,44.18604651162791
2003,102910,"Salvador Navarro",1,1,2,50
2003,102911,"Andrei Stoliarov",2,6,8,25
2003,102925,"Justin Gimelstob",9,17,26,34.61538461538461
2003,102934,"Nicolas Coutelot",2,2,4,50
2003,102950,"Fernando Vicente",20,29,49,40.816326530612244
2003,102957,"Vadim Kutsenko",1,2,3,33.333333333333336
2003,102968,"Jonathan Erlich",1,1,2,50
2003,102987,"Andre Sa",4,18,22,18.181818181818183
2003,102997,"Hermes Gamonal",2,4,6,33.333333333333336
2003,102998,"Jan Michael Gambill",22,25,47,46.808510638297875
2003,102999,"Stefano Galvani",1,2,3,33.333333333333336
2003,103009,"Razvan Sabau",3,1,4,75
2003,103017,"Nicolas Kiefer",19,17,36,52.77777777777778
2003,103018,"Max Mirnyi",37,28,65,56.92307692307692
2003,103047,"Julien Varlet",3,5,8,37.5
2003,103082,"Markus Hantschk",1,2,3,33.333333333333336
2003,103084,"Guillermo Canas",5,4,9,55.55555555555556
2003,103096,"Arnaud Clement",31,20,51,60.78431372549019
2003,103103,"Dominik Hrbaty",25,26,51,49.01960784313726
2003,103104,"Bjorn Rehnquist",1,1,2,50
2003,103105,"Ruben Ramirez Hidalgo",5,11,16,31.25
2003,103118,"Ion Moldovan",1,1,2,50
2003,103133,"Olivier Mutis",16,18,34,47.05882352941177
2003,103151,"Mariano Zabaleta",33,24,57,57.89473684210526
2003,103153,"Gilles Elseneer",2,4,6,33.333333333333336
2003,103154,"Jaymon Crabb",1,4,5,20
2003,103157,"Arvind Parmar",2,5,7,28.571428571428573
2003,103166,"Vladimir Voltchkov",10,16,26,38.46153846153846
2003,103169,"Oscar Hernandez",4,4,8,50
2003,103171,"Raemon Sluiter",19,24,43,44.18604651162791
2003,103174,"Noam Okun",2,4,6,33.333333333333336
2003,103176,"David Sanchez",23,27,50,46
2003,103181,"Jiri Vanek",7,9,16,43.75
2003,103182,"Markus Hipfl",3,6,9,33.333333333333336
2003,103184,"Bob Bryan",4,5,9,44.44444444444444
2003,103185,"Mike Bryan",2,1,3,66.66666666666667
2003,103188,"Michael Russell",1,1,2,50
2003,103206,"Sebastien Grosjean",34,21,55,61.81818181818182
2003,103225,"Simon Larose",3,2,5,60
2003,103228,"Marcos Daniel",1,3,4,25
2003,103230,"Tasuku Iwami",1,1,2,50
2003,103248,"Harel Levy",2,6,8,25
2003,103250,"Rodolphe Cadart",2,1,3,66.66666666666667
2003,103252,"Alberto Martin",19,26,45,42.22222222222222
2003,103264,"Mariano Puerta",5,14,19,26.31578947368421
2003,103280,"Martin Verkerk",24,24,48,50
2003,103285,"Radek Stepanek",27,23,50,54
2003,103292,"Gaston Gaudio",36,24,60,60
2003,103294,"Christophe Rochus",12,18,30,40
2003,103297,"Alex Kim",3,10,13,23.076923076923077
2003,103318,"Zeljko Krajan",2,14,16,12.5
2003,103319,"Jeff Morrison",4,10,14,28.571428571428573
2003,103324,"Arnaud Di Pasquale",1,4,5,20
2003,103325,"Wesley Moodie",7,9,16,43.75
2003,103333,"Ivo Karlovic",9,7,16,56.25
2003,103344,"Ivan Ljubicic",27,23,50,54
2003,103356,"Michel Kratochvil",11,20,31,35.483870967741936
2003,103373,"Sergio Roitman",1,4,5,20
2003,103385,"Paul Baccanello",1,2,3,33.333333333333336
2003,103387,"Paradorn Srichaphan",46,27,73,63.013698630136986
2003,103408,"Brian Vahaly",12,23,35,34.285714285714285
2003,103428,"Juan Ignacio Chela",35,27,62,56.45161290322581
2003,103429,"Peter Luczak",4,8,12,33.333333333333336
2003,103444,"Jean Rene Lisnard",16,19,35,45.714285714285715
2003,103451,"Bjorn Phau",1,4,5,20
2003,103454,"Nicolas Massu",36,20,56,64.28571428571429
2003,103470,"Robert Kendrick",6,10,16,37.5
2003,103478,"Diego Veronelli",2,2,4,50
2003,103484,"James Blake",31,25,56,55.357142857142854
2003,103498,"Marat Safin",12,13,25,48
2003,103507,"Juan Carlos Ferrero",63,18,81,77.77777777777777
2003,103525,"Ivan Miranda",6,9,15,40
2003,103530,"Zack Fleishman",2,3,5,40
2003,103566,"Michael Llodra",2,10,12,16.666666666666668
2003,103573,"Rik De Voest",2,2,4,50
2003,103580,"Alexander Peya",1,2,3,33.333333333333336
2003,103581,"Flavio Saretta",24,19,43,55.81395348837209
2003,103598,"Xavier Malisse",18,20,38,47.36842105263158
2003,103602,"Fernando Gonzalez",35,25,60,58.333333333333336
2003,103626,"Tomas Tenconi",1,1,2,50
2003,103632,"Luis Horna",18,20,38,47.36842105263158
2003,103656,"Albert Montanes",10,16,26,38.46153846153846
2003,103672,"Ricardo Mello",5,8,13,38.46153846153846
2003,103693,"Thierry Ascione",3,5,8,37.5
2003,103694,"Olivier Rochus",24,28,52,46.15384615384615
2003,103709,"Kristian Pless",2,5,7,28.571428571428573
2003,103714,"Andreas Vinciguerra",9,11,20,45
2003,103720,"Lleyton Hewitt",32,10,42,76.19047619047619
2003,103737,"Edgardo Massa",1,1,2,50
2003,103758,"Taylor Dent",28,12,40,70
2003,103781,"Jurgen Melzer",11,18,29,37.93103448275862
2003,103786,"Nikolay Davydenko",29,30,59,49.152542372881356
2003,103789,"Irakli Labadze",6,17,23,26.08695652173913
2003,103799,"Eric Prodon",1,2,3,33.333333333333336
2003,103812,"Victor Hanescu",13,12,25,52
2003,103813,"Jarkko Nieminen",37,29,66,56.06060606060606
2003,103819,"Roger Federer",74,16,90,82.22222222222223
2003,103835,"Filippo Volandri",18,16,34,52.94117647058823
2003,103852,"Feliciano Lopez",34,31,65,52.30769230769231
2003,103888,"Mardy Fish",38,23,61,62.295081967213115
2003,103898,"Julien Benneteau",3,7,10,30
2003,103900,"David Nalbandian",40,21,61,65.57377049180327
2003,103908,"Paul Henri Mathieu",16,23,39,41.02564102564103
2003,103909,"Guillermo Coria",61,17,78,78.2051282051282
2003,103912,"Mario Radic",1,1,2,50
2003,103917,"Nicolas Mahut",3,6,9,33.333333333333336
2003,103948,"Maximilian Abel",2,4,6,33.333333333333336
2003,103970,"David Ferrer",20,27,47,42.5531914893617
2003,103971,"Karol Beck",8,23,31,25.806451612903224
2003,103990,"Tommy Robredo",38,26,64,59.375
2003,104014,"Lee Childs",1,1,2,50
2003,104019,"Kristof Vliegen",5,8,13,38.46153846153846
2003,104022,"Mikhail Youzhny",28,26,54,51.851851851851855
2003,104025,"Amer Delic",1,3,4,25
2003,104026,"Joachim Johansson",2,4,6,33.333333333333336
2003,104043,"Marc Lopez",2,4,6,33.333333333333336
2003,104053,"Andy Roddick",71,18,89,79.7752808988764
2003,104068,"Robby Ginepri",31,19,50,62
2003,104076,"Jose Acasuso",11,19,30,36.666666666666664
2003,104098,"Dmitry Tursunov",2,3,5,40
2003,104117,"Giovanni Lapentti",1,2,3,33.333333333333336
2003,104166,"Alex Bogomolov Jr",5,8,13,38.46153846153846
2003,104182,"Sasa Tuksar",1,1,2,50
2003,104214,"Igor Andreev",4,4,8,50
2003,104250,"Prakash Amritraj",2,5,7,28.571428571428573
2003,104259,"Philipp Kohlschreiber",1,3,4,25
2003,104269,"Fernando Verdasco",7,12,19,36.8421052631579
2003,104330,"Rajeev Ram",1,1,2,50
2003,104332,"Philipp Petzschner",2,3,5,40
2003,104339,"Mario Ancic",14,18,32,43.75
2003,104372,"Alex Bogdanovic",2,3,5,40
2003,104379,"Todd Reid",2,5,7,28.571428571428573
2003,104386,"Janko Tipsarevic",1,2,3,33.333333333333336
2003,104417,"Robin Soderling",10,6,16,62.5
2003,104495,"Florin Mergea",1,1,2,50
2003,104527,"Stan Wawrinka",2,4,6,33.333333333333336
2003,104589,"Chris Guccione",2,2,4,50
2003,104597,"Nicolas Almagro",1,1,2,50
2003,104607,"Tomas Berdych",1,2,3,33.333333333333336
2003,104745,"Rafael Nadal",14,11,25,56
2003,104755,"Richard Gasquet",2,8,10,20
2004,101736,"Andre Agassi",37,13,50,74
2004,101774,"Todd Martin",10,15,25,40
2004,101820,"Marc Rosset",4,8,12,33.333333333333336
2004,101868,"Dick Norman",1,7,8,12.5
2004,101885,"Wayne Arthurs",13,20,33,39.39393939393939
2004,101924,"Stefano Pescosolido",1,4,5,20
2004,101964,"Goran Ivanisevic",4,10,14,28.571428571428573
2004,101965,"Wayne Ferreira",12,15,27,44.44444444444444
2004,102035,"Jonas Bjorkman",19,25,44,43.18181818181818
2004,102106,"Davide Sanguinetti",11,20,31,35.483870967741936
2004,102107,"Jan Frode Andersen",1,2,3,33.333333333333336
2004,102143,"Nicolas Thomann",1,4,5,20
2004,102148,"Fabrice Santoro",18,15,33,54.54545454545455
2004,102179,"Antony Dupuis",17,21,38,44.73684210526316
2004,102202,"Kenneth Carlsen",15,19,34,44.11764705882353
2004,102227,"Sargis Sargsian",17,27,44,38.63636363636363
2004,102231,"Alex Calatrava",6,7,13,46.15384615384615
2004,102257,"Greg Rusedski",24,15,39,61.53846153846154
2004,102259,"Jerome Golmard",4,5,9,44.44444444444444
2004,102269,"Jeff Salzenstein",4,10,14,28.571428571428573
2004,102271,"Hicham Arazi",15,18,33,45.45454545454545
2004,102287,"Albert Portas",4,16,20,20
2004,102300,"Gouichi Motomura",1,1,2,50
2004,102306,"Michael Kohlmann",4,4,8,50
2004,102318,"Andrei Pavel",31,24,55,56.36363636363637
2004,102344,"Karol Kucera",9,15,24,37.5
2004,102358,"Thomas Enqvist",12,20,32,37.5
2004,102369,"Julien Boutter",1,4,5,20
2004,102374,"Alex Corretja",12,20,32,37.5
2004,102381,"Werner Eschauer",1,2,3,33.333333333333336
2004,102382,"Julian Knowle",3,6,9,33.333333333333336
2004,102434,"Vincent Spadea",40,29,69,57.971014492753625
2004,102450,"Tim Henman",41,21,62,66.12903225806451
2004,102456,"Felix Mantilla",17,15,32,53.125
2004,102494,"Tomas Behrend",5,10,15,33.333333333333336
2004,102538,"Tuomas Ketola",1,1,2,50
2004,102539,"Bohdan Ulihrach",11,19,30,36.666666666666664
2004,102562,"Jiri Novak",40,22,62,64.51612903225806
2004,102563,"Thomas Johansson",29,20,49,59.183673469387756
2004,102565,"Alexander Waske",2,3,5,40
2004,102571,"Gregory Carraz",14,20,34,41.1764705882353
2004,102610,"Albert Costa",20,24,44,45.45454545454545
2004,102615,"Dennis Van Scheppingen",7,14,21,33.333333333333336
2004,102642,"Cyril Saulnier",28,23,51,54.90196078431372
2004,102644,"Franco Squillari",10,9,19,52.63157894736842
2004,102694,"Lars Burgsmuller",8,19,27,29.62962962962963
2004,102703,"Hyung Taik Lee",16,16,32,50
2004,102720,"Tomas Zib",3,8,11,27.272727272727273
2004,102730,"Ivo Heuberger",7,14,21,33.333333333333336
2004,102765,"Nicolas Escude",15,8,23,65.21739130434783
2004,102768,"Federico Browne",1,2,3,33.333333333333336
2004,102770,"John Van Lottum",3,14,17,17.647058823529413
2004,102780,"Frederic Niemeyer",2,4,6,33.333333333333336
2004,102783,"Rainer Schuettler",27,30,57,47.36842105263158
2004,102785,"Glenn Weiner",5,9,14,35.714285714285715
2004,102788,"Jan Vacek",3,12,15,20
2004,102800,"Nenad Zimonjic",1,2,3,33.333333333333336
2004,102821,"Cecil Mamiit",1,3,4,25
2004,102834,"Paul Goldstein",4,6,10,40
2004,102836,"Rogier Wassen",1,1,2,50
2004,102839,"Nicolas Lapentti",7,15,22,31.818181818181817
2004,102845,"Carlos Moya",56,18,74,75.67567567567568
2004,102854,"Sjeng Schalken",17,20,37,45.945945945945944
2004,102856,"Gustavo Kuerten",23,13,36,63.888888888888886
2004,102860,"Agustin Calleri",20,18,38,52.63157894736842
2004,102863,"Takao Suzuki",2,3,5,40
2004,102869,"Galo Blanco",7,15,22,31.818181818181817
2004,102880,"Alexander Popp",11,15,26,42.30769230769231
2004,102882,"Mark Philippoussis",11,17,28,39.285714285714285
2004,102886,"Frantisek Cermak",1,2,3,33.333333333333336
2004,102905,"Stefan Koubek",22,24,46,47.82608695652174
2004,102925,"Justin Gimelstob",1,5,6,16.666666666666668
2004,102950,"Fernando Vicente",4,5,9,44.44444444444444
2004,102965,"Jamie Delgado",1,2,3,33.333333333333336
2004,102967,"Marc Gicquel",1,2,3,33.333333333333336
2004,102998,"Jan Michael Gambill",18,25,43,41.86046511627907
2004,103017,"Nicolas Kiefer",35,20,55,63.63636363636363
2004,103018,"Max Mirnyi",22,26,48,45.833333333333336
2004,103063,"Sebastien De Chaunac",3,5,8,37.5
2004,103084,"Guillermo Canas",40,21,61,65.57377049180327
2004,103096,"Arnaud Clement",14,22,36,38.888888888888886
2004,103103,"Dominik Hrbaty",41,25,66,62.121212121212125
2004,103105,"Ruben Ramirez Hidalgo",7,19,26,26.923076923076923
2004,103110,"Daniele Bracciali",1,2,3,33.333333333333336
2004,103133,"Olivier Mutis",7,13,20,35
2004,103151,"Mariano Zabaleta",26,22,48,54.166666666666664
2004,103153,"Gilles Elseneer",5,12,17,29.41176470588235
2004,103157,"Arvind Parmar",1,6,7,14.285714285714286
2004,103163,"Tommy Haas",36,21,57,63.1578947368421
2004,103166,"Vladimir Voltchkov",2,4,6,33.333333333333336
2004,103169,"Oscar Hernandez",8,19,27,29.62962962962963
2004,103171,"Raemon Sluiter",19,22,41,46.34146341463415
2004,103174,"Noam Okun",4,5,9,44.44444444444444
2004,103176,"David Sanchez",20,27,47,42.5531914893617
2004,103181,"Jiri Vanek",4,7,11,36.36363636363637
2004,103201,"Adrian Garcia",6,10,16,37.5
2004,103204,"Hugo Armando",4,3,7,57.142857142857146
2004,103206,"Sebastien Grosjean",28,15,43,65.11627906976744
2004,103225,"Simon Larose",1,2,3,33.333333333333336
2004,103240,"Kevin Kim",2,3,5,40
2004,103248,"Harel Levy",5,13,18,27.77777777777778
2004,103252,"Alberto Martin",23,26,49,46.93877551020408
2004,103280,"Martin Verkerk",24,17,41,58.53658536585366
2004,103285,"Radek Stepanek",29,25,54,53.7037037037037
2004,103292,"Gaston Gaudio",37,24,61,60.65573770491803
2004,103294,"Christophe Rochus",9,18,27,33.333333333333336
2004,103305,"Daniel Elsner",2,8,10,20
2004,103318,"Zeljko Krajan",1,2,3,33.333333333333336
2004,103319,"Jeff Morrison",13,13,26,50
2004,103324,"Arnaud Di Pasquale",3,9,12,25
2004,103325,"Wesley Moodie",6,16,22,27.272727272727273
2004,103333,"Ivo Karlovic",18,25,43,41.86046511627907
2004,103337,"Ben Qiang Zhu",1,2,3,33.333333333333336
2004,103339,"Wesley Whitehouse",1,1,2,50
2004,103344,"Ivan Ljubicic",35,23,58,60.3448275862069
2004,103356,"Michel Kratochvil",5,8,13,38.46153846153846
2004,103369,"Melle Van Gemerden",1,2,3,33.333333333333336
2004,103385,"Paul Baccanello",1,2,3,33.333333333333336
2004,103387,"Paradorn Srichaphan",42,29,71,59.15492957746479
2004,103393,"Yuri Schukin",1,1,2,50
2004,103401,"Jan Hernych",9,12,21,42.857142857142854
2004,103403,"Takahiro Terachi",1,1,2,50
2004,103408,"Brian Vahaly",1,10,11,9.090909090909092
2004,103420,"Michal Tabara",3,4,7,42.857142857142854
2004,103428,"Juan Ignacio Chela",35,26,61,57.377049180327866
2004,103429,"Peter Luczak",3,5,8,37.5
2004,103444,"Jean Rene Lisnard",4,13,17,23.529411764705884
2004,103451,"Bjorn Phau",5,4,9,55.55555555555556
2004,103454,"Nicolas Massu",39,28,67,58.208955223880594
2004,103470,"Robert Kendrick",4,4,8,50
2004,103484,"James Blake",15,13,28,53.57142857142857
2004,103490,"Santiago Ventura",8,2,10,80
2004,103498,"Marat Safin",51,22,73,69.86301369863014
2004,103506,"Martin Vassallo Arguello",3,7,10,30
2004,103507,"Juan Carlos Ferrero",20,16,36,55.55555555555556
2004,103525,"Ivan Miranda",1,2,3,33.333333333333336
2004,103527,"Julien Jeanpierre",3,2,5,60
2004,103534,"Nicolas Devilder",1,1,2,50
2004,103535,"Olivier Patience",12,15,27,44.44444444444444
2004,103560,"Kj Hippensteel",1,3,4,25
2004,103565,"Stephane Robert",1,2,3,33.333333333333336
2004,103566,"Michael Llodra",20,12,32,62.5
2004,103573,"Rik De Voest",3,2,5,60
2004,103580,"Alexander Peya",4,11,15,26.666666666666668
2004,103581,"Flavio Saretta",15,19,34,44.11764705882353
2004,103592,"Jerome Haehnel",7,3,10,70
2004,103598,"Xavier Malisse",21,26,47,44.680851063829785
2004,103602,"Fernando Gonzalez",38,21,59,64.40677966101696
2004,103632,"Luis Horna",30,28,58,51.724137931034484
2004,103656,"Albert Montanes",11,17,28,39.285714285714285
2004,103663,"Matias Boeker",1,1,2,50
2004,103672,"Ricardo Mello",11,8,19,57.89473684210526
2004,103693,"Thierry Ascione",10,17,27,37.03703703703704
2004,103694,"Olivier Rochus",18,22,40,45
2004,103699,"Fred Hemmes",1,1,2,50
2004,103700,"Juan Pablo Guzman",1,3,4,25
2004,103709,"Kristian Pless",3,9,12,25
2004,103720,"Lleyton Hewitt",66,18,84,78.57142857142857
2004,103722,"Florent Serra",2,3,5,40
2004,103730,"Jonathan Marray",3,3,6,50
2004,103754,"Mark Hilton",1,1,2,50
2004,103758,"Taylor Dent",32,25,57,56.14035087719298
2004,103761,"Tomas Cakl",1,1,2,50
2004,103781,"Jurgen Melzer",27,23,50,54
2004,103786,"Nikolay Davydenko",32,29,61,52.459016393442624
2004,103789,"Irakli Labadze",13,21,34,38.23529411764706
2004,103808,"Potito Starace",8,9,17,47.05882352941177
2004,103812,"Victor Hanescu",17,24,41,41.46341463414634
2004,103813,"Jarkko Nieminen",18,17,35,51.42857142857143
2004,103819,"Roger Federer",71,6,77,92.20779220779221
2004,103835,"Filippo Volandri",29,22,51,56.86274509803921
2004,103843,"Marco Chiudinelli",4,7,11,36.36363636363637
2004,103852,"Feliciano Lopez",32,27,59,54.23728813559322
2004,103857,"Igor Kunitsyn",2,2,4,50
2004,103888,"Mardy Fish",26,18,44,59.09090909090909
2004,103898,"Julien Benneteau",14,15,29,48.275862068965516
2004,103900,"David Nalbandian",33,14,47,70.2127659574468
2004,103908,"Paul Henri Mathieu",9,10,19,47.36842105263158
2004,103909,"Guillermo Coria",37,15,52,71.15384615384616
2004,103913,"Ian Flanagan",2,1,3,66.66666666666667
2004,103917,"Nicolas Mahut",3,10,13,23.076923076923077
2004,103970,"David Ferrer",29,31,60,48.333333333333336
2004,103971,"Karol Beck",21,21,42,50
2004,103990,"Tommy Robredo",41,25,66,62.121212121212125
2004,103997,"Lukasz Kubot",1,1,2,50
2004,104019,"Kristof Vliegen",9,14,23,39.130434782608695
2004,104022,"Mikhail Youzhny",41,26,67,61.19402985074627
2004,104025,"Amer Delic",2,5,7,28.571428571428573
2004,104026,"Joachim Johansson",35,22,57,61.40350877192982
2004,104043,"Marc Lopez",9,12,21,42.857142857142854
2004,104053,"Andy Roddick",68,16,84,80.95238095238095
2004,104068,"Robby Ginepri",20,26,46,43.47826086956522
2004,104076,"Jose Acasuso",18,16,34,52.94117647058823
2004,104081,"Boris Pashanski",1,2,3,33.333333333333336
2004,104098,"Dmitry Tursunov",12,17,29,41.37931034482759
2004,104166,"Alex Bogomolov Jr",10,17,27,37.03703703703704
2004,104180,"Gilles Muller",10,8,18,55.55555555555556
2004,104195,"Simone Vagnozzi",1,1,2,50
2004,104198,"Guillermo Garcia Lopez",5,7,12,41.666666666666664
2004,104214,"Igor Andreev",27,27,54,50
2004,104229,"Yen Hsun Lu",4,10,14,28.571428571428573
2004,104230,"Daniel Koellerer",2,1,3,66.66666666666667
2004,104250,"Prakash Amritraj",1,3,4,25
2004,104252,"Florian Mayer",19,17,36,52.77777777777778
2004,104259,"Philipp Kohlschreiber",6,10,16,37.5
2004,104268,"Alejandro Falla",5,7,12,41.666666666666664
2004,104269,"Fernando Verdasco",31,25,56,55.357142857142854
2004,104273,"Edouard Roger Vasselin",1,2,3,33.333333333333336
2004,104294,"Hao Lu",1,1,2,50
2004,104312,"Andreas Seppi",5,9,14,35.714285714285715
2004,104330,"Rajeev Ram",1,3,4,25
2004,104332,"Philipp Petzschner",1,1,2,50
2004,104338,"Juan Monaco",16,12,28,57.142857142857146
2004,104339,"Mario Ancic",26,22,48,54.166666666666664
2004,104371,"Ivo Minar",1,1,2,50
2004,104372,"Alex Bogdanovic",1,3,4,25
2004,104379,"Todd Reid",12,11,23,52.17391304347826
2004,104383,"Diogo Rocha",1,1,2,50
2004,104386,"Janko Tipsarevic",2,7,9,22.22222222222222
2004,104417,"Robin Soderling",31,27,58,53.44827586206897
2004,104433,"Frank Dancevic",1,2,3,33.333333333333336
2004,104453,"Michael Ryderstedt",3,1,4,75
2004,104499,"Jimmy Wang",1,3,4,25
2004,104542,"Jo-Wilfried Tsonga",2,2,4,50
2004,104548,"Brian Baker",2,5,7,28.571428571428573
2004,104571,"Marcos Baghdatis",2,2,4,50
2004,104589,"Chris Guccione",2,2,4,50
2004,104597,"Nicolas Almagro",2,7,9,22.22222222222222
2004,104607,"Tomas Berdych",15,14,29,51.724137931034484
2004,104676,"Andreas Beck",1,1,2,50
2004,104745,"Rafael Nadal",27,17,44,61.36363636363637
2004,104755,"Richard Gasquet",13,15,28,46.42857142857143
2004,104792,"Gael Monfils",3,2,5,60
2004,104925,"Novak Djokovic",1,3,4,25
2005,101736,"Andre Agassi",38,12,50,76
2005,101868,"Dick Norman",2,9,11,18.181818181818183
2005,101885,"Wayne Arthurs",17,18,35,48.57142857142857
2005,101962,"Younes El Aynaoui",1,10,11,9.090909090909092
2005,102035,"Jonas Bjorkman",19,21,40,47.5
2005,102106,"Davide Sanguinetti",25,25,50,50
2005,102143,"Nicolas Thomann",1,2,3,33.333333333333336
2005,102148,"Fabrice Santoro",18,19,37,48.648648648648646
2005,102179,"Antony Dupuis",7,14,21,33.333333333333336
2005,102202,"Kenneth Carlsen",17,25,42,40.476190476190474
2005,102227,"Sargis Sargsian",3,9,12,25
2005,102231,"Alex Calatrava",4,17,21,19.047619047619047
2005,102257,"Greg Rusedski",27,22,49,55.10204081632653
2005,102269,"Jeff Salzenstein",1,4,5,20
2005,102287,"Albert Portas",2,6,8,25
2005,102306,"Michael Kohlmann",2,2,4,50
2005,102318,"Andrei Pavel",19,25,44,43.18181818181818
2005,102344,"Karol Kucera",3,5,8,37.5
2005,102358,"Thomas Enqvist",7,12,19,36.8421052631579
2005,102374,"Alex Corretja",1,5,6,16.666666666666668
2005,102434,"Vincent Spadea",22,26,48,45.833333333333336
2005,102450,"Tim Henman",23,18,41,56.09756097560975
2005,102456,"Felix Mantilla",14,15,29,48.275862068965516
2005,102494,"Tomas Behrend",7,14,21,33.333333333333336
2005,102539,"Bohdan Ulihrach",1,8,9,11.11111111111111
2005,102548,"Juan Antonio Marin",3,5,8,37.5
2005,102558,"Eric Taino",1,1,2,50
2005,102562,"Jiri Novak",22,26,48,45.833333333333336
2005,102563,"Thomas Johansson",45,24,69,65.21739130434783
2005,102565,"Alexander Waske",9,10,19,47.36842105263158
2005,102567,"George Bastl",4,7,11,36.36363636363637
2005,102571,"Gregory Carraz",4,11,15,26.666666666666668
2005,102610,"Albert Costa",13,17,30,43.333333333333336
2005,102642,"Cyril Saulnier",16,26,42,38.095238095238095
2005,102694,"Lars Burgsmuller",6,21,27,22.22222222222222
2005,102703,"Hyung Taik Lee",10,19,29,34.48275862068966
2005,102720,"Tomas Zib",18,27,45,40
2005,102730,"Ivo Heuberger",2,4,6,33.333333333333336
2005,102783,"Rainer Schuettler",17,24,41,41.46341463414634
2005,102785,"Glenn Weiner",2,4,6,33.333333333333336
2005,102788,"Jan Vacek",1,1,2,50
2005,102800,"Nenad Zimonjic",1,1,2,50
2005,102811,"Dusan Vemic",3,2,5,60
2005,102821,"Cecil Mamiit",1,2,3,33.333333333333336
2005,102834,"Paul Goldstein",13,12,25,52
2005,102839,"Nicolas Lapentti",9,16,25,36
2005,102845,"Carlos Moya",32,20,52,61.53846153846154
2005,102851,"Giorgio Galimberti",1,2,3,33.333333333333336
2005,102854,"Sjeng Schalken",7,10,17,41.1764705882353
2005,102856,"Gustavo Kuerten",3,9,12,25
2005,102860,"Agustin Calleri",21,21,42,50
2005,102863,"Takao Suzuki",1,2,3,33.333333333333336
2005,102880,"Alexander Popp",4,13,17,23.529411764705884
2005,102882,"Mark Philippoussis",9,11,20,45
2005,102886,"Frantisek Cermak",2,2,4,50
2005,102887,"Ramon Delgado",2,2,4,50
2005,102905,"Stefan Koubek",6,15,21,28.571428571428573
2005,102925,"Justin Gimelstob",8,9,17,47.05882352941177
2005,102950,"Fernando Vicente",3,5,8,37.5
2005,102965,"Jamie Delgado",1,3,4,25
2005,102967,"Marc Gicquel",3,2,5,60
2005,102987,"Andre Sa",1,1,2,50
2005,102998,"Jan Michael Gambill",5,10,15,33.333333333333336
2005,103009,"Razvan Sabau",6,10,16,37.5
2005,103017,"Nicolas Kiefer",32,23,55,58.18181818181818
2005,103018,"Max Mirnyi",32,24,56,57.142857142857146
2005,103032,"Francisco Fogues",1,2,3,33.333333333333336
2005,103035,"Alessio Di Mauro",3,6,9,33.333333333333336
2005,103063,"Sebastien De Chaunac",2,5,7,28.571428571428573
2005,103084,"Guillermo Canas",24,11,35,68.57142857142857
2005,103096,"Arnaud Clement",18,21,39,46.15384615384615
2005,103103,"Dominik Hrbaty",37,25,62,59.67741935483871
2005,103105,"Ruben Ramirez Hidalgo",5,5,10,50
2005,103110,"Daniele Bracciali",6,9,15,40
2005,103145,"Amir Hadad",2,2,4,50
2005,103151,"Mariano Zabaleta",20,16,36,55.55555555555556
2005,103153,"Gilles Elseneer",1,3,4,25
2005,103163,"Tommy Haas",31,22,53,58.490566037735846
2005,103169,"Oscar Hernandez",6,16,22,27.272727272727273
2005,103171,"Raemon Sluiter",5,14,19,26.31578947368421
2005,103174,"Noam Okun",3,8,11,27.272727272727273
2005,103175,"Toshihide Matsui",1,1,2,50
2005,103176,"David Sanchez",9,15,24,37.5
2005,103181,"Jiri Vanek",7,18,25,28
2005,103193,"Peter Wessels",8,13,21,38.095238095238095
2005,103201,"Adrian Garcia",1,4,5,20
2005,103204,"Hugo Armando",1,5,6,16.666666666666668
2005,103206,"Sebastien Grosjean",30,21,51,58.8235294117647
2005,103240,"Kevin Kim",19,25,44,43.18181818181818
2005,103252,"Alberto Martin",25,29,54,46.2962962962963
2005,103264,"Mariano Puerta",37,25,62,59.67741935483871
2005,103285,"Radek Stepanek",45,26,71,63.38028169014085
2005,103292,"Gaston Gaudio",56,21,77,72.72727272727273
2005,103294,"Christophe Rochus",18,26,44,40.90909090909091
2005,103305,"Daniel Elsner",1,1,2,50
2005,103319,"Jeff Morrison",3,16,19,15.789473684210526
2005,103325,"Wesley Moodie",16,11,27,59.25925925925926
2005,103333,"Ivo Karlovic",17,22,39,43.58974358974359
2005,103344,"Ivan Ljubicic",50,23,73,68.4931506849315
2005,103369,"Melle Van Gemerden",2,2,4,50
2005,103387,"Paradorn Srichaphan",31,29,60,51.666666666666664
2005,103401,"Jan Hernych",18,22,40,45
2005,103403,"Takahiro Terachi",1,1,2,50
2005,103408,"Brian Vahaly",1,2,3,33.333333333333336
2005,103420,"Michal Tabara",4,10,14,28.571428571428573
2005,103428,"Juan Ignacio Chela",28,26,54,51.851851851851855
2005,103429,"Peter Luczak",5,9,14,35.714285714285715
2005,103444,"Jean Rene Lisnard",9,19,28,32.142857142857146
2005,103451,"Bjorn Phau",10,14,24,41.666666666666664
2005,103454,"Nicolas Massu",18,22,40,45
2005,103455,"Michal Mertinak",4,5,9,44.44444444444444
2005,103484,"James Blake",34,20,54,62.96296296296296
2005,103487,"Federico Luzzi",3,5,8,37.5
2005,103490,"Santiago Ventura",9,18,27,33.333333333333336
2005,103498,"Marat Safin",25,11,36,69.44444444444444
2005,103503,"Robin Vik",8,9,17,47.05882352941177
2005,103506,"Martin Vassallo Arguello",1,1,2,50
2005,103507,"Juan Carlos Ferrero",45,26,71,63.38028169014085
2005,103516,"Nathan Healey",2,3,5,40
2005,103530,"Zack Fleishman",1,1,2,50
2005,103534,"Nicolas Devilder",2,2,4,50
2005,103535,"Olivier Patience",2,5,7,28.571428571428573
2005,103544,"Andy Ram",1,1,2,50
2005,103559,"David Sherwood",1,1,2,50
2005,103566,"Michael Llodra",10,22,32,31.25
2005,103581,"Flavio Saretta",3,5,8,37.5
2005,103582,"Michael Berrer",1,2,3,33.333333333333336
2005,103592,"Jerome Haehnel",1,11,12,8.333333333333334
2005,103594,"Oliver Marach",3,4,7,42.857142857142854
2005,103598,"Xavier Malisse",22,20,42,52.38095238095238
2005,103602,"Fernando Gonzalez",48,22,70,68.57142857142857
2005,103632,"Luis Horna",16,24,40,40
2005,103656,"Albert Montanes",10,19,29,34.48275862068966
2005,103672,"Ricardo Mello",12,23,35,34.285714285714285
2005,103693,"Thierry Ascione",1,5,6,16.666666666666668
2005,103694,"Olivier Rochus",35,25,60,58.333333333333336
2005,103700,"Juan Pablo Guzman",1,2,3,33.333333333333336
2005,103714,"Andreas Vinciguerra",1,1,2,50
2005,103716,"Uros Vico",2,4,6,33.333333333333336
2005,103720,"Lleyton Hewitt",36,9,45,80
2005,103722,"Florent Serra",10,10,20,50
2005,103730,"Jonathan Marray",1,2,3,33.333333333333336
2005,103737,"Edgardo Massa",2,3,5,40
2005,103758,"Taylor Dent",33,21,54,61.111111111111114
2005,103761,"Tomas Cakl",1,3,4,25
2005,103781,"Jurgen Melzer",24,25,49,48.97959183673469
2005,103786,"Nikolay Davydenko",52,29,81,64.19753086419753
2005,103789,"Irakli Labadze",5,11,16,31.25
2005,103808,"Potito Starace",13,20,33,39.39393939393939
2005,103812,"Victor Hanescu",25,22,47,53.191489361702125
2005,103813,"Jarkko Nieminen",29,22,51,56.86274509803921
2005,103817,"Yu Jr Wang",1,1,2,50
2005,103819,"Roger Federer",80,4,84,95.23809523809524
2005,103821,"Danai Udomchoke",2,4,6,33.333333333333336
2005,103823,"Denis Gremelmayr",1,3,4,25
2005,103835,"Filippo Volandri",27,27,54,50
2005,103843,"Marco Chiudinelli",1,2,3,33.333333333333336
2005,103849,"Francesco Aldi",1,4,5,20
2005,103852,"Feliciano Lopez",31,26,57,54.3859649122807
2005,103857,"Igor Kunitsyn",3,2,5,60
2005,103868,"Ivan Navarro",3,1,4,75
2005,103888,"Mardy Fish",6,11,17,35.294117647058826
2005,103898,"Julien Benneteau",5,18,23,21.73913043478261
2005,103900,"David Nalbandian",40,19,59,67.79661016949153
2005,103908,"Paul Henri Mathieu",26,27,53,49.056603773584904
2005,103909,"Guillermo Coria",52,24,76,68.42105263157895
2005,103917,"Nicolas Mahut",1,5,6,16.666666666666668
2005,103967,"Michael Lammer",1,3,4,25
2005,103970,"David Ferrer",43,29,72,59.72222222222222
2005,103971,"Karol Beck",18,26,44,40.90909090909091
2005,103990,"Tommy Robredo",44,25,69,63.768115942028984
2005,104019,"Kristof Vliegen",7,9,16,43.75
2005,104022,"Mikhail Youzhny",23,21,44,52.27272727272727
2005,104025,"Amer Delic",1,4,5,20
2005,104026,"Joachim Johansson",18,14,32,56.25
2005,104035,"Bobby Reynolds",5,8,13,38.46153846153846
2005,104043,"Marc Lopez",2,3,5,40
2005,104053,"Andy Roddick",56,14,70,80
2005,104056,"Roko Karanusic",1,6,7,14.285714285714286
2005,104068,"Robby Ginepri",37,23,60,61.666666666666664
2005,104076,"Jose Acasuso",27,26,53,50.943396226415096
2005,104098,"Dmitry Tursunov",16,16,32,50
2005,104117,"Giovanni Lapentti",6,5,11,54.54545454545455
2005,104154,"Paul Capdeville",1,1,2,50
2005,104160,"Lukas Dlouhy",3,8,11,27.272727272727273
2005,104167,"Todd Widom",1,1,2,50
2005,104180,"Gilles Muller",20,21,41,48.78048780487805
2005,104198,"Guillermo Garcia Lopez",19,26,45,42.22222222222222
2005,104209,"Rainer Eitzinger",1,1,2,50
2005,104214,"Igor Andreev",37,29,66,56.06060606060606
2005,104224,"Travis Rettenmaier",1,1,2,50
2005,104229,"Yen Hsun Lu",3,8,11,27.272727272727273
2005,104230,"Daniel Koellerer",1,2,3,33.333333333333336
2005,104252,"Florian Mayer",21,25,46,45.65217391304348
2005,104259,"Philipp Kohlschreiber",12,25,37,32.432432432432435
2005,104261,"Peng Sun",1,2,3,33.333333333333336
2005,104269,"Fernando Verdasco",34,27,61,55.73770491803279
2005,104312,"Andreas Seppi",17,16,33,51.515151515151516
2005,104330,"Rajeev Ram",2,2,4,50
2005,104338,"Juan Monaco",18,25,43,41.86046511627907
2005,104339,"Mario Ancic",42,23,65,64.61538461538461
2005,104360,"Adam Chadaj",1,1,2,50
2005,104371,"Ivo Minar",11,13,24,45.833333333333336
2005,104386,"Janko Tipsarevic",7,15,22,31.818181818181817
2005,104417,"Robin Soderling",16,18,34,47.05882352941177
2005,104433,"Frank Dancevic",2,6,8,25
2005,104468,"Gilles Simon",6,6,12,50
2005,104495,"Florin Mergea",1,1,2,50
2005,104499,"Jimmy Wang",3,8,11,27.272727272727273
2005,104527,"Stan Wawrinka",14,14,28,50
2005,104548,"Brian Baker",2,3,5,40
2005,104559,"Teymuraz Gabashvili",2,4,6,33.333333333333336
2005,104571,"Marcos Baghdatis",11,12,23,47.82608695652174
2005,104589,"Chris Guccione",3,3,6,50
2005,104592,"Ilija Bozoljac",1,1,2,50
2005,104597,"Nicolas Almagro",13,22,35,37.142857142857146
2005,104607,"Tomas Berdych",32,28,60,53.333333333333336
2005,104660,"Sergiy Stakhovsky",3,3,6,50
2005,104676,"Andreas Beck",1,1,2,50
2005,104745,"Rafael Nadal",77,10,87,88.50574712643679
2005,104755,"Richard Gasquet",30,10,40,75
2005,104792,"Gael Monfils",25,22,47,53.191489361702125
2005,104812,"Scoville Jenkins",2,3,5,40
2005,104918,"Andy Murray",14,9,23,60.869565217391305
2005,104925,"Novak Djokovic",9,9,18,50
2006,101736,"Andre Agassi",10,8,18,55.55555555555556
2006,101868,"Dick Norman",3,9,12,25
2006,101885,"Wayne Arthurs",6,10,16,37.5
2006,101962,"Younes El Aynaoui",2,2,4,50
2006,102035,"Jonas Bjorkman",13,18,31,41.935483870967744
2006,102106,"Davide Sanguinetti",11,25,36,30.555555555555557
2006,102148,"Fabrice Santoro",19,23,42,45.23809523809524
2006,102179,"Antony Dupuis",2,2,4,50
2006,102202,"Kenneth Carlsen",15,18,33,45.45454545454545
2006,102231,"Alex Calatrava",2,3,5,40
2006,102257,"Greg Rusedski",6,15,21,28.571428571428573
2006,102269,"Jeff Salzenstein",1,2,3,33.333333333333336
2006,102287,"Albert Portas",8,12,20,40
2006,102300,"Gouichi Motomura",1,3,4,25
2006,102318,"Andrei Pavel",13,21,34,38.23529411764706
2006,102434,"Vincent Spadea",19,26,45,42.22222222222222
2006,102450,"Tim Henman",31,20,51,60.78431372549019
2006,102494,"Tomas Behrend",4,12,16,25
2006,102548,"Juan Antonio Marin",4,12,16,25
2006,102562,"Jiri Novak",12,13,25,48
2006,102563,"Thomas Johansson",11,16,27,40.74074074074074
2006,102565,"Alexander Waske",8,20,28,28.571428571428573
2006,102567,"George Bastl",5,8,13,38.46153846153846
2006,102610,"Albert Costa",2,2,4,50
2006,102630,"Slimane Saoudi",1,1,2,50
2006,102642,"Cyril Saulnier",4,10,14,28.571428571428573
2006,102667,"Satoshi Iwabuchi",2,3,5,40
2006,102694,"Lars Burgsmuller",4,7,11,36.36363636363637
2006,102703,"Hyung Taik Lee",18,15,33,54.54545454545455
2006,102720,"Tomas Zib",4,20,24,16.666666666666668
2006,102783,"Rainer Schuettler",10,22,32,31.25
2006,102788,"Jan Vacek",1,1,2,50
2006,102811,"Dusan Vemic",3,2,5,60
2006,102834,"Paul Goldstein",16,21,37,43.24324324324324
2006,102839,"Nicolas Lapentti",12,9,21,57.142857142857146
2006,102845,"Carlos Moya",30,22,52,57.69230769230769
2006,102860,"Agustin Calleri",30,19,49,61.224489795918366
2006,102863,"Takao Suzuki",3,1,4,75
2006,102869,"Galo Blanco",1,1,2,50
2006,102882,"Mark Philippoussis",11,9,20,55
2006,102886,"Frantisek Cermak",1,1,2,50
2006,102887,"Ramon Delgado",6,9,15,40
2006,102904,"Leos Friedl",2,1,3,66.66666666666667
2006,102905,"Stefan Koubek",14,9,23,60.869565217391305
2006,102925,"Justin Gimelstob",14,20,34,41.1764705882353
2006,102950,"Fernando Vicente",5,17,22,22.727272727272727
2006,102965,"Jamie Delgado",1,1,2,50
2006,102967,"Marc Gicquel",17,12,29,58.62068965517241
2006,102985,"Gustavo Marcaccio",2,2,4,50
2006,102998,"Jan Michael Gambill",1,1,2,50
2006,102999,"Stefano Galvani",5,8,13,38.46153846153846
2006,103009,"Razvan Sabau",3,15,18,16.666666666666668
2006,103017,"Nicolas Kiefer",16,10,26,61.53846153846154
2006,103018,"Max Mirnyi",21,24,45,46.666666666666664
2006,103029,"Mehdi Tahiri",1,1,2,50
2006,103035,"Alessio Di Mauro",7,15,22,31.818181818181817
2006,103096,"Arnaud Clement",27,20,47,57.4468085106383
2006,103103,"Dominik Hrbaty",31,26,57,54.3859649122807
2006,103105,"Ruben Ramirez Hidalgo",25,20,45,55.55555555555556
2006,103110,"Daniele Bracciali",18,24,42,42.857142857142854
2006,103114,"Martin Lee",1,2,3,33.333333333333336
2006,103151,"Mariano Zabaleta",4,8,12,33.333333333333336
2006,103157,"Arvind Parmar",2,1,3,66.66666666666667
2006,103163,"Tommy Haas",48,19,67,71.64179104477611
2006,103169,"Oscar Hernandez",2,6,8,25
2006,103171,"Raemon Sluiter",8,15,23,34.78260869565217
2006,103174,"Noam Okun",1,2,3,33.333333333333336
2006,103181,"Jiri Vanek",10,17,27,37.03703703703704
2006,103204,"Hugo Armando",1,3,4,25
2006,103206,"Sebastien Grosjean",26,21,47,55.319148936170215
2006,103228,"Marcos Daniel",5,16,21,23.80952380952381
2006,103240,"Kevin Kim",7,18,25,28
2006,103252,"Alberto Martin",18,22,40,45
2006,103285,"Radek Stepanek",30,15,45,66.66666666666667
2006,103292,"Gaston Gaudio",26,22,48,54.166666666666664
2006,103294,"Christophe Rochus",15,26,41,36.58536585365854
2006,103319,"Jeff Morrison",3,3,6,50
2006,103325,"Wesley Moodie",11,19,30,36.666666666666664
2006,103333,"Ivo Karlovic",17,19,36,47.22222222222222
2006,103339,"Wesley Whitehouse",2,3,5,40
2006,103344,"Ivan Ljubicic",58,20,78,74.35897435897436
2006,103369,"Melle Van Gemerden",1,2,3,33.333333333333336
2006,103373,"Sergio Roitman",4,6,10,40
2006,103387,"Paradorn Srichaphan",28,31,59,47.45762711864407
2006,103393,"Yuri Schukin",1,1,2,50
2006,103401,"Jan Hernych",17,20,37,45.945945945945944
2006,103408,"Brian Vahaly",1,1,2,50
2006,103424,"Tobias Clemens",2,2,4,50
2006,103428,"Juan Ignacio Chela",27,26,53,50.943396226415096
2006,103429,"Peter Luczak",5,9,14,35.714285714285715
2006,103444,"Jean Rene Lisnard",1,5,6,16.666666666666668
2006,103451,"Bjorn Phau",16,26,42,38.095238095238095
2006,103454,"Nicolas Massu",37,26,63,58.73015873015873
2006,103470,"Robert Kendrick",4,5,9,44.44444444444444
2006,103484,"James Blake",57,22,79,72.15189873417721
2006,103487,"Federico Luzzi",1,3,4,25
2006,103490,"Santiago Ventura",1,2,3,33.333333333333336
2006,103498,"Marat Safin",33,23,56,58.92857142857143
2006,103503,"Robin Vik",12,27,39,30.76923076923077
2006,103506,"Martin Vassallo Arguello",9,6,15,60
2006,103507,"Juan Carlos Ferrero",28,23,51,54.90196078431372
2006,103516,"Nathan Healey",2,4,6,33.333333333333336
2006,103521,"Andrea Stoppini",2,3,5,40
2006,103523,"Rohan Bopanna",1,3,4,25
2006,103534,"Nicolas Devilder",1,2,3,33.333333333333336
2006,103535,"Olivier Patience",3,8,11,27.272727272727273
2006,103538,"James Auckland",2,1,3,66.66666666666667
2006,103566,"Michael Llodra",4,8,12,33.333333333333336
2006,103573,"Rik De Voest",2,7,9,22.22222222222222
2006,103580,"Alexander Peya",2,4,6,33.333333333333336
2006,103581,"Flavio Saretta",4,10,14,28.571428571428573
2006,103582,"Michael Berrer",4,11,15,26.666666666666668
2006,103594,"Oliver Marach",11,16,27,40.74074074074074
2006,103598,"Xavier Malisse",31,24,55,56.36363636363637
2006,103600,"Mohammad Ghareeb",1,2,3,33.333333333333336
2006,103602,"Fernando Gonzalez",48,21,69,69.56521739130434
2006,103632,"Luis Horna",17,22,39,43.58974358974359
2006,103656,"Albert Montanes",11,18,29,37.93103448275862
2006,103657,"Ivo Klec",1,2,3,33.333333333333336
2006,103672,"Ricardo Mello",2,7,9,22.22222222222222
2006,103675,"Diego Junqueira",2,2,4,50
2006,103693,"Thierry Ascione",3,6,9,33.333333333333336
2006,103694,"Olivier Rochus",30,20,50,60
2006,103700,"Juan Pablo Guzman",2,3,5,40
2006,103701,"Diego Hartfield",2,2,4,50
2006,103702,"Stefano Ianni",1,1,2,50
2006,103709,"Kristian Pless",5,10,15,33.333333333333336
2006,103714,"Andreas Vinciguerra",1,3,4,25
2006,103720,"Lleyton Hewitt",32,14,46,69.56521739130434
2006,103722,"Florent Serra",23,26,49,46.93877551020408
2006,103726,"Jean Christophe Faurel",2,6,8,25
2006,103737,"Edgardo Massa",5,7,12,41.666666666666664
2006,103747,"Dominik Meffert",1,1,2,50
2006,103752,"Simon Greul",11,16,27,40.74074074074074
2006,103758,"Taylor Dent",1,4,5,20
2006,103781,"Jurgen Melzer",33,25,58,56.89655172413793
2006,103786,"Nikolay Davydenko",67,28,95,70.52631578947368
2006,103789,"Irakli Labadze",3,1,4,75
2006,103794,"Benjamin Becker",9,8,17,52.94117647058823
2006,103808,"Potito Starace",13,17,30,43.333333333333336
2006,103813,"Jarkko Nieminen",49,27,76,64.47368421052632
2006,103819,"Roger Federer",90,5,95,94.73684210526316
2006,103821,"Danai Udomchoke",6,12,18,33.333333333333336
2006,103823,"Denis Gremelmayr",9,9,18,50
2006,103835,"Filippo Volandri",31,26,57,54.3859649122807
2006,103843,"Marco Chiudinelli",4,5,9,44.44444444444444
2006,103852,"Feliciano Lopez",19,29,48,39.583333333333336
2006,103857,"Igor Kunitsyn",10,15,25,40
2006,103868,"Ivan Navarro",2,7,9,22.22222222222222
2006,103888,"Mardy Fish",23,18,41,56.09756097560975
2006,103894,"Phillip King",1,1,2,50
2006,103898,"Julien Benneteau",24,22,46,52.17391304347826
2006,103900,"David Nalbandian",39,18,57,68.42105263157895
2006,103908,"Paul Henri Mathieu",23,28,51,45.09803921568628
2006,103909,"Guillermo Coria",11,14,25,44
2006,103917,"Nicolas Mahut",11,19,30,36.666666666666664
2006,103970,"David Ferrer",39,25,64,60.9375
2006,103990,"Tommy Robredo",49,26,75,65.33333333333333
2006,103997,"Lukasz Kubot",3,7,10,30
2006,103999,"Thiago Alves",3,3,6,50
2006,104001,"Brian Wilson",1,1,2,50
2006,104003,"Victor Crivoi",1,1,2,50
2006,104007,"Andre Ghem",1,1,2,50
2006,104010,"Dieter Kindlmann",1,3,4,25
2006,104019,"Kristof Vliegen",31,22,53,58.490566037735846
2006,104022,"Mikhail Youzhny",23,22,45,51.111111111111114
2006,104025,"Amer Delic",1,3,4,25
2006,104026,"Joachim Johansson",5,3,8,62.5
2006,104035,"Bobby Reynolds",1,11,12,8.333333333333334
2006,104053,"Andy Roddick",46,18,64,71.875
2006,104056,"Roko Karanusic",1,4,5,20
2006,104068,"Robby Ginepri",24,26,50,48
2006,104076,"Jose Acasuso",30,20,50,60
2006,104081,"Boris Pashanski",10,23,33,30.303030303030305
2006,104098,"Dmitry Tursunov",42,31,73,57.534246575342465
2006,104112,"Benjamin Balleret",3,2,5,60
2006,104122,"Carlos Berlocq",5,17,22,22.727272727272727
2006,104154,"Paul Capdeville",7,11,18,38.888888888888886
2006,104160,"Lukas Dlouhy",7,22,29,24.137931034482758
2006,104166,"Alex Bogomolov Jr",2,2,4,50
2006,104167,"Todd Widom",1,1,2,50
2006,104171,"Richard Bloomfield",1,2,3,33.333333333333336
2006,104173,"Sam Warburg",1,2,3,33.333333333333336
2006,104180,"Gilles Muller",11,20,31,35.483870967741936
2006,104196,"Carlos Cuadrado",3,2,5,60
2006,104198,"Guillermo Garcia Lopez",15,20,35,42.857142857142854
2006,104209,"Rainer Eitzinger",1,2,3,33.333333333333336
2006,104214,"Igor Andreev",13,13,26,50
2006,104224,"Travis Rettenmaier",1,1,2,50
2006,104225,"Jan Hajek",2,4,6,33.333333333333336
2006,104229,"Yen Hsun Lu",2,7,9,22.22222222222222
2006,104250,"Prakash Amritraj",1,2,3,33.333333333333336
2006,104252,"Florian Mayer",24,21,45,53.333333333333336
2006,104259,"Philipp Kohlschreiber",24,21,45,53.333333333333336
2006,104268,"Alejandro Falla",4,8,12,33.333333333333336
2006,104269,"Fernando Verdasco",32,26,58,55.172413793103445
2006,104305,"Luka Gregorc",1,1,2,50
2006,104308,"Michal Przysiezny",2,2,4,50
2006,104312,"Andreas Seppi",19,28,47,40.42553191489362
2006,104338,"Juan Monaco",18,23,41,43.90243902439025
2006,104339,"Mario Ancic",54,18,72,75
2006,104371,"Ivo Minar",1,14,15,6.666666666666667
2006,104372,"Alex Bogdanovic",3,5,8,37.5
2006,104386,"Janko Tipsarevic",8,17,25,32
2006,104417,"Robin Soderling",33,22,55,60
2006,104433,"Frank Dancevic",6,9,15,40
2006,104468,"Gilles Simon",24,24,48,50
2006,104477,"Jorge Aguilar",1,1,2,50
2006,104499,"Jimmy Wang",7,15,22,31.818181818181817
2006,104505,"Konstantin Kravchuk",1,1,2,50
2006,104515,"Mathieu Montcourt",1,1,2,50
2006,104523,"Frederico Gil",2,1,3,66.66666666666667
2006,104527,"Stan Wawrinka",31,23,54,57.407407407407405
2006,104559,"Teymuraz Gabashvili",6,12,18,33.333333333333336
2006,104571,"Marcos Baghdatis",33,20,53,62.264150943396224
2006,104589,"Chris Guccione",1,3,4,25
2006,104592,"Ilija Bozoljac",3,2,5,60
2006,104593,"Daniel Gimeno Traver",2,4,6,33.333333333333336
2006,104597,"Nicolas Almagro",27,20,47,57.4468085106383
2006,104607,"Tomas Berdych",45,24,69,65.21739130434783
2006,104660,"Sergiy Stakhovsky",1,2,3,33.333333333333336
2006,104678,"Viktor Troicki",1,1,2,50
2006,104745,"Rafael Nadal",58,12,70,82.85714285714286
2006,104755,"Richard Gasquet",33,20,53,62.264150943396224
2006,104760,"Scott Oudsema",1,2,3,33.333333333333336
2006,104783,"Mikhail Ledovskikh",1,3,4,25
2006,104792,"Gael Monfils",20,19,39,51.282051282051285
2006,104812,"Scoville Jenkins",1,4,5,20
2006,104851,"Gianluca Naso",1,1,2,50
2006,104871,"Jeremy Chardy",2,2,4,50
2006,104890,"Andreas Haider Maurer",1,1,2,50
2006,104918,"Andy Murray",37,25,62,59.67741935483871
2006,104925,"Novak Djokovic",35,17,52,67.3076923076923
2006,104926,"Fabio Fognini",2,5,7,28.571428571428573
2006,104976,"Ryan Sweeting",2,3,5,40
2006,104999,"Mischa Zverev",3,3,6,50
2006,105023,"Sam Querrey",6,11,17,35.294117647058826
2006,105095,"Evgeny Korolev",8,8,16,50
2006,105208,"Ernests Gulbis",3,1,4,75
2006,105217,"Thiemo De Bakker",1,1,2,50
2006,105223,"Juan Martin del Potro",10,12,22,45.45454545454545
2006,105227,"Marin Cilic",5,9,14,35.714285714285715
2007,101868,"Dick Norman",3,1,4,75
2007,101885,"Wayne Arthurs",4,2,6,66.66666666666667
2007,101962,"Younes El Aynaoui",1,3,4,25
2007,102035,"Jonas Bjorkman",17,21,38,44.73684210526316
2007,102106,"Davide Sanguinetti",5,8,13,38.46153846153846
2007,102148,"Fabrice Santoro",24,19,43,55.81395348837209
2007,102179,"Antony Dupuis",4,2,6,66.66666666666667
2007,102287,"Albert Portas",2,3,5,40
2007,102318,"Andrei Pavel",12,13,25,48
2007,102381,"Werner Eschauer",7,13,20,35
2007,102434,"Vincent Spadea",24,28,52,46.15384615384615
2007,102450,"Tim Henman",4,12,16,25
2007,102456,"Felix Mantilla",1,3,4,25
2007,102539,"Bohdan Ulihrach",1,2,3,33.333333333333336
2007,102563,"Thomas Johansson",24,23,47,51.06382978723404
2007,102565,"Alexander Waske",2,8,10,20
2007,102567,"George Bastl",1,4,5,20
2007,102615,"Dennis Van Scheppingen",1,1,2,50
2007,102630,"Slimane Saoudi",1,1,2,50
2007,102642,"Cyril Saulnier",1,1,2,50
2007,102703,"Hyung Taik Lee",21,23,44,47.72727272727273
2007,102720,"Tomas Zib",3,4,7,42.857142857142854
2007,102783,"Rainer Schuettler",7,13,20,35
2007,102788,"Jan Vacek",1,1,2,50
2007,102811,"Dusan Vemic",1,5,6,16.666666666666668
2007,102834,"Paul Goldstein",9,13,22,40.90909090909091
2007,102839,"Nicolas Lapentti",10,14,24,41.666666666666664
2007,102845,"Carlos Moya",42,23,65,64.61538461538461
2007,102856,"Gustavo Kuerten",2,7,9,22.22222222222222
2007,102860,"Agustin Calleri",24,25,49,48.97959183673469
2007,102905,"Stefan Koubek",22,26,48,45.833333333333336
2007,102925,"Justin Gimelstob",1,12,13,7.6923076923076925
2007,102967,"Marc Gicquel",21,25,46,45.65217391304348
2007,102999,"Stefano Galvani",3,8,11,27.272727272727273
2007,103017,"Nicolas Kiefer",19,12,31,61.29032258064516
2007,103018,"Max Mirnyi",9,18,27,33.333333333333336
2007,103035,"Alessio Di Mauro",5,10,15,33.333333333333336
2007,103077,"Konstantinos Economidis",1,7,8,12.5
2007,103084,"Guillermo Canas",38,21,59,64.40677966101696
2007,103096,"Arnaud Clement",23,26,49,46.93877551020408
2007,103103,"Dominik Hrbaty",9,21,30,30
2007,103104,"Bjorn Rehnquist",1,1,2,50
2007,103105,"Ruben Ramirez Hidalgo",9,18,27,33.333333333333336
2007,103110,"Daniele Bracciali",6,14,20,30
2007,103151,"Mariano Zabaleta",9,11,20,45
2007,103163,"Tommy Haas",36,17,53,67.9245283018868
2007,103169,"Oscar Hernandez",9,18,27,33.333333333333336
2007,103171,"Raemon Sluiter",3,4,7,42.857142857142854
2007,103175,"Toshihide Matsui",1,1,2,50
2007,103181,"Jiri Vanek",7,13,20,35
2007,103188,"Michael Russell",10,19,29,34.48275862068966
2007,103193,"Peter Wessels",4,2,6,66.66666666666667
2007,103204,"Hugo Armando",2,3,5,40
2007,103206,"Sebastien Grosjean",19,18,37,51.351351351351354
2007,103240,"Kevin Kim",3,14,17,17.647058823529413
2007,103252,"Alberto Martin",5,12,17,29.41176470588235
2007,103254,"Yves Allegro",1,1,2,50
2007,103285,"Radek Stepanek",27,21,48,56.25
2007,103292,"Gaston Gaudio",6,15,21,28.571428571428573
2007,103294,"Christophe Rochus",2,9,11,18.181818181818183
2007,103325,"Wesley Moodie",7,9,16,43.75
2007,103333,"Ivo Karlovic",45,21,66,68.18181818181819
2007,103339,"Wesley Whitehouse",1,2,3,33.333333333333336
2007,103344,"Ivan Ljubicic",43,22,65,66.15384615384616
2007,103373,"Sergio Roitman",11,25,36,30.555555555555557
2007,103387,"Paradorn Srichaphan",1,5,6,16.666666666666668
2007,103393,"Yuri Schukin",4,3,7,57.142857142857146
2007,103401,"Jan Hernych",7,15,22,31.818181818181817
2007,103428,"Juan Ignacio Chela",40,25,65,61.53846153846154
2007,103429,"Peter Luczak",3,7,10,30
2007,103451,"Bjorn Phau",4,10,14,28.571428571428573
2007,103454,"Nicolas Massu",17,23,40,42.5
2007,103470,"Robert Kendrick",5,18,23,21.73913043478261
2007,103484,"James Blake",50,23,73,68.4931506849315
2007,103487,"Federico Luzzi",1,4,5,20
2007,103490,"Santiago Ventura",4,2,6,66.66666666666667
2007,103498,"Marat Safin",21,19,40,52.5
2007,103506,"Martin Vassallo Arguello",14,20,34,41.1764705882353
2007,103507,"Juan Carlos Ferrero",34,23,57,59.64912280701754
2007,103516,"Nathan Healey",2,4,6,33.333333333333336
2007,103529,"Aisam Ul Haq Qureshi",4,4,8,50
2007,103530,"Zack Fleishman",4,6,10,40
2007,103534,"Nicolas Devilder",10,15,25,40
2007,103535,"Olivier Patience",6,8,14,42.857142857142854
2007,103553,"Alun Jones",2,3,5,40
2007,103566,"Michael Llodra",13,18,31,41.935483870967744
2007,103573,"Rik De Voest",3,4,7,42.857142857142854
2007,103580,"Alexander Peya",5,13,18,27.77777777777778
2007,103581,"Flavio Saretta",5,2,7,71.42857142857143
2007,103582,"Michael Berrer",13,12,25,52
2007,103594,"Oliver Marach",1,4,5,20
2007,103598,"Xavier Malisse",10,4,14,71.42857142857143
2007,103602,"Fernando Gonzalez",35,22,57,61.40350877192982
2007,103632,"Luis Horna",17,16,33,51.515151515151516
2007,103656,"Albert Montanes",24,24,48,50
2007,103672,"Ricardo Mello",4,5,9,44.44444444444444
2007,103693,"Thierry Ascione",3,4,7,42.857142857142854
2007,103694,"Olivier Rochus",18,25,43,41.86046511627907
2007,103700,"Juan Pablo Guzman",2,8,10,20
2007,103701,"Diego Hartfield",14,20,34,41.1764705882353
2007,103709,"Kristian Pless",5,16,21,23.80952380952381
2007,103720,"Lleyton Hewitt",34,15,49,69.38775510204081
2007,103722,"Florent Serra",16,24,40,40
2007,103747,"Dominik Meffert",2,2,4,50
2007,103752,"Simon Greul",2,10,12,16.666666666666668
2007,103761,"Tomas Cakl",1,2,3,33.333333333333336
2007,103781,"Jurgen Melzer",21,24,45,46.666666666666664
2007,103786,"Nikolay Davydenko",53,30,83,63.855421686746986
2007,103794,"Benjamin Becker",21,30,51,41.1764705882353
2007,103808,"Potito Starace",25,25,50,50
2007,103812,"Victor Hanescu",7,7,14,50
2007,103813,"Jarkko Nieminen",31,26,57,54.3859649122807
2007,103819,"Roger Federer",67,9,76,88.15789473684211
2007,103821,"Danai Udomchoke",7,19,26,26.923076923076923
2007,103835,"Filippo Volandri",20,25,45,44.44444444444444
2007,103843,"Marco Chiudinelli",1,3,4,25
2007,103852,"Feliciano Lopez",27,24,51,52.94117647058823
2007,103857,"Igor Kunitsyn",16,24,40,40
2007,103868,"Ivan Navarro",10,12,22,45.45454545454545
2007,103888,"Mardy Fish",24,23,47,51.06382978723404
2007,103893,"Paolo Lorenzi",1,1,2,50
2007,103898,"Julien Benneteau",22,28,50,44
2007,103900,"David Nalbandian",31,17,48,64.58333333333333
2007,103908,"Paul Henri Mathieu",45,23,68,66.17647058823529
2007,103917,"Nicolas Mahut",22,20,42,52.38095238095238
2007,103970,"David Ferrer",60,22,82,73.17073170731707
2007,103976,"Juan Pablo Brzezicki",2,4,6,33.333333333333336
2007,103990,"Tommy Robredo",48,25,73,65.75342465753425
2007,103999,"Thiago Alves",1,6,7,14.285714285714286
2007,104004,"Filip Prpic",1,2,3,33.333333333333336
2007,104019,"Kristof Vliegen",13,26,39,33.333333333333336
2007,104022,"Mikhail Youzhny",48,24,72,66.66666666666667
2007,104025,"Amer Delic",9,24,33,27.272727272727273
2007,104026,"Joachim Johansson",4,4,8,50
2007,104053,"Andy Roddick",48,16,64,75
2007,104056,"Roko Karanusic",2,6,8,25
2007,104068,"Robby Ginepri",11,20,31,35.483870967741936
2007,104076,"Jose Acasuso",21,19,40,52.5
2007,104081,"Boris Pashanski",9,10,19,47.36842105263158
2007,104098,"Dmitry Tursunov",28,21,49,57.142857142857146
2007,104121,"Tobias Summerer",1,2,3,33.333333333333336
2007,104122,"Carlos Berlocq",11,15,26,42.30769230769231
2007,104154,"Paul Capdeville",12,12,24,50
2007,104160,"Lukas Dlouhy",7,14,21,33.333333333333336
2007,104173,"Sam Warburg",1,2,3,33.333333333333336
2007,104180,"Gilles Muller",2,3,5,40
2007,104198,"Guillermo Garcia Lopez",13,22,35,37.142857142857146
2007,104209,"Rainer Eitzinger",1,1,2,50
2007,104214,"Igor Andreev",31,26,57,54.3859649122807
2007,104217,"Simon Stadler",2,3,5,40
2007,104225,"Jan Hajek",5,14,19,26.31578947368421
2007,104227,"Augustin Gensse",1,1,2,50
2007,104229,"Yen Hsun Lu",6,14,20,30
2007,104230,"Daniel Koellerer",1,1,2,50
2007,104250,"Prakash Amritraj",2,2,4,50
2007,104252,"Florian Mayer",18,25,43,41.86046511627907
2007,104259,"Philipp Kohlschreiber",31,25,56,55.357142857142854
2007,104262,"Flavio Cipolla",1,1,2,50
2007,104268,"Alejandro Falla",12,16,28,42.857142857142854
2007,104269,"Fernando Verdasco",33,26,59,55.932203389830505
2007,104273,"Edouard Roger Vasselin",5,7,12,41.666666666666664
2007,104305,"Luka Gregorc",1,1,2,50
2007,104308,"Michal Przysiezny",1,3,4,25
2007,104312,"Andreas Seppi",20,23,43,46.51162790697674
2007,104327,"Steve Darcis",6,2,8,75
2007,104332,"Philipp Petzschner",1,1,2,50
2007,104338,"Juan Monaco",41,19,60,68.33333333333333
2007,104339,"Mario Ancic",13,10,23,56.52173913043478
2007,104371,"Ivo Minar",1,3,4,25
2007,104372,"Alex Bogdanovic",2,8,10,20
2007,104386,"Janko Tipsarevic",17,21,38,44.73684210526316
2007,104397,"Laurent Recouderc",2,2,4,50
2007,104417,"Robin Soderling",24,16,40,60
2007,104433,"Frank Dancevic",16,18,34,47.05882352941177
2007,104453,"Michael Ryderstedt",1,2,3,33.333333333333336
2007,104468,"Gilles Simon",35,26,61,57.377049180327866
2007,104499,"Jimmy Wang",3,2,5,60
2007,104515,"Mathieu Montcourt",2,4,6,33.333333333333336
2007,104523,"Frederico Gil",1,2,3,33.333333333333336
2007,104527,"Stan Wawrinka",21,22,43,48.83720930232558
2007,104534,"Dudi Sela",5,4,9,55.55555555555556
2007,104542,"Jo-Wilfried Tsonga",14,10,24,58.333333333333336
2007,104545,"John Isner",8,5,13,61.53846153846154
2007,104559,"Teymuraz Gabashvili",10,28,38,26.31578947368421
2007,104571,"Marcos Baghdatis",44,22,66,66.66666666666667
2007,104589,"Chris Guccione",8,15,23,34.78260869565217
2007,104592,"Ilija Bozoljac",1,5,6,16.666666666666668
2007,104597,"Nicolas Almagro",34,27,61,55.73770491803279
2007,104607,"Tomas Berdych",45,22,67,67.16417910447761
2007,104620,"Simone Bolelli",8,14,22,36.36363636363637
2007,104635,"Robert Smeets",1,2,3,33.333333333333336
2007,104639,"Wayne Odesnik",4,3,7,57.142857142857146
2007,104665,"Pablo Andujar",3,4,7,42.857142857142854
2007,104678,"Viktor Troicki",5,7,12,41.666666666666664
2007,104707,"Denis Matsukevitch",1,2,3,33.333333333333336
2007,104719,"Marcel Granollers",2,2,4,50
2007,104745,"Rafael Nadal",71,15,86,82.55813953488372
2007,104755,"Richard Gasquet",47,24,71,66.19718309859155
2007,104779,"Jamie Baker",1,3,4,25
2007,104783,"Mikhail Ledovskikh",1,2,3,33.333333333333336
2007,104792,"Gael Monfils",21,21,42,50
2007,104812,"Scoville Jenkins",2,4,6,33.333333333333336
2007,104816,"Karan Rastogi",1,1,2,50
2007,104864,"Alex Kuznetsov",4,8,12,33.333333333333336
2007,104897,"Matthias Bachinger",1,1,2,50
2007,104898,"Robin Haase",10,11,21,47.61904761904762
2007,104918,"Andy Murray",40,14,54,74.07407407407408
2007,104925,"Novak Djokovic",65,19,84,77.38095238095238
2007,104926,"Fabio Fognini",5,7,12,41.666666666666664
2007,104976,"Ryan Sweeting",2,5,7,28.571428571428573
2007,104978,"Daniel Brands",1,1,2,50
2007,104979,"Andrey Golubev",1,1,2,50
2007,104999,"Mischa Zverev",6,8,14,42.857142857142854
2007,105023,"Sam Querrey",19,22,41,46.34146341463415
2007,105028,"Jesse Levine",2,3,5,40
2007,105095,"Evgeny Korolev",20,24,44,45.45454545454545
2007,105137,"Pere Riba",1,1,2,50
2007,105194,"Nick Lindahl",1,1,2,50
2007,105208,"Ernests Gulbis",6,14,20,30
2007,105217,"Thiemo De Bakker",1,4,5,20
2007,105223,"Juan Martin del Potro",26,24,50,52
2007,105227,"Marin Cilic",12,12,24,50
2007,105373,"Martin Klizan",1,1,2,50
2007,105385,"Donald Young",3,3,6,50
2007,105453,"Kei Nishikori",3,5,8,37.5
2008,101962,"Younes El Aynaoui",5,2,7,71.42857142857143
2008,102035,"Jonas Bjorkman",7,13,20,35
2008,102148,"Fabrice Santoro",18,17,35,51.42857142857143
2008,102381,"Werner Eschauer",1,10,11,9.090909090909092
2008,102434,"Vincent Spadea",13,19,32,40.625
2008,102512,"Joseph Sirianni",6,8,14,42.857142857142854
2008,102563,"Thomas Johansson",14,20,34,41.1764705882353
2008,102567,"George Bastl",1,4,5,20
2008,102703,"Hyung Taik Lee",9,17,26,34.61538461538461
2008,102783,"Rainer Schuettler",21,23,44,47.72727272727273
2008,102788,"Jan Vacek",1,1,2,50
2008,102811,"Dusan Vemic",1,2,3,33.333333333333336
2008,102821,"Cecil Mamiit",1,1,2,50
2008,102839,"Nicolas Lapentti",14,18,32,43.75
2008,102845,"Carlos Moya",28,23,51,54.90196078431372
2008,102860,"Agustin Calleri",21,22,43,48.83720930232558
2008,102863,"Takao Suzuki",2,1,3,66.66666666666667
2008,102905,"Stefan Koubek",3,6,9,33.333333333333336
2008,102967,"Marc Gicquel",21,24,45,46.666666666666664
2008,102999,"Stefano Galvani",1,1,2,50
2008,103017,"Nicolas Kiefer",22,19,41,53.65853658536585
2008,103018,"Max Mirnyi",2,6,8,25
2008,103084,"Guillermo Canas",22,23,45,48.888888888888886
2008,103096,"Arnaud Clement",10,17,27,37.03703703703704
2008,103103,"Dominik Hrbaty",4,8,12,33.333333333333336
2008,103104,"Bjorn Rehnquist",2,2,4,50
2008,103105,"Ruben Ramirez Hidalgo",1,6,7,14.285714285714286
2008,103163,"Tommy Haas",18,15,33,54.54545454545455
2008,103169,"Oscar Hernandez",19,21,40,47.5
2008,103181,"Jiri Vanek",7,16,23,30.434782608695652
2008,103188,"Michael Russell",3,5,8,37.5
2008,103204,"Hugo Armando",1,1,2,50
2008,103206,"Sebastien Grosjean",7,15,22,31.818181818181817
2008,103228,"Marcos Daniel",6,15,21,28.571428571428573
2008,103238,"Jean Claude Scherrer",1,1,2,50
2008,103252,"Alberto Martin",2,6,8,25
2008,103285,"Radek Stepanek",31,24,55,56.36363636363637
2008,103294,"Christophe Rochus",5,7,12,41.666666666666664
2008,103333,"Ivo Karlovic",29,25,54,53.7037037037037
2008,103344,"Ivan Ljubicic",20,19,39,51.282051282051285
2008,103373,"Sergio Roitman",7,18,25,28
2008,103393,"Yuri Schukin",2,7,9,22.22222222222222
2008,103395,"Julio Silva",1,1,2,50
2008,103401,"Jan Hernych",4,8,12,33.333333333333336
2008,103428,"Juan Ignacio Chela",14,12,26,53.84615384615385
2008,103429,"Peter Luczak",5,11,16,31.25
2008,103435,"Massimo Dellacqua",1,1,2,50
2008,103448,"Gabriel Trujillo Soler",1,1,2,50
2008,103451,"Bjorn Phau",3,4,7,42.857142857142854
2008,103454,"Nicolas Massu",7,12,19,36.8421052631579
2008,103470,"Robert Kendrick",3,9,12,25
2008,103484,"James Blake",45,24,69,65.21739130434783
2008,103490,"Santiago Ventura",8,16,24,33.333333333333336
2008,103498,"Marat Safin",24,23,47,51.06382978723404
2008,103506,"Martin Vassallo Arguello",5,13,18,27.77777777777778
2008,103507,"Juan Carlos Ferrero",21,15,36,58.333333333333336
2008,103521,"Andrea Stoppini",1,2,3,33.333333333333336
2008,103523,"Rohan Bopanna",3,2,5,60
2008,103529,"Aisam Ul Haq Qureshi",1,4,5,20
2008,103534,"Nicolas Devilder",4,11,15,26.666666666666668
2008,103535,"Olivier Patience",3,10,13,23.076923076923077
2008,103543,"David Marrero",2,4,6,33.333333333333336
2008,103553,"Alun Jones",1,3,4,25
2008,103566,"Michael Llodra",22,20,42,52.38095238095238
2008,103573,"Rik De Voest",3,7,10,30
2008,103580,"Alexander Peya",3,5,8,37.5
2008,103582,"Michael Berrer",8,20,28,28.571428571428573
2008,103598,"Xavier Malisse",8,12,20,40
2008,103602,"Fernando Gonzalez",37,16,53,69.81132075471699
2008,103632,"Luis Horna",8,16,24,33.333333333333336
2008,103656,"Albert Montanes",24,23,47,51.06382978723404
2008,103675,"Diego Junqueira",1,2,3,33.333333333333336
2008,103693,"Thierry Ascione",1,9,10,10
2008,103694,"Olivier Rochus",13,25,38,34.21052631578947
2008,103701,"Diego Hartfield",2,7,9,22.22222222222222
2008,103720,"Lleyton Hewitt",18,11,29,62.06896551724138
2008,103722,"Florent Serra",20,24,44,45.45454545454545
2008,103735,"Lovro Zovko",2,2,4,50
2008,103747,"Dominik Meffert",1,1,2,50
2008,103763,"Martin Slanar",1,2,3,33.333333333333336
2008,103781,"Jurgen Melzer",29,24,53,54.716981132075475
2008,103786,"Nikolay Davydenko",52,21,73,71.23287671232876
2008,103794,"Benjamin Becker",11,20,31,35.483870967741936
2008,103808,"Potito Starace",18,25,43,41.86046511627907
2008,103812,"Victor Hanescu",21,22,43,48.83720930232558
2008,103813,"Jarkko Nieminen",24,27,51,47.05882352941177
2008,103819,"Roger Federer",66,16,82,80.48780487804878
2008,103823,"Denis Gremelmayr",15,21,36,41.666666666666664
2008,103835,"Filippo Volandri",10,20,30,33.333333333333336
2008,103850,"Sebastian Decoud",2,2,4,50
2008,103852,"Feliciano Lopez",25,25,50,50
2008,103857,"Igor Kunitsyn",15,14,29,51.724137931034484
2008,103862,"Michail Elgin",2,2,4,50
2008,103868,"Ivan Navarro",7,14,21,33.333333333333336
2008,103888,"Mardy Fish",32,23,55,58.18181818181818
2008,103898,"Julien Benneteau",22,20,42,52.38095238095238
2008,103900,"David Nalbandian",39,15,54,72.22222222222223
2008,103908,"Paul Henri Mathieu",32,26,58,55.172413793103445
2008,103909,"Guillermo Coria",2,8,10,20
2008,103917,"Nicolas Mahut",16,26,42,38.095238095238095
2008,103970,"David Ferrer",42,22,64,65.625
2008,103976,"Juan Pablo Brzezicki",3,7,10,30
2008,103990,"Tommy Robredo",35,23,58,60.3448275862069
2008,103999,"Thiago Alves",1,1,2,50
2008,104003,"Victor Crivoi",1,3,4,25
2008,104019,"Kristof Vliegen",7,16,23,30.434782608695652
2008,104022,"Mikhail Youzhny",27,22,49,55.10204081632653
2008,104025,"Amer Delic",8,7,15,53.333333333333336
2008,104026,"Joachim Johansson",1,1,2,50
2008,104035,"Bobby Reynolds",13,19,32,40.625
2008,104043,"Marc Lopez",1,3,4,25
2008,104053,"Andy Roddick",47,16,63,74.60317460317461
2008,104056,"Roko Karanusic",7,12,19,36.8421052631579
2008,104068,"Robby Ginepri",25,20,45,55.55555555555556
2008,104076,"Jose Acasuso",26,24,50,52
2008,104081,"Boris Pashanski",4,12,16,25
2008,104091,"Miguel Angel Lopez Jaen",1,2,3,33.333333333333336
2008,104098,"Dmitry Tursunov",36,22,58,62.06896551724138
2008,104122,"Carlos Berlocq",3,16,19,15.789473684210526
2008,104149,"Adrian Cruciat",1,2,3,33.333333333333336
2008,104154,"Paul Capdeville",6,13,19,31.57894736842105
2008,104160,"Lukas Dlouhy",1,4,5,20
2008,104173,"Sam Warburg",3,6,9,33.333333333333336
2008,104180,"Gilles Muller",5,6,11,45.45454545454545
2008,104198,"Guillermo Garcia Lopez",22,22,44,50
2008,104214,"Igor Andreev",43,29,72,59.72222222222222
2008,104216,"Maximo Gonzalez",4,5,9,44.44444444444444
2008,104217,"Simon Stadler",4,4,8,50
2008,104219,"Stephane Bohli",2,4,6,33.333333333333336
2008,104229,"Yen Hsun Lu",9,14,23,39.130434782608695
2008,104230,"Daniel Koellerer",1,2,3,33.333333333333336
2008,104250,"Prakash Amritraj",4,2,6,66.66666666666667
2008,104252,"Florian Mayer",2,9,11,18.181818181818183
2008,104259,"Philipp Kohlschreiber",31,20,51,60.78431372549019
2008,104262,"Flavio Cipolla",6,7,13,46.15384615384615
2008,104268,"Alejandro Falla",6,11,17,35.294117647058826
2008,104269,"Fernando Verdasco",45,27,72,62.5
2008,104273,"Edouard Roger Vasselin",2,6,8,25
2008,104281,"Ryler Deheart",1,1,2,50
2008,104305,"Luka Gregorc",4,3,7,57.142857142857146
2008,104312,"Andreas Seppi",28,28,56,50
2008,104314,"Brian Dabul",3,4,7,42.857142857142854
2008,104327,"Steve Darcis",20,20,40,50
2008,104330,"Rajeev Ram",2,4,6,33.333333333333336
2008,104332,"Philipp Petzschner",10,9,19,52.63157894736842
2008,104338,"Juan Monaco",27,21,48,56.25
2008,104339,"Mario Ancic",29,17,46,63.04347826086956
2008,104349,"Rui Machado",2,2,4,50
2008,104371,"Ivo Minar",14,23,37,37.83783783783784
2008,104372,"Alex Bogdanovic",1,3,4,25
2008,104386,"Janko Tipsarevic",25,22,47,53.191489361702125
2008,104417,"Robin Soderling",44,20,64,68.75
2008,104424,"Go Soeda",1,3,4,25
2008,104433,"Frank Dancevic",6,11,17,35.294117647058826
2008,104453,"Michael Ryderstedt",1,1,2,50
2008,104467,"Lamine Ouahab",1,1,2,50
2008,104468,"Gilles Simon",52,27,79,65.82278481012658
2008,104500,"Somdev Devvarman",2,2,4,50
2008,104515,"Mathieu Montcourt",1,4,5,20
2008,104523,"Frederico Gil",2,4,6,33.333333333333336
2008,104527,"Stan Wawrinka",34,21,55,61.81818181818182
2008,104534,"Dudi Sela",14,22,36,38.888888888888886
2008,104542,"Jo-Wilfried Tsonga",33,15,48,68.75
2008,104545,"John Isner",11,19,30,36.666666666666664
2008,104559,"Teymuraz Gabashvili",13,13,26,50
2008,104571,"Marcos Baghdatis",12,12,24,50
2008,104579,"Romain Jouan",1,1,2,50
2008,104586,"Lukas Rosol",1,2,3,33.333333333333336
2008,104589,"Chris Guccione",11,18,29,37.93103448275862
2008,104592,"Ilija Bozoljac",1,1,2,50
2008,104593,"Daniel Gimeno Traver",7,7,14,50
2008,104597,"Nicolas Almagro",34,17,51,66.66666666666667
2008,104607,"Tomas Berdych",34,20,54,62.96296296296296
2008,104619,"Jesse Huta Galung",1,4,5,20
2008,104620,"Simone Bolelli",28,29,57,49.12280701754386
2008,104628,"Alexander Kudryavtsev",2,6,8,25
2008,104639,"Wayne Odesnik",14,16,30,46.666666666666664
2008,104655,"Pablo Cuevas",8,13,21,38.095238095238095
2008,104660,"Sergiy Stakhovsky",5,4,9,55.55555555555556
2008,104665,"Pablo Andujar",3,6,9,33.333333333333336
2008,104676,"Andreas Beck",5,7,12,41.666666666666664
2008,104678,"Viktor Troicki",19,19,38,50
2008,104717,"Brendan Evans",2,4,6,33.333333333333336
2008,104719,"Marcel Granollers",15,20,35,42.857142857142854
2008,104721,"Josselin Ouanna",2,5,7,28.571428571428573
2008,104724,"Eduardo Schwank",15,15,30,50
2008,104731,"Kevin Anderson",8,9,17,47.05882352941177
2008,104745,"Rafael Nadal",79,11,90,87.77777777777777
2008,104753,"Woong Sun Jun",1,4,5,20
2008,104755,"Richard Gasquet",31,21,52,59.61538461538461
2008,104763,"Rafael Arevalo",1,1,2,50
2008,104783,"Mikhail Ledovskikh",2,3,5,40
2008,104792,"Gael Monfils",30,17,47,63.829787234042556
2008,104797,"Denis Istomin",2,2,4,50
2008,104851,"Gianluca Naso",1,6,7,14.285714285714286
2008,104871,"Jeremy Chardy",10,9,19,52.63157894736842
2008,104882,"Blaz Kavcic",1,2,3,33.333333333333336
2008,104898,"Robin Haase",12,13,25,48
2008,104914,"Ervin Eleskovic",1,1,2,50
2008,104918,"Andy Murray",56,17,73,76.71232876712328
2008,104919,"Leonardo Mayer",1,1,2,50
2008,104925,"Novak Djokovic",63,16,79,79.74683544303798
2008,104926,"Fabio Fognini",16,17,33,48.484848484848484
2008,104976,"Ryan Sweeting",1,2,3,33.333333333333336
2008,104978,"Daniel Brands",1,4,5,20
2008,104979,"Andrey Golubev",5,5,10,50
2008,104999,"Mischa Zverev",18,23,41,43.90243902439025
2008,105023,"Sam Querrey",28,24,52,53.84615384615385
2008,105028,"Jesse Levine",8,17,25,32
2008,105032,"Sam Groth",1,1,2,50
2008,105052,"Chris Eaton",1,1,2,50
2008,105053,"Santiago Giraldo",2,7,9,22.22222222222222
2008,105062,"Mikhail Kukushkin",3,4,7,42.857142857142854
2008,105064,"Thomaz Bellucci",3,12,15,20
2008,105095,"Evgeny Korolev",13,17,30,43.333333333333336
2008,105122,"Karlis Lejnieks",1,1,2,50
2008,105173,"Adrian Mannarino",3,3,6,50
2008,105208,"Ernests Gulbis",22,21,43,51.16279069767442
2008,105217,"Thiemo De Bakker",1,1,2,50
2008,105223,"Juan Martin del Potro",44,16,60,73.33333333333333
2008,105227,"Marin Cilic",37,24,61,60.65573770491803
2008,105311,"Joao Sousa",1,1,2,50
2008,105385,"Donald Young",8,20,28,28.571428571428573
2008,105453,"Kei Nishikori",16,11,27,59.25925925925926
2008,105992,"Ryan Harrison",1,1,2,50
2009,101868,"Dick Norman",1,1,2,50
2009,102148,"Fabrice Santoro",15,20,35,42.857142857142854
2009,102434,"Vincent Spadea",2,9,11,18.181818181818183
2009,102567,"George Bastl",1,1,2,50
2009,102780,"Frederic Niemeyer",1,1,2,50
2009,102783,"Rainer Schuettler",16,29,45,35.55555555555556
2009,102839,"Nicolas Lapentti",6,14,20,30
2009,102845,"Carlos Moya",2,4,6,33.333333333333336
2009,102860,"Agustin Calleri",3,10,13,23.076923076923077
2009,102905,"Stefan Koubek",6,11,17,35.294117647058826
2009,102967,"Marc Gicquel",21,25,46,45.65217391304348
2009,103017,"Nicolas Kiefer",12,16,28,42.857142857142854
2009,103063,"Sebastien De Chaunac",5,5,10,50
2009,103084,"Guillermo Canas",5,13,18,27.77777777777778
2009,103096,"Arnaud Clement",14,20,34,41.1764705882353
2009,103103,"Dominik Hrbaty",2,5,7,28.571428571428573
2009,103105,"Ruben Ramirez Hidalgo",4,10,14,28.571428571428573
2009,103163,"Tommy Haas",31,18,49,63.265306122448976
2009,103169,"Oscar Hernandez",15,27,42,35.714285714285715
2009,103171,"Raemon Sluiter",4,1,5,80
2009,103188,"Michael Russell",2,4,6,33.333333333333336
2009,103206,"Sebastien Grosjean",1,5,6,16.666666666666668
2009,103228,"Marcos Daniel",6,12,18,33.333333333333336
2009,103240,"Kevin Kim",7,16,23,30.434782608695652
2009,103252,"Alberto Martin",7,20,27,25.925925925925927
2009,103285,"Radek Stepanek",44,19,63,69.84126984126983
2009,103292,"Gaston Gaudio",1,5,6,16.666666666666668
2009,103294,"Christophe Rochus",14,28,42,33.333333333333336
2009,103333,"Ivo Karlovic",21,22,43,48.83720930232558
2009,103344,"Ivan Ljubicic",32,23,55,58.18181818181818
2009,103373,"Sergio Roitman",1,7,8,12.5
2009,103401,"Jan Hernych",11,23,34,32.35294117647059
2009,103428,"Juan Ignacio Chela",9,14,23,39.130434782608695
2009,103429,"Peter Luczak",2,6,8,25
2009,103444,"Jean Rene Lisnard",1,2,3,33.333333333333336
2009,103451,"Bjorn Phau",12,17,29,41.37931034482759
2009,103454,"Nicolas Massu",7,11,18,38.888888888888886
2009,103470,"Robert Kendrick",9,16,25,36
2009,103484,"James Blake",23,18,41,56.09756097560975
2009,103490,"Santiago Ventura",5,8,13,38.46153846153846
2009,103498,"Marat Safin",18,22,40,45
2009,103506,"Martin Vassallo Arguello",14,26,40,35
2009,103507,"Juan Carlos Ferrero",33,20,53,62.264150943396224
2009,103523,"Rohan Bopanna",1,2,3,33.333333333333336
2009,103534,"Nicolas Devilder",4,14,18,22.22222222222222
2009,103566,"Michael Llodra",17,16,33,51.515151515151516
2009,103573,"Rik De Voest",1,5,6,16.666666666666668
2009,103580,"Alexander Peya",1,5,6,16.666666666666668
2009,103582,"Michael Berrer",5,8,13,38.46153846153846
2009,103598,"Xavier Malisse",3,4,7,42.857142857142854
2009,103602,"Fernando Gonzalez",39,16,55,70.9090909090909
2009,103656,"Albert Montanes",25,21,46,54.34782608695652
2009,103675,"Diego Junqueira",4,16,20,20
2009,103693,"Thierry Ascione",1,3,4,25
2009,103694,"Olivier Rochus",13,9,22,59.09090909090909
2009,103714,"Andreas Vinciguerra",4,4,8,50
2009,103720,"Lleyton Hewitt",33,19,52,63.46153846153846
2009,103722,"Florent Serra",24,29,53,45.283018867924525
2009,103752,"Simon Greul",15,15,30,50
2009,103758,"Taylor Dent",12,15,27,44.44444444444444
2009,103781,"Jurgen Melzer",35,26,61,57.377049180327866
2009,103786,"Nikolay Davydenko",57,19,76,75
2009,103794,"Benjamin Becker",14,19,33,42.42424242424242
2009,103808,"Potito Starace",15,23,38,39.473684210526315
2009,103812,"Victor Hanescu",26,30,56,46.42857142857143
2009,103813,"Jarkko Nieminen",11,14,25,44
2009,103819,"Roger Federer",59,12,71,83.09859154929578
2009,103823,"Denis Gremelmayr",2,9,11,18.181818181818183
2009,103830,"Shao Xuan Zeng",1,1,2,50
2009,103843,"Marco Chiudinelli",10,11,21,47.61904761904762
2009,103850,"Sebastian Decoud",2,1,3,66.66666666666667
2009,103852,"Feliciano Lopez",17,23,40,42.5
2009,103857,"Igor Kunitsyn",16,30,46,34.78260869565217
2009,103862,"Michail Elgin",1,1,2,50
2009,103868,"Ivan Navarro",9,19,28,32.142857142857146
2009,103888,"Mardy Fish",21,17,38,55.26315789473684
2009,103898,"Julien Benneteau",26,28,54,48.148148148148145
2009,103900,"David Nalbandian",14,8,22,63.63636363636363
2009,103908,"Paul Henri Mathieu",28,29,57,49.12280701754386
2009,103917,"Nicolas Mahut",4,4,8,50
2009,103967,"Michael Lammer",1,4,5,20
2009,103970,"David Ferrer",40,24,64,62.5
2009,103971,"Karol Beck",4,7,11,36.36363636363637
2009,103990,"Tommy Robredo",46,24,70,65.71428571428571
2009,103997,"Lukasz Kubot",9,9,18,50
2009,103999,"Thiago Alves",1,5,6,16.666666666666668
2009,104003,"Victor Crivoi",7,14,21,33.333333333333336
2009,104019,"Kristof Vliegen",9,12,21,42.857142857142854
2009,104022,"Mikhail Youzhny",41,27,68,60.294117647058826
2009,104025,"Amer Delic",3,5,8,37.5
2009,104026,"Joachim Johansson",3,2,5,60
2009,104035,"Bobby Reynolds",3,13,16,18.75
2009,104053,"Andy Roddick",47,15,62,75.80645161290323
2009,104056,"Roko Karanusic",1,6,7,14.285714285714286
2009,104068,"Robby Ginepri",13,21,34,38.23529411764706
2009,104070,"Jesse Witten",2,2,4,50
2009,104071,"Raven Klaasen",1,1,2,50
2009,104076,"Jose Acasuso",21,21,42,50
2009,104095,"David Guez",2,2,4,50
2009,104098,"Dmitry Tursunov",13,17,30,43.333333333333336
2009,104154,"Paul Capdeville",8,14,22,36.36363636363637
2009,104160,"Lukas Dlouhy",2,1,3,66.66666666666667
2009,104166,"Alex Bogomolov Jr",3,3,6,50
2009,104167,"Todd Widom",3,2,5,60
2009,104180,"Gilles Muller",5,9,14,35.714285714285715
2009,104198,"Guillermo Garcia Lopez",28,27,55,50.90909090909091
2009,104214,"Igor Andreev",27,31,58,46.55172413793103
2009,104216,"Maximo Gonzalez",13,13,26,50
2009,104225,"Jan Hajek",1,1,2,50
2009,104229,"Yen Hsun Lu",9,22,31,29.032258064516128
2009,104230,"Daniel Koellerer",10,17,27,37.03703703703704
2009,104250,"Prakash Amritraj",1,2,3,33.333333333333336
2009,104252,"Florian Mayer",3,6,9,33.333333333333336
2009,104259,"Philipp Kohlschreiber",37,27,64,57.8125
2009,104262,"Flavio Cipolla",4,12,16,25
2009,104268,"Alejandro Falla",2,8,10,20
2009,104269,"Fernando Verdasco",51,24,75,68
2009,104273,"Edouard Roger Vasselin",2,3,5,40
2009,104292,"Izak Van Der Merwe",1,1,2,50
2009,104312,"Andreas Seppi",24,30,54,44.44444444444444
2009,104314,"Brian Dabul",5,11,16,31.25
2009,104327,"Steve Darcis",5,18,23,21.73913043478261
2009,104330,"Rajeev Ram",8,6,14,57.142857142857146
2009,104332,"Philipp Petzschner",15,25,40,37.5
2009,104338,"Juan Monaco",35,24,59,59.32203389830509
2009,104339,"Mario Ancic",12,7,19,63.1578947368421
2009,104349,"Rui Machado",2,4,6,33.333333333333336
2009,104371,"Ivo Minar",4,11,15,26.666666666666668
2009,104372,"Alex Bogdanovic",1,2,3,33.333333333333336
2009,104386,"Janko Tipsarevic",29,24,53,54.716981132075475
2009,104392,"Franco Ferreiro",2,2,4,50
2009,104417,"Robin Soderling",47,23,70,67.14285714285714
2009,104433,"Frank Dancevic",9,11,20,45
2009,104468,"Gilles Simon",45,27,72,62.5
2009,104471,"Ivan Dodig",2,2,4,50
2009,104500,"Somdev Devvarman",7,5,12,58.333333333333336
2009,104515,"Mathieu Montcourt",1,1,2,50
2009,104523,"Frederico Gil",16,17,33,48.484848484848484
2009,104527,"Stan Wawrinka",29,19,48,60.416666666666664
2009,104534,"Dudi Sela",15,20,35,42.857142857142854
2009,104542,"Jo-Wilfried Tsonga",50,21,71,70.4225352112676
2009,104545,"John Isner",27,18,45,60
2009,104547,"Horacio Zeballos",5,5,10,50
2009,104559,"Teymuraz Gabashvili",12,24,36,33.333333333333336
2009,104571,"Marcos Baghdatis",18,16,34,52.94117647058823
2009,104589,"Chris Guccione",7,8,15,46.666666666666664
2009,104593,"Daniel Gimeno Traver",9,20,29,31.03448275862069
2009,104597,"Nicolas Almagro",30,24,54,55.55555555555556
2009,104607,"Tomas Berdych",33,24,57,57.89473684210526
2009,104620,"Simone Bolelli",15,23,38,39.473684210526315
2009,104624,"Joshua Goodall",1,2,3,33.333333333333336
2009,104639,"Wayne Odesnik",10,13,23,43.47826086956522
2009,104655,"Pablo Cuevas",18,15,33,54.54545454545455
2009,104660,"Sergiy Stakhovsky",14,13,27,51.851851851851855
2009,104665,"Pablo Andujar",1,12,13,7.6923076923076925
2009,104676,"Andreas Beck",22,20,42,52.38095238095238
2009,104678,"Viktor Troicki",30,28,58,51.724137931034484
2009,104717,"Brendan Evans",3,5,8,37.5
2009,104719,"Marcel Granollers",16,25,41,39.02439024390244
2009,104721,"Josselin Ouanna",3,5,8,37.5
2009,104724,"Eduardo Schwank",3,14,17,17.647058823529413
2009,104731,"Kevin Anderson",2,6,8,25
2009,104745,"Rafael Nadal",64,14,78,82.05128205128206
2009,104755,"Richard Gasquet",23,15,38,60.526315789473685
2009,104792,"Gael Monfils",42,19,61,68.85245901639344
2009,104797,"Denis Istomin",13,17,30,43.333333333333336
2009,104812,"Scoville Jenkins",1,1,2,50
2009,104868,"James Ward",1,3,4,25
2009,104871,"Jeremy Chardy",34,28,62,54.83870967741935
2009,104918,"Andy Murray",64,12,76,84.21052631578948
2009,104919,"Leonardo Mayer",18,18,36,50
2009,104925,"Novak Djokovic",78,17,95,82.10526315789474
2009,104926,"Fabio Fognini",17,26,43,39.53488372093023
2009,104947,"Marsel Ilhan",2,3,5,40
2009,104958,"Carsten Ball",5,3,8,62.5
2009,104976,"Ryan Sweeting",2,6,8,25
2009,104978,"Daniel Brands",7,5,12,58.333333333333336
2009,104979,"Andrey Golubev",5,18,23,21.73913043478261
2009,104999,"Mischa Zverev",15,24,39,38.46153846153846
2009,105011,"Illya Marchenko",4,3,7,57.142857142857146
2009,105023,"Sam Querrey",41,23,64,64.0625
2009,105028,"Jesse Levine",7,8,15,46.666666666666664
2009,105032,"Sam Groth",1,2,3,33.333333333333336
2009,105041,"Lukas Lacko",1,3,4,25
2009,105062,"Mikhail Kukushkin",5,6,11,45.45454545454545
2009,105064,"Thomaz Bellucci",18,17,35,51.42857142857143
2009,105095,"Evgeny Korolev",18,19,37,48.648648648648646
2009,105098,"Alexandre Sidorenko",2,2,4,50
2009,105099,"Antonio Veic",2,1,3,66.66666666666667
2009,105137,"Pere Riba",2,3,5,40
2009,105166,"Peter Polansky",1,4,5,20
2009,105208,"Ernests Gulbis",17,26,43,39.53488372093023
2009,105217,"Thiemo De Bakker",2,3,5,40
2009,105223,"Juan Martin del Potro",53,16,69,76.81159420289855
2009,105227,"Marin Cilic",45,20,65,69.23076923076923
2009,105238,"Alexandr Dolgopolov",1,1,2,50
2009,105453,"Kei Nishikori",3,6,9,33.333333333333336
2009,105454,"Brydan Klein",2,3,5,40
2009,105558,"Guillaume Rufin",1,1,2,50
2009,105657,"Marius Copil",1,1,2,50
2009,105723,"Andrey Kuznetsov",1,2,3,33.333333333333336
2009,105777,"Grigor Dimitrov",2,6,8,25
2009,106071,"Bernard Tomic",1,3,4,25
2010,101962,"Younes El Aynaoui",1,1,2,50
2010,102783,"Rainer Schuettler",13,17,30,43.333333333333336
2010,102839,"Nicolas Lapentti",1,7,8,12.5
2010,102845,"Carlos Moya",2,6,8,25
2010,102887,"Ramon Delgado",1,2,3,33.333333333333336
2010,102905,"Stefan Koubek",3,5,8,37.5
2010,102967,"Marc Gicquel",5,12,17,29.41176470588235
2010,103017,"Nicolas Kiefer",1,3,4,25
2010,103035,"Alessio Di Mauro",1,1,2,50
2010,103096,"Arnaud Clement",15,24,39,38.46153846153846
2010,103105,"Ruben Ramirez Hidalgo",1,4,5,20
2010,103163,"Tommy Haas",3,4,7,42.857142857142854
2010,103169,"Oscar Hernandez",2,14,16,12.5
2010,103188,"Michael Russell",11,23,34,32.35294117647059
2010,103206,"Sebastien Grosjean",1,3,4,25
2010,103228,"Marcos Daniel",2,10,12,16.666666666666668
2010,103240,"Kevin Kim",1,3,4,25
2010,103248,"Harel Levy",1,2,3,33.333333333333336
2010,103252,"Alberto Martin",5,4,9,55.55555555555556
2010,103285,"Radek Stepanek",17,15,32,53.125
2010,103333,"Ivo Karlovic",16,9,25,64
2010,103344,"Ivan Ljubicic",26,19,45,57.77777777777778
2010,103393,"Yuri Schukin",4,2,6,66.66666666666667
2010,103428,"Juan Ignacio Chela",28,24,52,53.84615384615385
2010,103429,"Peter Luczak",9,24,33,27.272727272727273
2010,103451,"Bjorn Phau",9,13,22,40.90909090909091
2010,103454,"Nicolas Massu",3,7,10,30
2010,103484,"James Blake",15,17,32,46.875
2010,103490,"Santiago Ventura",3,11,14,21.428571428571427
2010,103507,"Juan Carlos Ferrero",33,14,47,70.2127659574468
2010,103543,"David Marrero",1,2,3,33.333333333333336
2010,103565,"Stephane Robert",11,17,28,39.285714285714285
2010,103566,"Michael Llodra",27,21,48,56.25
2010,103582,"Michael Berrer",20,28,48,41.666666666666664
2010,103598,"Xavier Malisse",22,22,44,50
2010,103602,"Fernando Gonzalez",13,9,22,59.09090909090909
2010,103656,"Albert Montanes",38,24,62,61.29032258064516
2010,103672,"Ricardo Mello",6,10,16,37.5
2010,103694,"Olivier Rochus",14,22,36,38.888888888888886
2010,103714,"Andreas Vinciguerra",1,2,3,33.333333333333336
2010,103720,"Lleyton Hewitt",19,12,31,61.29032258064516
2010,103722,"Florent Serra",19,27,46,41.30434782608695
2010,103747,"Dominik Meffert",1,1,2,50
2010,103752,"Simon Greul",12,25,37,32.432432432432435
2010,103758,"Taylor Dent",12,19,31,38.70967741935484
2010,103781,"Jurgen Melzer",49,25,74,66.21621621621621
2010,103786,"Nikolay Davydenko",29,19,48,60.416666666666664
2010,103794,"Benjamin Becker",30,29,59,50.847457627118644
2010,103808,"Potito Starace",23,25,48,47.916666666666664
2010,103812,"Victor Hanescu",23,24,47,48.93617021276596
2010,103813,"Jarkko Nieminen",28,27,55,50.90909090909091
2010,103819,"Roger Federer",66,13,79,83.54430379746836
2010,103835,"Filippo Volandri",3,6,9,33.333333333333336
2010,103843,"Marco Chiudinelli",14,25,39,35.8974358974359
2010,103852,"Feliciano Lopez",27,23,50,54
2010,103857,"Igor Kunitsyn",5,14,19,26.31578947368421
2010,103868,"Ivan Navarro",2,8,10,20
2010,103888,"Mardy Fish",38,15,53,71.69811320754717
2010,103893,"Paolo Lorenzi",2,14,16,12.5
2010,103898,"Julien Benneteau",24,19,43,55.81395348837209
2010,103900,"David Nalbandian",25,10,35,71.42857142857143
2010,103908,"Paul Henri Mathieu",11,21,32,34.375
2010,103917,"Nicolas Mahut",3,7,10,30
2010,103926,"Daniel Munoz de la Nava",1,1,2,50
2010,103967,"Michael Lammer",3,2,5,60
2010,103970,"David Ferrer",58,23,81,71.60493827160494
2010,103971,"Karol Beck",1,11,12,8.333333333333334
2010,103990,"Tommy Robredo",20,23,43,46.51162790697674
2010,103997,"Lukasz Kubot",15,24,39,38.46153846153846
2010,103999,"Thiago Alves",1,5,6,16.666666666666668
2010,104003,"Victor Crivoi",2,5,7,28.571428571428573
2010,104004,"Filip Prpic",1,3,4,25
2010,104019,"Kristof Vliegen",2,10,12,16.666666666666668
2010,104022,"Mikhail Youzhny",40,19,59,67.79661016949153
2010,104053,"Andy Roddick",48,18,66,72.72727272727273
2010,104068,"Robby Ginepri",8,14,22,36.36363636363637
2010,104071,"Raven Klaasen",3,2,5,60
2010,104076,"Jose Acasuso",1,3,4,25
2010,104098,"Dmitry Tursunov",6,9,15,40
2010,104122,"Carlos Berlocq",3,3,6,50
2010,104154,"Paul Capdeville",1,1,2,50
2010,104171,"Richard Bloomfield",3,1,4,75
2010,104180,"Gilles Muller",2,2,4,50
2010,104195,"Simone Vagnozzi",1,2,3,33.333333333333336
2010,104198,"Guillermo Garcia Lopez",31,23,54,57.407407407407405
2010,104214,"Igor Andreev",17,19,36,47.22222222222222
2010,104216,"Maximo Gonzalez",3,9,12,25
2010,104225,"Jan Hajek",12,20,32,37.5
2010,104229,"Yen Hsun Lu",15,20,35,42.857142857142854
2010,104230,"Daniel Koellerer",4,10,14,28.571428571428573
2010,104252,"Florian Mayer",21,19,40,52.5
2010,104259,"Philipp Kohlschreiber",36,25,61,59.01639344262295
2010,104268,"Alejandro Falla",14,19,33,42.42424242424242
2010,104269,"Fernando Verdasco",43,21,64,67.1875
2010,104273,"Edouard Roger Vasselin",2,7,9,22.22222222222222
2010,104292,"Izak Van Der Merwe",1,1,2,50
2010,104308,"Michal Przysiezny",1,12,13,7.6923076923076925
2010,104311,"Leonardo Tavares",1,1,2,50
2010,104312,"Andreas Seppi",24,28,52,46.15384615384615
2010,104314,"Brian Dabul",5,4,9,55.55555555555556
2010,104327,"Steve Darcis",4,6,10,40
2010,104330,"Rajeev Ram",6,18,24,25
2010,104332,"Philipp Petzschner",21,19,40,52.5
2010,104338,"Juan Monaco",30,19,49,61.224489795918366
2010,104339,"Mario Ancic",2,3,5,40
2010,104349,"Rui Machado",3,2,5,60
2010,104386,"Janko Tipsarevic",22,22,44,50
2010,104397,"Laurent Recouderc",1,5,6,16.666666666666668
2010,104417,"Robin Soderling",53,22,75,70.66666666666667
2010,104424,"Go Soeda",1,4,5,20
2010,104433,"Frank Dancevic",2,3,5,40
2010,104453,"Michael Ryderstedt",1,1,2,50
2010,104460,"Dustin Brown",6,10,16,37.5
2010,104468,"Gilles Simon",22,17,39,56.41025641025641
2010,104471,"Ivan Dodig",7,7,14,50
2010,104476,"Louk Sorensen",1,2,3,33.333333333333336
2010,104494,"Adrian Ungur",1,1,2,50
2010,104500,"Somdev Devvarman",7,11,18,38.888888888888886
2010,104505,"Konstantin Kravchuk",1,2,3,33.333333333333336
2010,104523,"Frederico Gil",8,13,21,38.095238095238095
2010,104527,"Stan Wawrinka",35,17,52,67.3076923076923
2010,104534,"Dudi Sela",15,17,32,46.875
2010,104542,"Jo-Wilfried Tsonga",30,15,45,66.66666666666667
2010,104545,"John Isner",38,22,60,63.333333333333336
2010,104547,"Horacio Zeballos",16,27,43,37.2093023255814
2010,104559,"Teymuraz Gabashvili",10,16,26,38.46153846153846
2010,104571,"Marcos Baghdatis",41,27,68,60.294117647058826
2010,104592,"Ilija Bozoljac",1,4,5,20
2010,104593,"Daniel Gimeno Traver",18,25,43,41.86046511627907
2010,104594,"Marinko Matosevic",1,3,4,25
2010,104597,"Nicolas Almagro",43,24,67,64.17910447761194
2010,104607,"Tomas Berdych",44,24,68,64.70588235294117
2010,104620,"Simone Bolelli",5,11,16,31.25
2010,104639,"Wayne Odesnik",7,7,14,50
2010,104655,"Pablo Cuevas",20,22,42,47.61904761904762
2010,104660,"Sergiy Stakhovsky",24,24,48,50
2010,104665,"Pablo Andujar",8,8,16,50
2010,104676,"Andreas Beck",9,15,24,37.5
2010,104678,"Viktor Troicki",37,27,64,57.8125
2010,104714,"Julian Reister",5,5,10,50
2010,104717,"Brendan Evans",1,2,3,33.333333333333336
2010,104719,"Marcel Granollers",21,22,43,48.83720930232558
2010,104721,"Josselin Ouanna",4,5,9,44.44444444444444
2010,104724,"Eduardo Schwank",14,21,35,40
2010,104731,"Kevin Anderson",14,18,32,43.75
2010,104735,"Tobias Kamke",7,8,15,46.666666666666664
2010,104745,"Rafael Nadal",71,10,81,87.65432098765432
2010,104755,"Richard Gasquet",38,24,62,61.29032258064516
2010,104770,"Martin Fischer",1,3,4,25
2010,104792,"Gael Monfils",42,19,61,68.85245901639344
2010,104797,"Denis Istomin",29,29,58,50
2010,104813,"Grega Zemlja",3,4,7,42.857142857142854
2010,104868,"James Ward",2,4,6,33.333333333333336
2010,104869,"Sergei Bubka",1,1,2,50
2010,104871,"Jeremy Chardy",26,29,55,47.27272727272727
2010,104882,"Blaz Kavcic",3,7,10,30
2010,104890,"Andreas Haider Maurer",5,3,8,62.5
2010,104897,"Matthias Bachinger",1,2,3,33.333333333333336
2010,104898,"Robin Haase",6,11,17,35.294117647058826
2010,104907,"Jose Rubin Statham",1,1,2,50
2010,104914,"Ervin Eleskovic",1,1,2,50
2010,104918,"Andy Murray",46,18,64,71.875
2010,104919,"Leonardo Mayer",12,19,31,38.70967741935484
2010,104925,"Novak Djokovic",56,18,74,75.67567567567568
2010,104926,"Fabio Fognini",14,25,39,35.8974358974359
2010,104947,"Marsel Ilhan",4,8,12,33.333333333333336
2010,104948,"Petar Jelenic",1,1,2,50
2010,104958,"Carsten Ball",3,8,11,27.272727272727273
2010,104963,"Yannick Mertens",1,1,2,50
2010,104967,"Alexander Sadecky",1,1,2,50
2010,104976,"Ryan Sweeting",4,9,13,30.76923076923077
2010,104978,"Daniel Brands",9,19,28,32.142857142857146
2010,104979,"Andrey Golubev",18,21,39,46.15384615384615
2010,104997,"Igor Sijsling",3,3,6,50
2010,104999,"Mischa Zverev",14,18,32,43.75
2010,105011,"Illya Marchenko",17,21,38,44.73684210526316
2010,105015,"Franko Skugor",3,3,6,50
2010,105023,"Sam Querrey",38,22,60,63.333333333333336
2010,105028,"Jesse Levine",1,5,6,16.666666666666668
2010,105041,"Lukas Lacko",16,21,37,43.24324324324324
2010,105051,"Matthew Ebden",1,2,3,33.333333333333336
2010,105053,"Santiago Giraldo",17,23,40,42.5
2010,105062,"Mikhail Kukushkin",11,8,19,57.89473684210526
2010,105064,"Thomaz Bellucci",32,24,56,57.142857142857146
2010,105065,"Tim Smyczek",1,4,5,20
2010,105074,"Ruben Bemelmans",1,4,5,20
2010,105077,"Albert Ramos",2,4,6,33.333333333333336
2010,105079,"Ivan Sergeyev",1,1,2,50
2010,105095,"Evgeny Korolev",12,20,32,37.5
2010,105098,"Alexandre Sidorenko",1,2,3,33.333333333333336
2010,105099,"Antonio Veic",1,3,4,25
2010,105137,"Pere Riba",6,14,20,30
2010,105149,"Reda El Amrani",2,1,3,66.66666666666667
2010,105154,"Joao Souza",3,2,5,60
2010,105166,"Peter Polansky",2,3,5,40
2010,105173,"Adrian Mannarino",2,4,6,33.333333333333336
2010,105208,"Ernests Gulbis",29,20,49,59.183673469387756
2010,105217,"Thiemo De Bakker",26,23,49,53.06122448979592
2010,105223,"Juan Martin del Potro",3,3,6,50
2010,105227,"Marin Cilic",38,21,59,64.40677966101696
2010,105238,"Alexandr Dolgopolov",21,23,44,47.72727272727273
2010,105332,"Benoit Paire",1,4,5,20
2010,105339,"Yan Bai",1,1,2,50
2010,105373,"Martin Klizan",1,2,3,33.333333333333336
2010,105385,"Donald Young",3,6,9,33.333333333333336
2010,105453,"Kei Nishikori",3,9,12,25
2010,105539,"Evgeny Donskoy",1,2,3,33.333333333333336
2010,105558,"Guillaume Rufin",3,4,7,42.857142857142854
2010,105573,"Henri Kontinen",1,1,2,50
2010,105575,"Ricardas Berankis",4,3,7,57.142857142857146
2010,105683,"Milos Raonic",3,4,7,42.857142857142854
2010,105723,"Andrey Kuznetsov",1,4,5,20
2010,105777,"Grigor Dimitrov",1,1,2,50
2010,105936,"Filip Krajinovic",3,5,8,37.5
2010,105992,"Ryan Harrison",4,9,13,30.76923076923077
2010,106026,"Yuki Bhambri",1,1,2,50
2010,106045,"Denis Kudla",1,1,2,50
2010,106071,"Bernard Tomic",2,6,8,25
2011,102783,"Rainer Schuettler",5,13,18,27.77777777777778
2011,103096,"Arnaud Clement",6,11,17,35.294117647058826
2011,103105,"Ruben Ramirez Hidalgo",5,15,20,25
2011,103163,"Tommy Haas",7,12,19,36.8421052631579
2011,103188,"Michael Russell",12,18,30,40
2011,103285,"Radek Stepanek",30,24,54,55.55555555555556
2011,103333,"Ivo Karlovic",16,20,36,44.44444444444444
2011,103344,"Ivan Ljubicic",25,19,44,56.81818181818182
2011,103401,"Jan Hernych",3,2,5,60
2011,103428,"Juan Ignacio Chela",28,24,52,53.84615384615385
2011,103429,"Peter Luczak",1,4,5,20
2011,103444,"Jean Rene Lisnard",1,2,3,33.333333333333336
2011,103451,"Bjorn Phau",2,7,9,22.22222222222222
2011,103470,"Robert Kendrick",4,9,13,30.76923076923077
2011,103484,"James Blake",19,16,35,54.285714285714285
2011,103507,"Juan Carlos Ferrero",20,11,31,64.51612903225806
2011,103565,"Stephane Robert",2,5,7,28.571428571428573
2011,103566,"Michael Llodra",17,21,38,44.73684210526316
2011,103573,"Rik De Voest",5,4,9,55.55555555555556
2011,103582,"Michael Berrer",17,22,39,43.58974358974359
2011,103598,"Xavier Malisse",24,24,48,50
2011,103602,"Fernando Gonzalez",3,4,7,42.857142857142854
2011,103656,"Albert Montanes",22,25,47,46.808510638297875
2011,103672,"Ricardo Mello",8,14,22,36.36363636363637
2011,103675,"Diego Junqueira",3,5,8,37.5
2011,103676,"Michael Yani",3,4,7,42.857142857142854
2011,103694,"Olivier Rochus",13,14,27,48.148148148148145
2011,103720,"Lleyton Hewitt",8,9,17,47.05882352941177
2011,103722,"Florent Serra",4,12,16,25
2011,103752,"Simon Greul",3,3,6,50
2011,103781,"Jurgen Melzer",20,21,41,48.78048780487805
2011,103786,"Nikolay Davydenko",26,25,51,50.98039215686274
2011,103794,"Benjamin Becker",3,9,12,25
2011,103808,"Potito Starace",22,26,48,45.833333333333336
2011,103812,"Victor Hanescu",16,24,40,40
2011,103813,"Jarkko Nieminen",20,25,45,44.44444444444444
2011,103819,"Roger Federer",61,12,73,83.56164383561644
2011,103821,"Danai Udomchoke",1,1,2,50
2011,103823,"Denis Gremelmayr",4,10,14,28.571428571428573
2011,103835,"Filippo Volandri",13,19,32,40.625
2011,103843,"Marco Chiudinelli",2,4,6,33.333333333333336
2011,103852,"Feliciano Lopez",35,25,60,58.333333333333336
2011,103857,"Igor Kunitsyn",16,21,37,43.24324324324324
2011,103868,"Ivan Navarro",1,2,3,33.333333333333336
2011,103888,"Mardy Fish",43,23,66,65.15151515151516
2011,103893,"Paolo Lorenzi",2,3,5,40
2011,103898,"Julien Benneteau",21,21,42,50
2011,103900,"David Nalbandian",20,13,33,60.60606060606061
2011,103917,"Nicolas Mahut",11,12,23,47.82608695652174
2011,103967,"Michael Lammer",1,2,3,33.333333333333336
2011,103970,"David Ferrer",55,19,74,74.32432432432432
2011,103971,"Karol Beck",4,10,14,28.571428571428573
2011,103976,"Juan Pablo Brzezicki",1,1,2,50
2011,103990,"Tommy Robredo",20,14,34,58.8235294117647
2011,103997,"Lukasz Kubot",17,17,34,50
2011,104003,"Victor Crivoi",1,3,4,25
2011,104022,"Mikhail Youzhny",25,24,49,51.02040816326531
2011,104023,"Nicolas Renavand",1,1,2,50
2011,104053,"Andy Roddick",32,15,47,68.08510638297872
2011,104068,"Robby Ginepri",2,4,6,33.333333333333336
2011,104076,"Jose Acasuso",2,1,3,66.66666666666667
2011,104098,"Dmitry Tursunov",18,18,36,50
2011,104122,"Carlos Berlocq",15,23,38,39.473684210526315
2011,104136,"Santiago Gonzalez",1,1,2,50
2011,104166,"Alex Bogomolov Jr",27,21,48,56.25
2011,104180,"Gilles Muller",14,11,25,56
2011,104195,"Simone Vagnozzi",2,2,4,50
2011,104198,"Guillermo Garcia Lopez",20,29,49,40.816326530612244
2011,104214,"Igor Andreev",16,26,42,38.095238095238095
2011,104216,"Maximo Gonzalez",3,13,16,18.75
2011,104226,"Bastian Knittel",1,2,3,33.333333333333336
2011,104229,"Yen Hsun Lu",11,20,31,35.483870967741936
2011,104252,"Florian Mayer",45,24,69,65.21739130434783
2011,104259,"Philipp Kohlschreiber",30,24,54,55.55555555555556
2011,104262,"Flavio Cipolla",5,12,17,29.41176470588235
2011,104268,"Alejandro Falla",9,14,23,39.130434782608695
2011,104269,"Fernando Verdasco",34,24,58,58.62068965517241
2011,104273,"Edouard Roger Vasselin",6,12,18,33.333333333333336
2011,104291,"Malek Jaziri",1,1,2,50
2011,104292,"Izak Van Der Merwe",3,1,4,75
2011,104297,"Rogerio Dutra Silva",1,2,3,33.333333333333336
2011,104308,"Michal Przysiezny",1,4,5,20
2011,104312,"Andreas Seppi",25,24,49,51.02040816326531
2011,104314,"Brian Dabul",2,8,10,20
2011,104327,"Steve Darcis",7,6,13,53.84615384615385
2011,104330,"Rajeev Ram",2,3,5,40
2011,104332,"Philipp Petzschner",22,22,44,50
2011,104338,"Juan Monaco",28,25,53,52.83018867924528
2011,104349,"Rui Machado",3,12,15,20
2011,104386,"Janko Tipsarevic",50,25,75,66.66666666666667
2011,104417,"Robin Soderling",37,9,46,80.43478260869566
2011,104424,"Go Soeda",3,7,10,30
2011,104433,"Frank Dancevic",2,6,8,25
2011,104453,"Michael Ryderstedt",2,2,4,50
2011,104460,"Dustin Brown",2,10,12,16.666666666666668
2011,104468,"Gilles Simon",38,25,63,60.317460317460316
2011,104471,"Ivan Dodig",26,23,49,53.06122448979592
2011,104494,"Adrian Ungur",2,3,5,40
2011,104499,"Jimmy Wang",1,1,2,50
2011,104500,"Somdev Devvarman",19,22,41,46.34146341463415
2011,104523,"Frederico Gil",10,17,27,37.03703703703704
2011,104527,"Stan Wawrinka",33,19,52,63.46153846153846
2011,104534,"Dudi Sela",6,13,19,31.57894736842105
2011,104542,"Jo-Wilfried Tsonga",56,23,79,70.88607594936708
2011,104545,"John Isner",35,20,55,63.63636363636363
2011,104547,"Horacio Zeballos",5,6,11,45.45454545454545
2011,104559,"Teymuraz Gabashvili",10,19,29,34.48275862068966
2011,104571,"Marcos Baghdatis",26,27,53,49.056603773584904
2011,104586,"Lukas Rosol",5,13,18,27.77777777777778
2011,104589,"Chris Guccione",1,3,4,25
2011,104592,"Ilija Bozoljac",1,1,2,50
2011,104593,"Daniel Gimeno Traver",9,25,34,26.470588235294116
2011,104594,"Marinko Matosevic",2,9,11,18.181818181818183
2011,104597,"Nicolas Almagro",47,23,70,67.14285714285714
2011,104607,"Tomas Berdych",51,23,74,68.91891891891892
2011,104619,"Jesse Huta Galung",2,5,7,28.571428571428573
2011,104620,"Simone Bolelli",4,8,12,33.333333333333336
2011,104628,"Alexander Kudryavtsev",1,1,2,50
2011,104633,"Mathieu Rodrigues",1,1,2,50
2011,104655,"Pablo Cuevas",11,13,24,45.833333333333336
2011,104660,"Sergiy Stakhovsky",22,26,48,45.833333333333336
2011,104661,"Pierre Ludovic Duclos",1,1,2,50
2011,104665,"Pablo Andujar",25,28,53,47.16981132075472
2011,104678,"Viktor Troicki",36,25,61,59.01639344262295
2011,104681,"Sebastian Rieschick",1,1,2,50
2011,104695,"Fritz Wolmarans",1,1,2,50
2011,104714,"Julian Reister",3,7,10,30
2011,104719,"Marcel Granollers",27,25,52,51.92307692307692
2011,104724,"Eduardo Schwank",3,6,9,33.333333333333336
2011,104731,"Kevin Anderson",39,27,66,59.09090909090909
2011,104735,"Tobias Kamke",15,23,38,39.473684210526315
2011,104738,"Caio Zampieri",1,1,2,50
2011,104745,"Rafael Nadal",64,15,79,81.0126582278481
2011,104755,"Richard Gasquet",34,18,52,65.38461538461539
2011,104792,"Gael Monfils",37,17,54,68.51851851851852
2011,104797,"Denis Istomin",10,21,31,32.25806451612903
2011,104813,"Grega Zemlja",1,3,4,25
2011,104850,"Jonathan Dasnieres De Veigy",1,3,4,25
2011,104851,"Gianluca Naso",1,2,3,33.333333333333336
2011,104868,"James Ward",4,4,8,50
2011,104869,"Sergei Bubka",3,4,7,42.857142857142854
2011,104871,"Jeremy Chardy",8,18,26,30.76923076923077
2011,104882,"Blaz Kavcic",13,16,29,44.827586206896555
2011,104890,"Andreas Haider Maurer",7,14,21,33.333333333333336
2011,104897,"Matthias Bachinger",4,10,14,28.571428571428573
2011,104898,"Robin Haase",25,24,49,51.02040816326531
2011,104918,"Andy Murray",54,13,67,80.59701492537313
2011,104919,"Leonardo Mayer",4,7,11,36.36363636363637
2011,104925,"Novak Djokovic",72,6,78,92.3076923076923
2011,104926,"Fabio Fognini",22,28,50,44
2011,104947,"Marsel Ilhan",5,13,18,27.77777777777778
2011,104965,"Pavol Cervenak",2,1,3,66.66666666666667
2011,104976,"Ryan Sweeting",14,19,33,42.42424242424242
2011,104978,"Daniel Brands",4,11,15,26.666666666666668
2011,104979,"Andrey Golubev",4,25,29,13.793103448275861
2011,104997,"Igor Sijsling",2,3,5,40
2011,104999,"Mischa Zverev",2,18,20,10
2011,105011,"Illya Marchenko",5,9,14,35.714285714285715
2011,105023,"Sam Querrey",12,15,27,44.44444444444444
2011,105041,"Lukas Lacko",4,7,11,36.36363636363637
2011,105051,"Matthew Ebden",10,10,20,50
2011,105053,"Santiago Giraldo",29,26,55,52.72727272727273
2011,105062,"Mikhail Kukushkin",9,21,30,30
2011,105064,"Thomaz Bellucci",23,24,47,48.93617021276596
2011,105065,"Tim Smyczek",3,6,9,33.333333333333336
2011,105074,"Ruben Bemelmans",1,3,4,25
2011,105077,"Albert Ramos",13,16,29,44.827586206896555
2011,105099,"Antonio Veic",4,6,10,40
2011,105128,"Guillermo Olaso",1,2,3,33.333333333333336
2011,105137,"Pere Riba",11,22,33,33.333333333333336
2011,105147,"Tatsuma Ito",2,4,6,33.333333333333336
2011,105154,"Joao Souza",7,8,15,46.666666666666664
2011,105173,"Adrian Mannarino",17,23,40,42.5
2011,105208,"Ernests Gulbis",18,22,40,45
2011,105216,"Yuichi Sugita",1,3,4,25
2011,105217,"Thiemo De Bakker",2,11,13,15.384615384615385
2011,105223,"Juan Martin del Potro",46,17,63,73.01587301587301
2011,105227,"Marin Cilic",40,23,63,63.492063492063494
2011,105238,"Alexandr Dolgopolov",38,29,67,56.71641791044776
2011,105270,"Maxime Teixeira",1,1,2,50
2011,105311,"Joao Sousa",1,1,2,50
2011,105318,"Thomas Schoorel",1,4,5,20
2011,105332,"Benoit Paire",5,10,15,33.333333333333336
2011,105379,"Aljaz Bedene",1,1,2,50
2011,105385,"Donald Young",19,17,36,52.77777777777778
2011,105453,"Kei Nishikori",32,22,54,59.25925925925926
2011,105558,"Guillaume Rufin",1,2,3,33.333333333333336
2011,105561,"Alessandro Giannessi",2,1,3,66.66666666666667
2011,105575,"Ricardas Berankis",6,10,16,37.5
2011,105577,"Vasek Pospisil",3,4,7,42.857142857142854
2011,105583,"Dusan Lajovic",3,5,8,37.5
2011,105585,"Ze Zhang",1,2,3,33.333333333333336
2011,105643,"Federico Delbonis",3,2,5,60
2011,105649,"Cedrik Marcel Stebe",4,4,8,50
2011,105657,"Marius Copil",1,2,3,33.333333333333336
2011,105676,"David Goffin",2,2,4,50
2011,105683,"Milos Raonic",30,18,48,62.5
2011,105723,"Andrey Kuznetsov",2,4,6,33.333333333333336
2011,105777,"Grigor Dimitrov",18,25,43,41.86046511627907
2011,105894,"Javier Marti",1,4,5,20
2011,105930,"Daniel Kosakowski",1,1,2,50
2011,105992,"Ryan Harrison",14,19,33,42.42424242424242
2011,106045,"Denis Kudla",2,2,4,50
2011,106058,"Jack Sock",1,2,3,33.333333333333336
2011,106071,"Bernard Tomic",14,14,28,50
2011,106233,"Dominic Thiem",1,3,4,25
2012,103096,"Arnaud Clement",2,3,5,40
2012,103105,"Ruben Ramirez Hidalgo",3,12,15,20
2012,103163,"Tommy Haas",31,17,48,64.58333333333333
2012,103188,"Michael Russell",11,11,22,50
2012,103285,"Radek Stepanek",22,24,46,47.82608695652174
2012,103333,"Ivo Karlovic",14,16,30,46.666666666666664
2012,103344,"Ivan Ljubicic",3,6,9,33.333333333333336
2012,103401,"Jan Hernych",2,1,3,66.66666666666667
2012,103428,"Juan Ignacio Chela",5,12,17,29.41176470588235
2012,103451,"Bjorn Phau",7,14,21,33.333333333333336
2012,103484,"James Blake",8,13,21,38.095238095238095
2012,103507,"Juan Carlos Ferrero",4,12,16,25
2012,103534,"Nicolas Devilder",2,1,3,66.66666666666667
2012,103566,"Michael Llodra",12,14,26,46.15384615384615
2012,103582,"Michael Berrer",5,11,16,31.25
2012,103598,"Xavier Malisse",21,24,45,46.666666666666664
2012,103602,"Fernando Gonzalez",3,4,7,42.857142857142854
2012,103656,"Albert Montanes",7,16,23,30.434782608695652
2012,103672,"Ricardo Mello",2,6,8,25
2012,103675,"Diego Junqueira",1,4,5,20
2012,103676,"Michael Yani",1,2,3,33.333333333333336
2012,103694,"Olivier Rochus",9,23,32,28.125
2012,103720,"Lleyton Hewitt",15,12,27,55.55555555555556
2012,103722,"Florent Serra",5,8,13,38.46153846153846
2012,103781,"Jurgen Melzer",18,23,41,43.90243902439025
2012,103786,"Nikolay Davydenko",24,25,49,48.97959183673469
2012,103794,"Benjamin Becker",10,14,24,41.666666666666664
2012,103808,"Potito Starace",8,18,26,30.76923076923077
2012,103812,"Victor Hanescu",6,13,19,31.57894736842105
2012,103813,"Jarkko Nieminen",24,27,51,47.05882352941177
2012,103819,"Roger Federer",72,12,84,85.71428571428571
2012,103823,"Denis Gremelmayr",1,1,2,50
2012,103835,"Filippo Volandri",11,21,32,34.375
2012,103843,"Marco Chiudinelli",4,8,12,33.333333333333336
2012,103852,"Feliciano Lopez",26,27,53,49.056603773584904
2012,103857,"Igor Kunitsyn",4,20,24,16.666666666666668
2012,103868,"Ivan Navarro",1,1,2,50
2012,103888,"Mardy Fish",20,12,32,62.5
2012,103893,"Paolo Lorenzi",8,17,25,32
2012,103898,"Julien Benneteau",27,22,49,55.10204081632653
2012,103900,"David Nalbandian",20,16,36,55.55555555555556
2012,103908,"Paul Henri Mathieu",14,17,31,45.16129032258065
2012,103917,"Nicolas Mahut",16,18,34,47.05882352941177
2012,103926,"Daniel Munoz de la Nava",3,4,7,42.857142857142854
2012,103970,"David Ferrer",70,15,85,82.3529411764706
2012,103971,"Karol Beck",2,9,11,18.181818181818183
2012,103990,"Tommy Robredo",5,7,12,41.666666666666664
2012,103997,"Lukasz Kubot",21,27,48,43.75
2012,104022,"Mikhail Youzhny",33,22,55,60
2012,104035,"Bobby Reynolds",4,7,11,36.36363636363637
2012,104053,"Andy Roddick",23,16,39,58.97435897435897
2012,104068,"Robby Ginepri",2,4,6,33.333333333333336
2012,104098,"Dmitry Tursunov",3,11,14,21.428571428571427
2012,104122,"Carlos Berlocq",25,30,55,45.45454545454545
2012,104154,"Paul Capdeville",1,5,6,16.666666666666668
2012,104166,"Alex Bogomolov Jr",14,29,43,32.55813953488372
2012,104180,"Gilles Muller",21,21,42,50
2012,104198,"Guillermo Garcia Lopez",20,25,45,44.44444444444444
2012,104214,"Igor Andreev",12,16,28,42.857142857142854
2012,104225,"Jan Hajek",4,7,11,36.36363636363637
2012,104229,"Yen Hsun Lu",12,18,30,40
2012,104252,"Florian Mayer",21,25,46,45.65217391304348
2012,104256,"Clement Reix",1,1,2,50
2012,104259,"Philipp Kohlschreiber",42,25,67,62.6865671641791
2012,104262,"Flavio Cipolla",17,23,40,42.5
2012,104268,"Alejandro Falla",14,24,38,36.8421052631579
2012,104269,"Fernando Verdasco",32,22,54,59.25925925925926
2012,104273,"Edouard Roger Vasselin",14,19,33,42.42424242424242
2012,104291,"Malek Jaziri",6,11,17,35.294117647058826
2012,104292,"Izak Van Der Merwe",2,3,5,40
2012,104297,"Rogerio Dutra Silva",4,5,9,44.44444444444444
2012,104312,"Andreas Seppi",36,25,61,59.01639344262295
2012,104327,"Steve Darcis",19,18,37,51.351351351351354
2012,104330,"Rajeev Ram",7,9,16,43.75
2012,104332,"Philipp Petzschner",11,16,27,40.74074074074074
2012,104338,"Juan Monaco",37,18,55,67.27272727272727
2012,104349,"Rui Machado",1,13,14,7.142857142857143
2012,104371,"Ivo Minar",1,1,2,50
2012,104386,"Janko Tipsarevic",54,27,81,66.66666666666667
2012,104424,"Go Soeda",11,19,30,36.666666666666664
2012,104433,"Frank Dancevic",1,5,6,16.666666666666668
2012,104460,"Dustin Brown",4,5,9,44.44444444444444
2012,104467,"Lamine Ouahab",1,1,2,50
2012,104468,"Gilles Simon",43,24,67,64.17910447761194
2012,104471,"Ivan Dodig",16,24,40,40
2012,104494,"Adrian Ungur",1,12,13,7.6923076923076925
2012,104499,"Jimmy Wang",2,3,5,40
2012,104505,"Konstantin Kravchuk",1,2,3,33.333333333333336
2012,104523,"Frederico Gil",10,12,22,45.45454545454545
2012,104527,"Stan Wawrinka",34,19,53,64.15094339622641
2012,104534,"Dudi Sela",11,17,28,39.285714285714285
2012,104542,"Jo-Wilfried Tsonga",54,24,78,69.23076923076923
2012,104545,"John Isner",41,19,60,68.33333333333333
2012,104547,"Horacio Zeballos",3,9,12,25
2012,104548,"Brian Baker",11,13,24,45.833333333333336
2012,104559,"Teymuraz Gabashvili",1,4,5,20
2012,104571,"Marcos Baghdatis",33,25,58,56.89655172413793
2012,104586,"Lukas Rosol",17,18,35,48.57142857142857
2012,104593,"Daniel Gimeno Traver",6,12,18,33.333333333333336
2012,104594,"Marinko Matosevic",16,19,35,45.714285714285715
2012,104597,"Nicolas Almagro",54,22,76,71.05263157894737
2012,104607,"Tomas Berdych",55,22,77,71.42857142857143
2012,104619,"Jesse Huta Galung",1,2,3,33.333333333333336
2012,104620,"Simone Bolelli",6,10,16,37.5
2012,104639,"Wayne Odesnik",4,6,10,40
2012,104660,"Sergiy Stakhovsky",13,27,40,32.5
2012,104665,"Pablo Andujar",19,29,48,39.583333333333336
2012,104667,"Philipp Oswald",1,1,2,50
2012,104672,"Vincent Millot",1,1,2,50
2012,104676,"Andreas Beck",2,6,8,25
2012,104678,"Viktor Troicki",26,27,53,49.056603773584904
2012,104714,"Julian Reister",1,2,3,33.333333333333336
2012,104719,"Marcel Granollers",22,23,45,48.888888888888886
2012,104724,"Eduardo Schwank",4,4,8,50
2012,104731,"Kevin Anderson",31,26,57,54.3859649122807
2012,104735,"Tobias Kamke",6,18,24,25
2012,104745,"Rafael Nadal",42,7,49,85.71428571428571
2012,104755,"Richard Gasquet",42,22,64,65.625
2012,104770,"Martin Fischer",1,3,4,25
2012,104779,"Jamie Baker",2,3,5,40
2012,104792,"Gael Monfils",18,10,28,64.28571428571429
2012,104797,"Denis Istomin",28,30,58,48.275862068965516
2012,104813,"Grega Zemlja",10,7,17,58.8235294117647
2012,104857,"Robert Farah",3,2,5,60
2012,104868,"James Ward",1,4,5,20
2012,104869,"Sergei Bubka",1,7,8,12.5
2012,104871,"Jeremy Chardy",24,20,44,54.54545454545455
2012,104882,"Blaz Kavcic",4,14,18,22.22222222222222
2012,104897,"Matthias Bachinger",9,16,25,36
2012,104898,"Robin Haase",16,26,42,38.095238095238095
2012,104918,"Andy Murray",59,17,76,77.63157894736842
2012,104919,"Leonardo Mayer",14,14,28,50
2012,104925,"Novak Djokovic",75,12,87,86.20689655172414
2012,104926,"Fabio Fognini",21,24,45,46.666666666666664
2012,104932,"Kenny De Schepper",1,4,5,20
2012,104965,"Pavol Cervenak",3,2,5,60
2012,104976,"Ryan Sweeting",9,11,20,45
2012,104978,"Daniel Brands",5,8,13,38.46153846153846
2012,104979,"Andrey Golubev",3,4,7,42.857142857142854
2012,104997,"Igor Sijsling",8,10,18,44.44444444444444
2012,105004,"Dimitar Kutrovsky",2,1,3,66.66666666666667
2012,105023,"Sam Querrey",37,24,61,60.65573770491803
2012,105028,"Jesse Levine",7,15,22,31.818181818181817
2012,105041,"Lukas Lacko",12,19,31,38.70967741935484
2012,105051,"Matthew Ebden",15,23,38,39.473684210526315
2012,105053,"Santiago Giraldo",18,20,38,47.36842105263158
2012,105062,"Mikhail Kukushkin",10,14,24,41.666666666666664
2012,105064,"Thomaz Bellucci",24,22,46,52.17391304347826
2012,105065,"Tim Smyczek",3,6,9,33.333333333333336
2012,105074,"Ruben Bemelmans",3,6,9,33.333333333333336
2012,105077,"Albert Ramos",26,30,56,46.42857142857143
2012,105095,"Evgeny Korolev",1,3,4,25
2012,105099,"Antonio Veic",3,5,8,37.5
2012,105113,"Patrik Rosenholm",1,1,2,50
2012,105132,"Jurgen Zopp",7,11,18,38.888888888888886
2012,105137,"Pere Riba",1,7,8,12.5
2012,105138,"Roberto Bautista Agut",3,10,13,23.076923076923077
2012,105147,"Tatsuma Ito",10,15,25,40
2012,105154,"Joao Souza",5,9,14,35.714285714285715
2012,105173,"Adrian Mannarino",1,7,8,12.5
2012,105208,"Ernests Gulbis",12,17,29,41.37931034482759
2012,105216,"Yuichi Sugita",2,3,5,40
2012,105223,"Juan Martin del Potro",62,17,79,78.48101265822785
2012,105226,"Attila Balazs",4,3,7,57.142857142857146
2012,105227,"Marin Cilic",38,18,56,67.85714285714286
2012,105238,"Alexandr Dolgopolov",34,25,59,57.6271186440678
2012,105300,"Sergio Gutierrez Ferrol",2,1,3,66.66666666666667
2012,105311,"Joao Sousa",3,4,7,42.857142857142854
2012,105332,"Benoit Paire",26,26,52,50
2012,105373,"Martin Klizan",16,14,30,53.333333333333336
2012,105379,"Aljaz Bedene",3,4,7,42.857142857142854
2012,105385,"Donald Young",5,24,29,17.24137931034483
2012,105404,"Michael Mcclune",1,1,2,50
2012,105438,"Inigo Cervantes Huegun",2,3,5,40
2012,105449,"Steve Johnson",3,5,8,37.5
2012,105453,"Kei Nishikori",35,18,53,66.0377358490566
2012,105477,"Marco Trungelliti",1,1,2,50
2012,105487,"Facundo Bagnis",1,2,3,33.333333333333336
2012,105558,"Guillaume Rufin",3,7,10,30
2012,105561,"Alessandro Giannessi",1,4,5,20
2012,105575,"Ricardas Berankis",10,5,15,66.66666666666667
2012,105577,"Vasek Pospisil",4,13,17,23.529411764705884
2012,105583,"Dusan Lajovic",1,1,2,50
2012,105585,"Ze Zhang",3,3,6,50
2012,105614,"Bradley Klahn",1,2,3,33.333333333333336
2012,105643,"Federico Delbonis",6,9,15,40
2012,105649,"Cedrik Marcel Stebe",7,15,22,31.818181818181817
2012,105655,"Hiroki Moriya",1,3,4,25
2012,105657,"Marius Copil",3,3,6,50
2012,105668,"Jerzy Janowicz",9,4,13,69.23076923076923
2012,105676,"David Goffin",14,14,28,50
2012,105683,"Milos Raonic",43,21,64,67.1875
2012,105723,"Andrey Kuznetsov",2,5,7,28.571428571428573
2012,105777,"Grigor Dimitrov",24,19,43,55.81395348837209
2012,105874,"Albano Olivetti",2,2,4,50
2012,105894,"Javier Marti",1,5,6,16.666666666666668
2012,105902,"James Duckworth",2,3,5,40
2012,105936,"Filip Krajinovic",1,2,3,33.333333333333336
2012,105992,"Ryan Harrison",22,22,44,50
2012,106026,"Yuki Bhambri",1,1,2,50
2012,106045,"Denis Kudla",2,6,8,25
2012,106058,"Jack Sock",5,7,12,41.666666666666664
2012,106071,"Bernard Tomic",22,26,48,45.833333333333336
2012,106207,"Mate Pavic",2,2,4,50
2012,106233,"Dominic Thiem",1,2,3,33.333333333333336
2012,106261,"Dennis Novikov",1,1,2,50
2013,103105,"Ruben Ramirez Hidalgo",2,6,8,25
2013,103163,"Tommy Haas",47,24,71,66.19718309859155
2013,103188,"Michael Russell",7,15,22,31.818181818181817
2013,103285,"Radek Stepanek",14,16,30,46.666666666666664
2013,103333,"Ivo Karlovic",15,13,28,53.57142857142857
2013,103401,"Jan Hernych",5,5,10,50
2013,103451,"Bjorn Phau",2,6,8,25
2013,103484,"James Blake",9,14,23,39.130434782608695
2013,103565,"Stephane Robert",2,2,4,50
2013,103566,"Michael Llodra",12,15,27,44.44444444444444
2013,103582,"Michael Berrer",2,3,5,40
2013,103598,"Xavier Malisse",13,19,32,40.625
2013,103607,"Victor Estrella",1,1,2,50
2013,103656,"Albert Montanes",18,19,37,48.648648648648646
2013,103694,"Olivier Rochus",2,4,6,33.333333333333336
2013,103708,"Jaroslav Pospisil",1,2,3,33.333333333333336
2013,103720,"Lleyton Hewitt",22,18,40,55
2013,103781,"Jurgen Melzer",25,23,48,52.083333333333336
2013,103786,"Nikolay Davydenko",22,23,45,48.888888888888886
2013,103794,"Benjamin Becker",9,20,29,31.03448275862069
2013,103808,"Potito Starace",1,1,2,50
2013,103812,"Victor Hanescu",18,25,43,41.86046511627907
2013,103813,"Jarkko Nieminen",31,27,58,53.44827586206897
2013,103819,"Roger Federer",45,17,62,72.58064516129032
2013,103835,"Filippo Volandri",5,11,16,31.25
2013,103852,"Feliciano Lopez",30,20,50,60
2013,103888,"Mardy Fish",4,5,9,44.44444444444444
2013,103893,"Paolo Lorenzi",13,24,37,35.13513513513514
2013,103898,"Julien Benneteau",27,25,52,51.92307692307692
2013,103900,"David Nalbandian",6,5,11,54.54545454545455
2013,103908,"Paul Henri Mathieu",6,19,25,24
2013,103917,"Nicolas Mahut",17,7,24,70.83333333333333
2013,103926,"Daniel Munoz de la Nava",2,5,7,28.571428571428573
2013,103970,"David Ferrer",63,24,87,72.41379310344827
2013,103990,"Tommy Robredo",36,20,56,64.28571428571429
2013,103997,"Lukasz Kubot",10,17,27,37.03703703703704
2013,104007,"Andre Ghem",1,1,2,50
2013,104022,"Mikhail Youzhny",39,24,63,61.904761904761905
2013,104026,"Joachim Johansson",1,1,2,50
2013,104035,"Bobby Reynolds",2,4,6,33.333333333333336
2013,104068,"Robby Ginepri",2,2,4,50
2013,104098,"Dmitry Tursunov",30,21,51,58.8235294117647
2013,104122,"Carlos Berlocq",26,24,50,52
2013,104154,"Paul Capdeville",1,1,2,50
2013,104166,"Alex Bogomolov Jr",5,9,14,35.714285714285715
2013,104180,"Gilles Muller",2,8,10,20
2013,104198,"Guillermo Garcia Lopez",20,21,41,48.78048780487805
2013,104216,"Maximo Gonzalez",1,1,2,50
2013,104225,"Jan Hajek",8,15,23,34.78260869565217
2013,104229,"Yen Hsun Lu",17,18,35,48.57142857142857
2013,104250,"Prakash Amritraj",2,2,4,50
2013,104252,"Florian Mayer",27,25,52,51.92307692307692
2013,104259,"Philipp Kohlschreiber",33,25,58,56.89655172413793
2013,104262,"Flavio Cipolla",2,9,11,18.181818181818183
2013,104268,"Alejandro Falla",13,20,33,39.39393939393939
2013,104269,"Fernando Verdasco",27,24,51,52.94117647058823
2013,104273,"Edouard Roger Vasselin",23,26,49,46.93877551020408
2013,104297,"Rogerio Dutra Silva",1,6,7,14.285714285714286
2013,104308,"Michal Przysiezny",10,11,21,47.61904761904762
2013,104312,"Andreas Seppi",28,27,55,50.90909090909091
2013,104327,"Steve Darcis",2,7,9,22.22222222222222
2013,104330,"Rajeev Ram",4,11,15,26.666666666666668
2013,104332,"Philipp Petzschner",3,5,8,37.5
2013,104338,"Juan Monaco",22,21,43,51.16279069767442
2013,104386,"Janko Tipsarevic",19,23,42,45.23809523809524
2013,104424,"Go Soeda",6,15,21,28.571428571428573
2013,104433,"Frank Dancevic",2,3,5,40
2013,104460,"Dustin Brown",2,3,5,40
2013,104468,"Gilles Simon",36,22,58,62.06896551724138
2013,104471,"Ivan Dodig",32,24,56,57.142857142857146
2013,104499,"Jimmy Wang",1,3,4,25
2013,104500,"Somdev Devvarman",11,12,23,47.82608695652174
2013,104505,"Konstantin Kravchuk",1,1,2,50
2013,104516,"Arnau Brugues Davi",1,2,3,33.333333333333336
2013,104527,"Stan Wawrinka",49,23,72,68.05555555555556
2013,104534,"Dudi Sela",4,7,11,36.36363636363637
2013,104542,"Jo-Wilfried Tsonga",36,16,52,69.23076923076923
2013,104545,"John Isner",38,22,60,63.333333333333336
2013,104547,"Horacio Zeballos",14,23,37,37.83783783783784
2013,104548,"Brian Baker",3,5,8,37.5
2013,104559,"Teymuraz Gabashvili",2,2,4,50
2013,104571,"Marcos Baghdatis",14,22,36,38.888888888888886
2013,104586,"Lukas Rosol",21,25,46,45.65217391304348
2013,104589,"Chris Guccione",1,1,2,50
2013,104593,"Daniel Gimeno Traver",14,27,41,34.146341463414636
2013,104594,"Marinko Matosevic",18,24,42,42.857142857142854
2013,104597,"Nicolas Almagro",42,23,65,64.61538461538461
2013,104607,"Tomas Berdych",51,24,75,68
2013,104620,"Simone Bolelli",6,8,14,42.857142857142854
2013,104639,"Wayne Odesnik",2,3,5,40
2013,104651,"Martin Alund",6,8,14,42.857142857142854
2013,104655,"Pablo Cuevas",2,4,6,33.333333333333336
2013,104660,"Sergiy Stakhovsky",10,15,25,40
2013,104665,"Pablo Andujar",18,31,49,36.734693877551024
2013,104678,"Viktor Troicki",18,18,36,50
2013,104714,"Julian Reister",3,6,9,33.333333333333336
2013,104719,"Marcel Granollers",27,23,50,54
2013,104731,"Kevin Anderson",37,23,60,61.666666666666664
2013,104735,"Tobias Kamke",17,21,38,44.73684210526316
2013,104745,"Rafael Nadal",75,7,82,91.46341463414635
2013,104755,"Richard Gasquet",48,23,71,67.6056338028169
2013,104792,"Gael Monfils",33,22,55,60
2013,104797,"Denis Istomin",30,29,59,50.847457627118644
2013,104804,"Amir Weintraub",1,2,3,33.333333333333336
2013,104813,"Grega Zemlja",13,19,32,40.625
2013,104864,"Alex Kuznetsov",2,4,6,33.333333333333336
2013,104871,"Jeremy Chardy",22,25,47,46.808510638297875
2013,104882,"Blaz Kavcic",10,14,24,41.666666666666664
2013,104890,"Andreas Haider Maurer",3,6,9,33.333333333333336
2013,104897,"Matthias Bachinger",2,6,8,25
2013,104898,"Robin Haase",28,26,54,51.851851851851855
2013,104918,"Andy Murray",41,8,49,83.6734693877551
2013,104919,"Leonardo Mayer",12,18,30,40
2013,104925,"Novak Djokovic",67,9,76,88.15789473684211
2013,104926,"Fabio Fognini",41,26,67,61.19402985074627
2013,104932,"Kenny De Schepper",9,15,24,37.5
2013,104970,"Matteo Viola",4,7,11,36.36363636363637
2013,104978,"Daniel Brands",23,23,46,50
2013,104979,"Andrey Golubev",3,4,7,42.857142857142854
2013,104997,"Igor Sijsling",18,25,43,41.86046511627907
2013,104999,"Mischa Zverev",4,5,9,44.44444444444444
2013,105023,"Sam Querrey",25,21,46,54.34782608695652
2013,105028,"Jesse Levine",6,14,20,30
2013,105032,"Sam Groth",1,3,4,25
2013,105041,"Lukas Lacko",11,16,27,40.74074074074074
2013,105051,"Matthew Ebden",4,11,15,26.666666666666668
2013,105053,"Santiago Giraldo",14,24,38,36.8421052631579
2013,105062,"Mikhail Kukushkin",6,5,11,54.54545454545455
2013,105064,"Thomaz Bellucci",7,16,23,30.434782608695652
2013,105065,"Tim Smyczek",8,11,19,42.10526315789474
2013,105074,"Ruben Bemelmans",3,5,8,37.5
2013,105077,"Albert Ramos",19,22,41,46.34146341463415
2013,105080,"Miloslav Mecir Jr",1,1,2,50
2013,105095,"Evgeny Korolev",1,3,4,25
2013,105128,"Guillermo Olaso",1,2,3,33.333333333333336
2013,105132,"Jurgen Zopp",1,6,7,14.285714285714286
2013,105138,"Roberto Bautista Agut",26,22,48,54.166666666666664
2013,105147,"Tatsuma Ito",2,9,11,18.181818181818183
2013,105154,"Joao Souza",1,4,5,20
2013,105173,"Adrian Mannarino",10,15,25,40
2013,105208,"Ernests Gulbis",32,18,50,64
2013,105216,"Yuichi Sugita",1,3,4,25
2013,105217,"Thiemo De Bakker",7,10,17,41.1764705882353
2013,105223,"Juan Martin del Potro",52,16,68,76.47058823529412
2013,105227,"Marin Cilic",24,13,37,64.86486486486487
2013,105238,"Alexandr Dolgopolov",21,26,47,44.680851063829785
2013,105286,"Greg Jones",1,1,2,50
2013,105311,"Joao Sousa",14,13,27,51.851851851851855
2013,105332,"Benoit Paire",32,30,62,51.61290322580645
2013,105357,"John Millman",2,4,6,33.333333333333336
2013,105373,"Martin Klizan",12,24,36,33.333333333333336
2013,105376,"Peter Gojowczyk",1,1,2,50
2013,105379,"Aljaz Bedene",11,18,29,37.93103448275862
2013,105385,"Donald Young",2,3,5,40
2013,105449,"Steve Johnson",4,10,14,28.571428571428573
2013,105453,"Kei Nishikori",34,19,53,64.15094339622641
2013,105472,"Nils Langer",1,2,3,33.333333333333336
2013,105477,"Marco Trungelliti",1,1,2,50
2013,105526,"Jan Lennard Struff",4,9,13,30.76923076923077
2013,105539,"Evgeny Donskoy",12,19,31,38.70967741935484
2013,105550,"Guido Pella",7,13,20,35
2013,105554,"Daniel Evans",4,2,6,66.66666666666667
2013,105558,"Guillaume Rufin",8,14,22,36.36363636363637
2013,105575,"Ricardas Berankis",11,16,27,40.74074074074074
2013,105577,"Vasek Pospisil",17,15,32,53.125
2013,105614,"Bradley Klahn",1,3,4,25
2013,105633,"Mohamed Safwat",1,1,2,50
2013,105643,"Federico Delbonis",12,8,20,60
2013,105649,"Cedrik Marcel Stebe",2,3,5,40
2013,105657,"Marius Copil",1,5,6,16.666666666666668
2013,105668,"Jerzy Janowicz",23,20,43,53.48837209302326
2013,105671,"Gastao Elias",2,3,5,40
2013,105676,"David Goffin",10,22,32,31.25
2013,105683,"Milos Raonic",41,21,62,66.12903225806451
2013,105723,"Andrey Kuznetsov",8,19,27,29.62962962962963
2013,105732,"Pierre Hugues Herbert",1,2,3,33.333333333333336
2013,105733,"Rhyne Williams",5,11,16,31.25
2013,105777,"Grigor Dimitrov",35,23,58,60.3448275862069
2013,105806,"Mirza Basic",2,2,4,50
2013,105807,"Pablo Carreno Busta",7,7,14,50
2013,105874,"Albano Olivetti",1,2,3,33.333333333333336
2013,105877,"Emilio Gomez",1,1,2,50
2013,105902,"James Duckworth",3,7,10,30
2013,105916,"Marton Fucsovics",1,1,2,50
2013,105967,"Henri Laaksonen",2,4,6,33.333333333333336
2013,105992,"Ryan Harrison",11,21,32,34.375
2013,106043,"Diego Schwartzman",1,5,6,16.666666666666668
2013,106045,"Denis Kudla",5,11,16,31.25
2013,106058,"Jack Sock",10,13,23,43.47826086956522
2013,106071,"Bernard Tomic",21,22,43,48.83720930232558
2013,106233,"Dominic Thiem",4,2,6,66.66666666666667
2013,106290,"Filip Peliwo",1,1,2,50
2013,106298,"Lucas Pouille",1,4,5,20
2013,106328,"Christian Harrison",1,1,2,50
2013,106378,"Kyle Edmund",1,3,4,25
2013,106401,"Nick Kyrgios",1,2,3,33.333333333333336
2013,106426,"Cristian Garin",1,1,2,50
2013,111575,"Karen Khachanov",3,2,5,60
2014,100644,"Alexander Zverev",4,6,10,40
2014,102967,"Marc Gicquel",2,1,3,66.66666666666667
2014,103163,"Tommy Haas",14,11,25,56
2014,103188,"Michael Russell",6,11,17,35.294117647058826
2014,103285,"Radek Stepanek",16,17,33,48.484848484848484
2014,103333,"Ivo Karlovic",36,28,64,56.25
2014,103401,"Jan Hernych",1,1,2,50
2014,103451,"Bjorn Phau",3,2,5,60
2014,103565,"Stephane Robert",5,8,13,38.46153846153846
2014,103566,"Michael Llodra",4,6,10,40
2014,103582,"Michael Berrer",3,6,9,33.333333333333336
2014,103607,"Victor Estrella",8,9,17,47.05882352941177
2014,103656,"Albert Montanes",13,16,29,44.827586206896555
2014,103720,"Lleyton Hewitt",19,15,34,55.88235294117647
2014,103781,"Jurgen Melzer",14,20,34,41.1764705882353
2014,103786,"Nikolay Davydenko",6,11,17,35.294117647058826
2014,103794,"Benjamin Becker",27,26,53,50.943396226415096
2014,103808,"Potito Starace",1,2,3,33.333333333333336
2014,103812,"Victor Hanescu",11,15,26,42.30769230769231
2014,103813,"Jarkko Nieminen",23,26,49,46.93877551020408
2014,103819,"Roger Federer",68,12,80,85
2014,103835,"Filippo Volandri",1,16,17,5.882352941176471
2014,103852,"Feliciano Lopez",40,25,65,61.53846153846154
2014,103893,"Paolo Lorenzi",11,14,25,44
2014,103898,"Julien Benneteau",25,22,47,53.191489361702125
2014,103908,"Paul Henri Mathieu",11,17,28,39.285714285714285
2014,103917,"Nicolas Mahut",14,23,37,37.83783783783784
2014,103970,"David Ferrer",55,24,79,69.62025316455696
2014,103990,"Tommy Robredo",43,26,69,62.31884057971015
2014,103997,"Lukasz Kubot",5,12,17,29.41176470588235
2014,104022,"Mikhail Youzhny",18,24,42,42.857142857142854
2014,104068,"Robby Ginepri",3,8,11,27.272727272727273
2014,104098,"Dmitry Tursunov",13,19,32,40.625
2014,104122,"Carlos Berlocq",17,17,34,50
2014,104166,"Alex Bogomolov Jr",2,6,8,25
2014,104180,"Gilles Muller",4,6,10,40
2014,104198,"Guillermo Garcia Lopez",25,26,51,49.01960784313726
2014,104216,"Maximo Gonzalez",3,4,7,42.857142857142854
2014,104229,"Yen Hsun Lu",24,23,47,51.06382978723404
2014,104252,"Florian Mayer",7,7,14,50
2014,104259,"Philipp Kohlschreiber",36,25,61,59.01639344262295
2014,104268,"Alejandro Falla",9,17,26,34.61538461538461
2014,104269,"Fernando Verdasco",26,20,46,56.52173913043478
2014,104273,"Edouard Roger Vasselin",21,28,49,42.857142857142854
2014,104291,"Malek Jaziri",8,11,19,42.10526315789474
2014,104297,"Rogerio Dutra Silva",1,1,2,50
2014,104308,"Michal Przysiezny",4,18,22,18.181818181818183
2014,104312,"Andreas Seppi",23,28,51,45.09803921568628
2014,104330,"Rajeev Ram",3,7,10,30
2014,104332,"Philipp Petzschner",1,2,3,33.333333333333336
2014,104338,"Juan Monaco",22,19,41,53.65853658536585
2014,104349,"Rui Machado",1,1,2,50
2014,104424,"Go Soeda",1,3,4,25
2014,104433,"Frank Dancevic",2,6,8,25
2014,104460,"Dustin Brown",13,16,29,44.827586206896555
2014,104468,"Gilles Simon",28,25,53,52.83018867924528
2014,104471,"Ivan Dodig",15,23,38,39.473684210526315
2014,104476,"Louk Sorensen",1,1,2,50
2014,104494,"Adrian Ungur",1,2,3,33.333333333333336
2014,104499,"Jimmy Wang",4,5,9,44.44444444444444
2014,104500,"Somdev Devvarman",3,10,13,23.076923076923077
2014,104527,"Stan Wawrinka",38,16,54,70.37037037037037
2014,104534,"Dudi Sela",16,19,35,45.714285714285715
2014,104542,"Jo-Wilfried Tsonga",34,17,51,66.66666666666667
2014,104545,"John Isner",37,21,58,63.793103448275865
2014,104547,"Horacio Zeballos",7,9,16,43.75
2014,104559,"Teymuraz Gabashvili",18,26,44,40.90909090909091
2014,104571,"Marcos Baghdatis",7,11,18,38.888888888888886
2014,104586,"Lukas Rosol",28,26,54,51.851851851851855
2014,104593,"Daniel Gimeno Traver",11,20,31,35.483870967741936
2014,104594,"Marinko Matosevic",22,22,44,50
2014,104597,"Nicolas Almagro",15,10,25,60
2014,104607,"Tomas Berdych",53,22,75,70.66666666666667
2014,104619,"Jesse Huta Galung",1,5,6,16.666666666666668
2014,104620,"Simone Bolelli",6,8,14,42.857142857142854
2014,104628,"Alexander Kudryavtsev",2,2,4,50
2014,104651,"Martin Alund",1,2,3,33.333333333333336
2014,104655,"Pablo Cuevas",17,12,29,58.62068965517241
2014,104660,"Sergiy Stakhovsky",15,19,34,44.11764705882353
2014,104665,"Pablo Andujar",23,22,45,51.111111111111114
2014,104672,"Vincent Millot",1,2,3,33.333333333333336
2014,104678,"Viktor Troicki",8,4,12,66.66666666666667
2014,104714,"Julian Reister",1,10,11,9.090909090909092
2014,104719,"Marcel Granollers",19,28,47,40.42553191489362
2014,104731,"Kevin Anderson",39,24,63,61.904761904761905
2014,104735,"Tobias Kamke",9,16,25,36
2014,104745,"Rafael Nadal",49,11,60,81.66666666666667
2014,104755,"Richard Gasquet",29,19,48,60.416666666666664
2014,104792,"Gael Monfils",32,15,47,68.08510638297872
2014,104797,"Denis Istomin",27,24,51,52.94117647058823
2014,104864,"Alex Kuznetsov",3,8,11,27.272727272727273
2014,104868,"James Ward",4,10,14,28.571428571428573
2014,104871,"Jeremy Chardy",33,27,60,55
2014,104873,"Aleksandr Nedovyesov",4,14,18,22.22222222222222
2014,104882,"Blaz Kavcic",5,7,12,41.666666666666664
2014,104890,"Andreas Haider Maurer",4,7,11,36.36363636363637
2014,104897,"Matthias Bachinger",4,2,6,66.66666666666667
2014,104898,"Robin Haase",15,23,38,39.473684210526315
2014,104918,"Andy Murray",57,19,76,75
2014,104919,"Leonardo Mayer",26,20,46,56.52173913043478
2014,104925,"Novak Djokovic",65,8,73,89.04109589041096
2014,104926,"Fabio Fognini",36,24,60,60
2014,104932,"Kenny De Schepper",7,19,26,26.923076923076923
2014,104978,"Daniel Brands",2,11,13,15.384615384615385
2014,104979,"Andrey Golubev",9,22,31,29.032258064516128
2014,104997,"Igor Sijsling",9,26,35,25.714285714285715
2014,105011,"Illya Marchenko",2,4,6,33.333333333333336
2014,105023,"Sam Querrey",26,20,46,56.52173913043478
2014,105032,"Sam Groth",9,13,22,40.90909090909091
2014,105041,"Lukas Lacko",11,17,28,39.285714285714285
2014,105047,"Tim Puetz",1,1,2,50
2014,105051,"Matthew Ebden",5,21,26,19.23076923076923
2014,105053,"Santiago Giraldo",28,27,55,50.90909090909091
2014,105062,"Mikhail Kukushkin",15,24,39,38.46153846153846
2014,105064,"Thomaz Bellucci",16,13,29,55.172413793103445
2014,105065,"Tim Smyczek",7,12,19,36.8421052631579
2014,105077,"Albert Ramos",13,20,33,39.39393939393939
2014,105132,"Jurgen Zopp",1,2,3,33.333333333333336
2014,105137,"Pere Riba",3,11,14,21.428571428571427
2014,105138,"Roberto Bautista Agut",44,21,65,67.6923076923077
2014,105147,"Tatsuma Ito",3,5,8,37.5
2014,105154,"Joao Souza",1,3,4,25
2014,105161,"Yann Marti",2,2,4,50
2014,105166,"Peter Polansky",2,6,8,25
2014,105173,"Adrian Mannarino",16,23,39,41.02564102564103
2014,105208,"Ernests Gulbis",41,21,62,66.12903225806451
2014,105217,"Thiemo De Bakker",7,6,13,53.84615384615385
2014,105223,"Juan Martin del Potro",7,3,10,70
2014,105227,"Marin Cilic",51,21,72,70.83333333333333
2014,105238,"Alexandr Dolgopolov",27,22,49,55.10204081632653
2014,105292,"Alejandro Gonzalez",9,19,28,32.142857142857146
2014,105302,"Ante Pavic",2,6,8,25
2014,105311,"Joao Sousa",23,34,57,40.35087719298246
2014,105332,"Benoit Paire",10,19,29,34.48275862068966
2014,105373,"Martin Klizan",23,16,39,58.97435897435897
2014,105376,"Peter Gojowczyk",7,8,15,46.666666666666664
2014,105379,"Aljaz Bedene",5,9,14,35.714285714285715
2014,105385,"Donald Young",18,21,39,46.15384615384615
2014,105430,"Radu Albot",1,4,5,20
2014,105438,"Inigo Cervantes Huegun",2,3,5,40
2014,105449,"Steve Johnson",20,20,40,50
2014,105453,"Kei Nishikori",52,15,67,77.61194029850746
2014,105487,"Facundo Bagnis",2,3,5,40
2014,105526,"Jan Lennard Struff",15,17,32,46.875
2014,105539,"Evgeny Donskoy",3,9,12,25
2014,105550,"Guido Pella",3,4,7,42.857142857142854
2014,105554,"Daniel Evans",4,6,10,40
2014,105572,"Austin Krajicek",1,1,2,50
2014,105575,"Ricardas Berankis",6,7,13,46.15384615384615
2014,105577,"Vasek Pospisil",20,24,44,45.45454545454545
2014,105583,"Dusan Lajovic",14,17,31,45.16129032258065
2014,105614,"Bradley Klahn",2,11,13,15.384615384615385
2014,105641,"Blaz Rola",4,9,13,30.76923076923077
2014,105643,"Federico Delbonis",20,27,47,42.5531914893617
2014,105657,"Marius Copil",6,6,12,50
2014,105668,"Jerzy Janowicz",22,24,46,47.82608695652174
2014,105671,"Gastao Elias",3,6,9,33.333333333333336
2014,105676,"David Goffin",22,14,36,61.111111111111114
2014,105678,"Axel Michon",1,1,2,50
2014,105683,"Milos Raonic",47,20,67,70.14925373134328
2014,105723,"Andrey Kuznetsov",8,8,16,50
2014,105732,"Pierre Hugues Herbert",5,11,16,31.25
2014,105733,"Rhyne Williams",2,4,6,33.333333333333336
2014,105777,"Grigor Dimitrov",50,18,68,73.52941176470588
2014,105807,"Pablo Carreno Busta",14,25,39,35.8974358974359
2014,105872,"Christian Lindell",1,2,3,33.333333333333336
2014,105874,"Albano Olivetti",2,4,6,33.333333333333336
2014,105902,"James Duckworth",1,7,8,12.5
2014,105934,"Chuhan Wang",1,1,2,50
2014,105936,"Filip Krajinovic",4,4,8,50
2014,105952,"Renzo Olivo",2,1,3,66.66666666666667
2014,105967,"Henri Laaksonen",1,3,4,25
2014,105992,"Ryan Harrison",5,13,18,27.77777777777778
2014,106000,"Damir Dzumhur",2,4,6,33.333333333333336
2014,106026,"Yuki Bhambri",2,1,3,66.66666666666667
2014,106043,"Diego Schwartzman",2,4,6,33.333333333333336
2014,106045,"Denis Kudla",3,5,8,37.5
2014,106053,"Philip Davydenko",1,1,2,50
2014,106058,"Jack Sock",27,20,47,57.4468085106383
2014,106071,"Bernard Tomic",17,16,33,51.515151515151516
2014,106121,"Taro Daniel",2,5,7,28.571428571428573
2014,106148,"Roberto Carballes Baena",3,3,6,50
2014,106186,"Jason Kubler",1,1,2,50
2014,106207,"Mate Pavic",1,2,3,33.333333333333336
2014,106210,"Jiri Vesely",14,17,31,45.16129032258065
2014,106233,"Dominic Thiem",22,23,45,48.888888888888886
2014,106243,"Mate Delic",2,5,7,28.571428571428573
2014,106290,"Filip Peliwo",1,2,3,33.333333333333336
2014,106291,"Luke Saville",2,2,4,50
2014,106298,"Lucas Pouille",2,4,6,33.333333333333336
2014,106368,"Ramkumar Ramanathan",1,1,2,50
2014,106401,"Nick Kyrgios",8,7,15,53.333333333333336
2014,106423,"Thanasi Kokkinakis",2,6,8,25
2014,106432,"Borna Coric",6,5,11,54.54545454545455
2014,110748,"Nikola Milojevic",1,1,2,50
2014,111200,"Elias Ymer",1,2,3,33.333333333333336
2015,100644,"Alexander Zverev",14,17,31,45.16129032258065
2015,103163,"Tommy Haas",2,9,11,18.181818181818183
2015,103285,"Radek Stepanek",7,10,17,41.1764705882353
2015,103333,"Ivo Karlovic",38,25,63,60.317460317460316
2015,103401,"Jan Hernych",2,2,4,50
2015,103565,"Stephane Robert",1,6,7,14.285714285714286
2015,103582,"Michael Berrer",6,10,16,37.5
2015,103607,"Victor Estrella",15,19,34,44.11764705882353
2015,103656,"Albert Montanes",7,8,15,46.666666666666664
2015,103720,"Lleyton Hewitt",3,9,12,25
2015,103781,"Jurgen Melzer",9,11,20,45
2015,103794,"Benjamin Becker",10,21,31,32.25806451612903
2015,103812,"Victor Hanescu",1,1,2,50
2015,103813,"Jarkko Nieminen",9,17,26,34.61538461538461
2015,103819,"Roger Federer",61,11,72,84.72222222222223
2015,103843,"Marco Chiudinelli",1,3,4,25
2015,103852,"Feliciano Lopez",32,26,58,55.172413793103445
2015,103888,"Mardy Fish",2,4,6,33.333333333333336
2015,103893,"Paolo Lorenzi",7,18,25,28
2015,103898,"Julien Benneteau",1,5,6,16.666666666666668
2015,103908,"Paul Henri Mathieu",7,12,19,36.8421052631579
2015,103917,"Nicolas Mahut",11,10,21,52.38095238095238
2015,103970,"David Ferrer",53,16,69,76.81159420289855
2015,103990,"Tommy Robredo",23,20,43,53.48837209302326
2015,103997,"Lukasz Kubot",1,2,3,33.333333333333336
2015,104022,"Mikhail Youzhny",9,24,33,27.272727272727273
2015,104122,"Carlos Berlocq",7,9,16,43.75
2015,104180,"Gilles Muller",31,24,55,56.36363636363637
2015,104198,"Guillermo Garcia Lopez",32,25,57,56.14035087719298
2015,104229,"Yen Hsun Lu",16,22,38,42.10526315789474
2015,104252,"Florian Mayer",4,9,13,30.76923076923077
2015,104259,"Philipp Kohlschreiber",30,22,52,57.69230769230769
2015,104268,"Alejandro Falla",7,11,18,38.888888888888886
2015,104269,"Fernando Verdasco",24,26,50,48
2015,104273,"Edouard Roger Vasselin",6,12,18,33.333333333333336
2015,104291,"Malek Jaziri",12,20,32,37.5
2015,104312,"Andreas Seppi",26,24,50,52
2015,104327,"Steve Darcis",8,11,19,42.10526315789474
2015,104330,"Rajeev Ram",7,6,13,53.84615384615385
2015,104338,"Juan Monaco",21,19,40,52.5
2015,104349,"Rui Machado",1,1,2,50
2015,104386,"Janko Tipsarevic",3,7,10,30
2015,104424,"Go Soeda",6,12,18,33.333333333333336
2015,104460,"Dustin Brown",10,15,25,40
2015,104467,"Lamine Ouahab",2,1,3,66.66666666666667
2015,104468,"Gilles Simon",41,22,63,65.07936507936508
2015,104471,"Ivan Dodig",8,11,19,42.10526315789474
2015,104527,"Stan Wawrinka",54,19,73,73.97260273972603
2015,104534,"Dudi Sela",7,9,16,43.75
2015,104542,"Jo-Wilfried Tsonga",32,15,47,68.08510638297872
2015,104545,"John Isner",45,23,68,66.17647058823529
2015,104547,"Horacio Zeballos",2,4,6,33.333333333333336
2015,104559,"Teymuraz Gabashvili",16,21,37,43.24324324324324
2015,104563,"Luca Vanni",4,9,13,30.76923076923077
2015,104571,"Marcos Baghdatis",26,19,45,57.77777777777778
2015,104586,"Lukas Rosol",19,28,47,40.42553191489362
2015,104593,"Daniel Gimeno Traver",13,18,31,41.935483870967744
2015,104594,"Marinko Matosevic",3,16,19,15.789473684210526
2015,104597,"Nicolas Almagro",18,20,38,47.36842105263158
2015,104607,"Tomas Berdych",57,22,79,72.15189873417721
2015,104620,"Simone Bolelli",28,25,53,52.83018867924528
2015,104629,"Adrian Menendez Maceiras",1,4,5,20
2015,104655,"Pablo Cuevas",28,25,53,52.83018867924528
2015,104660,"Sergiy Stakhovsky",20,25,45,44.44444444444444
2015,104665,"Pablo Andujar",16,22,38,42.10526315789474
2015,104678,"Viktor Troicki",33,27,60,55
2015,104714,"Julian Reister",1,2,3,33.333333333333336
2015,104719,"Marcel Granollers",14,21,35,40
2015,104731,"Kevin Anderson",46,24,70,65.71428571428571
2015,104735,"Tobias Kamke",1,5,6,16.666666666666668
2015,104745,"Rafael Nadal",60,20,80,75
2015,104755,"Richard Gasquet",43,17,60,71.66666666666667
2015,104792,"Gael Monfils",33,18,51,64.70588235294117
2015,104797,"Denis Istomin",20,23,43,46.51162790697674
2015,104868,"James Ward",3,10,13,23.076923076923077
2015,104871,"Jeremy Chardy",27,27,54,50
2015,104882,"Blaz Kavcic",3,10,13,23.076923076923077
2015,104890,"Andreas Haider Maurer",19,26,45,42.22222222222222
2015,104897,"Matthias Bachinger",2,4,6,33.333333333333336
2015,104898,"Robin Haase",14,20,34,41.1764705882353
2015,104918,"Andy Murray",63,15,78,80.76923076923077
2015,104919,"Leonardo Mayer",24,23,47,51.06382978723404
2015,104925,"Novak Djokovic",82,6,88,93.18181818181819
2015,104926,"Fabio Fognini",30,25,55,54.54545454545455
2015,104932,"Kenny De Schepper",4,10,14,28.571428571428573
2015,104947,"Marsel Ilhan",8,14,22,36.36363636363637
2015,104978,"Daniel Brands",2,1,3,66.66666666666667
2015,104979,"Andrey Golubev",3,10,13,23.076923076923077
2015,104997,"Igor Sijsling",3,10,13,23.076923076923077
2015,104999,"Mischa Zverev",7,8,15,46.666666666666664
2015,105011,"Illya Marchenko",3,7,10,30
2015,105023,"Sam Querrey",20,24,44,45.45454545454545
2015,105030,"Michael Venus",1,2,3,33.333333333333336
2015,105032,"Sam Groth",18,21,39,46.15384615384615
2015,105041,"Lukas Lacko",2,12,14,14.285714285714286
2015,105051,"Matthew Ebden",1,6,7,14.285714285714286
2015,105053,"Santiago Giraldo",21,26,47,44.680851063829785
2015,105062,"Mikhail Kukushkin",16,23,39,41.02564102564103
2015,105063,"Andrea Arnaboldi",1,3,4,25
2015,105064,"Thomaz Bellucci",29,27,56,51.785714285714285
2015,105065,"Tim Smyczek",5,13,18,27.77777777777778
2015,105074,"Ruben Bemelmans",3,8,11,27.272727272727273
2015,105077,"Albert Ramos",16,23,39,41.02564102564103
2015,105138,"Roberto Bautista Agut",41,29,70,58.57142857142857
2015,105147,"Tatsuma Ito",8,11,19,42.10526315789474
2015,105154,"Joao Souza",6,16,22,27.272727272727273
2015,105173,"Adrian Mannarino",28,30,58,48.275862068965516
2015,105208,"Ernests Gulbis",11,24,35,31.428571428571427
2015,105216,"Yuichi Sugita",2,6,8,25
2015,105217,"Thiemo De Bakker",2,5,7,28.571428571428573
2015,105223,"Juan Martin del Potro",2,2,4,50
2015,105227,"Marin Cilic",35,19,54,64.81481481481481
2015,105238,"Alexandr Dolgopolov",25,26,51,49.01960784313726
2015,105254,"Nikola Mektic",1,1,2,50
2015,105269,"Marcelo Demoliner",1,1,2,50
2015,105292,"Alejandro Gonzalez",3,11,14,21.428571428571427
2015,105311,"Joao Sousa",34,30,64,53.125
2015,105332,"Benoit Paire",25,17,42,59.523809523809526
2015,105339,"Yan Bai",1,2,3,33.333333333333336
2015,105357,"John Millman",5,9,14,35.714285714285715
2015,105373,"Martin Klizan",24,27,51,47.05882352941177
2015,105376,"Peter Gojowczyk",1,3,4,25
2015,105379,"Aljaz Bedene",17,17,34,50
2015,105385,"Donald Young",21,22,43,48.83720930232558
2015,105430,"Radu Albot",1,4,5,20
2015,105441,"John Patrick Smith",3,5,8,37.5
2015,105449,"Steve Johnson",37,27,64,57.8125
2015,105453,"Kei Nishikori",51,17,68,75
2015,105487,"Facundo Bagnis",2,4,6,33.333333333333336
2015,105512,"Alexander Sarkissian",1,1,2,50
2015,105526,"Jan Lennard Struff",4,18,22,18.181818181818183
2015,105539,"Evgeny Donskoy",5,5,10,50
2015,105542,"Bastian Trinker",1,2,3,33.333333333333336
2015,105550,"Guido Pella",1,4,5,20
2015,105572,"Austin Krajicek",7,11,18,38.888888888888886
2015,105575,"Ricardas Berankis",12,18,30,40
2015,105577,"Vasek Pospisil",24,22,46,52.17391304347826
2015,105583,"Dusan Lajovic",16,21,37,43.24324324324324
2015,105585,"Ze Zhang",1,4,5,20
2015,105589,"Gerald Melzer",3,4,7,42.857142857142854
2015,105641,"Blaz Rola",4,6,10,40
2015,105643,"Federico Delbonis",15,18,33,45.45454545454545
2015,105655,"Hiroki Moriya",1,3,4,25
2015,105657,"Marius Copil",3,5,8,37.5
2015,105668,"Jerzy Janowicz",20,22,42,47.61904761904762
2015,105676,"David Goffin",34,24,58,58.62068965517241
2015,105683,"Milos Raonic",32,15,47,68.08510638297872
2015,105723,"Andrey Kuznetsov",8,12,20,40
2015,105732,"Pierre Hugues Herbert",7,6,13,53.84615384615385
2015,105777,"Grigor Dimitrov",32,22,54,59.25925925925926
2015,105807,"Pablo Carreno Busta",14,25,39,35.8974358974359
2015,105819,"Guido Andreozzi",1,1,2,50
2015,105826,"Alejandro Gomez Gb42",1,1,2,50
2015,105872,"Christian Lindell",1,2,3,33.333333333333336
2015,105902,"James Duckworth",9,11,20,45
2015,105917,"Gianni Mina",1,1,2,50
2015,105932,"Nikoloz Basilashvili",4,8,12,33.333333333333336
2015,105936,"Filip Krajinovic",3,11,14,21.428571428571427
2015,105952,"Renzo Olivo",2,2,4,50
2015,105963,"Arthur De Greef",1,1,2,50
2015,105992,"Ryan Harrison",5,8,13,38.46153846153846
2015,106000,"Damir Dzumhur",7,9,16,43.75
2015,106032,"Facundo Arguello",1,5,6,16.666666666666668
2015,106043,"Diego Schwartzman",11,20,31,35.483870967741936
2015,106045,"Denis Kudla",8,14,22,36.36363636363637
2015,106058,"Jack Sock",33,18,51,64.70588235294117
2015,106071,"Bernard Tomic",37,27,64,57.8125
2015,106121,"Taro Daniel",1,5,6,16.666666666666668
2015,106148,"Roberto Carballes Baena",1,2,3,33.333333333333336
2015,106210,"Jiri Vesely",23,28,51,45.09803921568628
2015,106233,"Dominic Thiem",36,26,62,58.064516129032256
2015,106234,"Aslan Karatsev",1,1,2,50
2015,106281,"Liam Broady",1,1,2,50
2015,106298,"Lucas Pouille",12,14,26,46.15384615384615
2015,106378,"Kyle Edmund",1,5,6,16.666666666666668
2015,106390,"Matteo Donati",1,1,2,50
2015,106401,"Nick Kyrgios",25,18,43,58.13953488372093
2015,106415,"Yoshihito Nishioka",3,5,8,37.5
2015,106423,"Thanasi Kokkinakis",11,17,28,39.285714285714285
2015,106432,"Borna Coric",24,27,51,47.05882352941177
2015,110602,"Dennis Novak",1,2,3,33.333333333333336
2015,111190,"Zhizhen Zhang",1,1,2,50
2015,111200,"Elias Ymer",3,8,11,27.272727272727273
2015,111202,"Hyeon Chung",9,9,18,50
2015,111577,"Jared Donaldson",4,7,11,36.36363636363637
2015,111797,"Nicolas Jarry",1,2,3,33.333333333333336
2015,123755,"Daniel Elahi Galan",1,1,2,50
2015,126094,"Andrey Rublev",6,11,17,35.294117647058826
2015,126203,"Taylor Fritz",1,1,2,50
2015,126207,"Frances Tiafoe",1,5,6,16.666666666666668
2015,144719,"Jaume Munar",1,2,3,33.333333333333336
2016,100644,"Alexander Zverev",44,22,66,66.66666666666667
2016,103285,"Radek Stepanek",10,11,21,47.61904761904762
2016,103333,"Ivo Karlovic",32,22,54,59.25925925925926
2016,103565,"Stephane Robert",14,18,32,43.75
2016,103582,"Michael Berrer",4,9,13,30.76923076923077
2016,103607,"Victor Estrella",12,17,29,41.37931034482759
2016,103656,"Albert Montanes",7,8,15,46.666666666666664
2016,103720,"Lleyton Hewitt",1,1,2,50
2016,103781,"Jurgen Melzer",3,3,6,50
2016,103794,"Benjamin Becker",9,18,27,33.333333333333336
2016,103819,"Roger Federer",21,7,28,75
2016,103843,"Marco Chiudinelli",3,4,7,42.857142857142854
2016,103852,"Feliciano Lopez",29,24,53,54.716981132075475
2016,103893,"Paolo Lorenzi",24,25,49,48.97959183673469
2016,103898,"Julien Benneteau",7,14,21,33.333333333333336
2016,103902,"Jan Mertl",1,1,2,50
2016,103908,"Paul Henri Mathieu",18,20,38,47.36842105263158
2016,103917,"Nicolas Mahut",23,20,43,53.48837209302326
2016,103926,"Daniel Munoz de la Nava",3,13,16,18.75
2016,103970,"David Ferrer",34,23,57,59.64912280701754
2016,103990,"Tommy Robredo",2,6,8,25
2016,104022,"Mikhail Youzhny",17,20,37,45.945945945945944
2016,104098,"Dmitry Tursunov",1,7,8,12.5
2016,104122,"Carlos Berlocq",4,6,10,40
2016,104180,"Gilles Muller",35,24,59,59.32203389830509
2016,104198,"Guillermo Garcia Lopez",22,31,53,41.509433962264154
2016,104216,"Maximo Gonzalez",2,5,7,28.571428571428573
2016,104229,"Yen Hsun Lu",7,9,16,43.75
2016,104252,"Florian Mayer",10,11,21,47.61904761904762
2016,104259,"Philipp Kohlschreiber",30,23,53,56.60377358490566
2016,104268,"Alejandro Falla",1,1,2,50
2016,104269,"Fernando Verdasco",29,26,55,52.72727272727273
2016,104273,"Edouard Roger Vasselin",2,3,5,40
2016,104291,"Malek Jaziri",15,22,37,40.54054054054054
2016,104297,"Rogerio Dutra Silva",2,8,10,20
2016,104312,"Andreas Seppi",19,24,43,44.18604651162791
2016,104327,"Steve Darcis",3,5,8,37.5
2016,104330,"Rajeev Ram",12,19,31,38.70967741935484
2016,104338,"Juan Monaco",17,14,31,54.83870967741935
2016,104386,"Janko Tipsarevic",7,10,17,41.1764705882353
2016,104433,"Frank Dancevic",3,3,6,50
2016,104460,"Dustin Brown",13,12,25,52
2016,104468,"Gilles Simon",32,26,58,55.172413793103445
2016,104471,"Ivan Dodig",7,16,23,30.434782608695652
2016,104494,"Adrian Ungur",1,3,4,25
2016,104505,"Konstantin Kravchuk",1,4,5,20
2016,104527,"Stan Wawrinka",46,18,64,71.875
2016,104534,"Dudi Sela",10,17,27,37.03703703703704
2016,104542,"Jo-Wilfried Tsonga",35,16,51,68.62745098039215
2016,104545,"John Isner",30,20,50,60
2016,104547,"Horacio Zeballos",7,13,20,35
2016,104548,"Brian Baker",2,10,12,16.666666666666668
2016,104559,"Teymuraz Gabashvili",10,22,32,31.25
2016,104563,"Luca Vanni",1,5,6,16.666666666666668
2016,104571,"Marcos Baghdatis",26,23,49,53.06122448979592
2016,104586,"Lukas Rosol",14,23,37,37.83783783783784
2016,104593,"Daniel Gimeno Traver",8,10,18,44.44444444444444
2016,104597,"Nicolas Almagro",22,22,44,50
2016,104607,"Tomas Berdych",39,19,58,67.24137931034483
2016,104620,"Simone Bolelli",2,8,10,20
2016,104655,"Pablo Cuevas",34,23,57,59.64912280701754
2016,104660,"Sergiy Stakhovsky",6,13,19,31.57894736842105
2016,104665,"Pablo Andujar",1,7,8,12.5
2016,104672,"Vincent Millot",3,4,7,42.857142857142854
2016,104678,"Viktor Troicki",33,28,61,54.09836065573771
2016,104719,"Marcel Granollers",22,25,47,46.808510638297875
2016,104731,"Kevin Anderson",17,21,38,44.73684210526316
2016,104735,"Tobias Kamke",5,5,10,50
2016,104745,"Rafael Nadal",40,15,55,72.72727272727273
2016,104755,"Richard Gasquet",33,17,50,66
2016,104792,"Gael Monfils",43,18,61,70.49180327868852
2016,104797,"Denis Istomin",6,20,26,23.076923076923077
2016,104813,"Grega Zemlja",1,1,2,50
2016,104871,"Jeremy Chardy",17,21,38,44.73684210526316
2016,104898,"Robin Haase",14,20,34,41.1764705882353
2016,104918,"Andy Murray",77,8,85,90.58823529411765
2016,104919,"Leonardo Mayer",9,15,24,37.5
2016,104925,"Novak Djokovic",64,9,73,87.67123287671232
2016,104926,"Fabio Fognini",25,22,47,53.191489361702125
2016,104932,"Kenny De Schepper",1,5,6,16.666666666666668
2016,104978,"Daniel Brands",2,4,6,33.333333333333336
2016,104997,"Igor Sijsling",4,7,11,36.36363636363637
2016,104999,"Mischa Zverev",12,14,26,46.15384615384615
2016,105011,"Illya Marchenko",14,20,34,41.1764705882353
2016,105015,"Franko Skugor",1,5,6,16.666666666666668
2016,105023,"Sam Querrey",28,23,51,54.90196078431372
2016,105032,"Sam Groth",4,14,18,22.22222222222222
2016,105041,"Lukas Lacko",4,7,11,36.36363636363637
2016,105053,"Santiago Giraldo",8,13,21,38.095238095238095
2016,105062,"Mikhail Kukushkin",11,20,31,35.483870967741936
2016,105063,"Andrea Arnaboldi",2,3,5,40
2016,105064,"Thomaz Bellucci",17,22,39,43.58974358974359
2016,105065,"Tim Smyczek",8,10,18,44.44444444444444
2016,105074,"Ruben Bemelmans",2,2,4,50
2016,105077,"Albert Ramos",34,31,65,52.30769230769231
2016,105098,"Alexandre Sidorenko",1,1,2,50
2016,105132,"Jurgen Zopp",1,2,3,33.333333333333336
2016,105138,"Roberto Bautista Agut",49,23,72,68.05555555555556
2016,105147,"Tatsuma Ito",3,4,7,42.857142857142854
2016,105154,"Joao Souza",1,2,3,33.333333333333336
2016,105166,"Peter Polansky",1,2,3,33.333333333333336
2016,105173,"Adrian Mannarino",26,28,54,48.148148148148145
2016,105208,"Ernests Gulbis",7,14,21,33.333333333333336
2016,105216,"Yuichi Sugita",6,10,16,37.5
2016,105217,"Thiemo De Bakker",5,12,17,29.41176470588235
2016,105223,"Juan Martin del Potro",29,12,41,70.73170731707317
2016,105227,"Marin Cilic",44,21,65,67.6923076923077
2016,105238,"Alexandr Dolgopolov",17,18,35,48.57142857142857
2016,105254,"Nikola Mektic",1,2,3,33.333333333333336
2016,105302,"Ante Pavic",1,1,2,50
2016,105311,"Joao Sousa",25,33,58,43.10344827586207
2016,105332,"Benoit Paire",23,32,55,41.81818181818182
2016,105341,"Thomas Fabbiano",5,10,15,33.333333333333336
2016,105357,"John Millman",19,21,40,47.5
2016,105373,"Martin Klizan",14,15,29,48.275862068965516
2016,105376,"Peter Gojowczyk",1,2,3,33.333333333333336
2016,105379,"Aljaz Bedene",12,19,31,38.70967741935484
2016,105385,"Donald Young",18,21,39,46.15384615384615
2016,105413,"Andrej Martin",9,4,13,69.23076923076923
2016,105430,"Radu Albot",4,11,15,26.666666666666668
2016,105438,"Inigo Cervantes Huegun",13,23,36,36.111111111111114
2016,105441,"John Patrick Smith",2,4,6,33.333333333333336
2016,105449,"Steve Johnson",30,28,58,51.724137931034484
2016,105453,"Kei Nishikori",57,21,78,73.07692307692308
2016,105477,"Marco Trungelliti",2,4,6,33.333333333333336
2016,105487,"Facundo Bagnis",6,11,17,35.294117647058826
2016,105512,"Alexander Sarkissian",1,2,3,33.333333333333336
2016,105526,"Jan Lennard Struff",11,18,29,37.93103448275862
2016,105539,"Evgeny Donskoy",7,19,26,26.923076923076923
2016,105550,"Guido Pella",14,22,36,38.888888888888886
2016,105554,"Daniel Evans",9,8,17,52.94117647058823
2016,105561,"Alessandro Giannessi",1,1,2,50
2016,105572,"Austin Krajicek",4,9,13,30.76923076923077
2016,105575,"Ricardas Berankis",8,15,23,34.78260869565217
2016,105577,"Vasek Pospisil",9,22,31,29.032258064516128
2016,105583,"Dusan Lajovic",18,22,40,45
2016,105589,"Gerald Melzer",3,6,9,33.333333333333336
2016,105596,"Jan Satral",1,2,3,33.333333333333336
2016,105641,"Blaz Rola",1,1,2,50
2016,105643,"Federico Delbonis",24,23,47,51.06382978723404
2016,105650,"Marcus Willis",1,1,2,50
2016,105657,"Marius Copil",3,4,7,42.857142857142854
2016,105671,"Gastao Elias",12,13,25,48
2016,105676,"David Goffin",46,25,71,64.78873239436619
2016,105677,"Nikola Cacic",1,1,2,50
2016,105683,"Milos Raonic",52,19,71,73.2394366197183
2016,105723,"Andrey Kuznetsov",27,21,48,56.25
2016,105731,"Steven Diez",1,3,4,25
2016,105732,"Pierre Hugues Herbert",7,12,19,36.8421052631579
2016,105777,"Grigor Dimitrov",40,26,66,60.60606060606061
2016,105806,"Mirza Basic",3,4,7,42.857142857142854
2016,105807,"Pablo Carreno Busta",40,26,66,60.60606060606061
2016,105842,"Di Wu",2,3,5,40
2016,105881,"Matthew Barton",3,3,6,50
2016,105902,"James Duckworth",4,8,12,33.333333333333336
2016,105916,"Marton Fucsovics",1,2,3,33.333333333333336
2016,105932,"Nikoloz Basilashvili",6,9,15,40
2016,105936,"Filip Krajinovic",1,5,6,16.666666666666668
2016,105952,"Renzo Olivo",8,8,16,50
2016,105967,"Henri Laaksonen",2,4,6,33.333333333333336
2016,105992,"Ryan Harrison",11,11,22,50
2016,106000,"Damir Dzumhur",20,22,42,47.61904761904762
2016,106043,"Diego Schwartzman",17,17,34,50
2016,106044,"Nicolas Kicker",1,2,3,33.333333333333336
2016,106045,"Denis Kudla",8,20,28,28.571428571428573
2016,106058,"Jack Sock",36,19,55,65.45454545454545
2016,106065,"Marco Cecchinato",2,10,12,16.666666666666668
2016,106071,"Bernard Tomic",28,23,51,54.90196078431372
2016,106075,"Jozef Kovalik",3,8,11,27.272727272727273
2016,106121,"Taro Daniel",8,15,23,34.78260869565217
2016,106137,"Tristan Lamasine",1,3,4,25
2016,106148,"Roberto Carballes Baena",6,9,15,40
2016,106210,"Jiri Vesely",21,21,42,50
2016,106216,"Bjorn Fratangelo",6,9,15,40
2016,106225,"Andrew Whittington",1,1,2,50
2016,106233,"Dominic Thiem",58,24,82,70.73170731707317
2016,106261,"Dennis Novikov",2,6,8,25
2016,106288,"Mathias Bourgue",1,1,2,50
2016,106298,"Lucas Pouille",33,21,54,61.111111111111114
2016,106329,"Thiago Monteiro",6,6,12,50
2016,106361,"Adam Pavlasek",3,3,6,50
2016,106368,"Ramkumar Ramanathan",2,2,4,50
2016,106378,"Kyle Edmund",20,19,39,51.282051282051285
2016,106401,"Nick Kyrgios",39,15,54,72.22222222222223
2016,106415,"Yoshihito Nishioka",8,12,20,40
2016,106421,"Daniil Medvedev",5,5,10,50
2016,106432,"Borna Coric",21,21,42,50
2016,111200,"Elias Ymer",2,7,9,22.22222222222222
2016,111202,"Hyeon Chung",6,13,19,31.57894736842105
2016,111442,"Jordan Thompson",3,10,13,23.076923076923077
2016,111460,"Quentin Halys",3,6,9,33.333333333333336
2016,111511,"Noah Rubin",2,4,6,33.333333333333336
2016,111575,"Karen Khachanov",13,9,22,59.09090909090909
2016,111577,"Jared Donaldson",7,10,17,41.1764705882353
2016,111578,"Stefan Kozlov",3,2,5,60
2016,117357,"Omar Jasika",1,1,2,50
2016,122330,"Alexander Bublik",2,2,4,50
2016,123921,"Calvin Hemery",1,1,2,50
2016,124014,"Ernesto Escobedo",2,4,6,33.333333333333336
2016,124187,"Reilly Opelka",5,5,10,50
2016,126094,"Andrey Rublev",2,5,7,28.571428571428573
2016,126203,"Taylor Fritz",15,22,37,40.54054054054054
2016,126205,"Tommy Paul",1,4,5,20
2016,126207,"Frances Tiafoe",1,6,7,14.285714285714286
2016,133430,"Denis Shapovalov",1,2,3,33.333333333333336
2016,144707,"Mikael Ymer",1,1,2,50
2016,144797,"Carl Soderlund",1,1,2,50
2016,144923,"Louis Wessels",1,1,2,50
2017,100644,"Alexander Zverev",54,21,75,72
2017,103163,"Tommy Haas",6,14,20,30
2017,103285,"Radek Stepanek",3,2,5,60
2017,103333,"Ivo Karlovic",15,20,35,42.857142857142854
2017,103565,"Stephane Robert",1,11,12,8.333333333333334
2017,103607,"Victor Estrella",8,10,18,44.44444444444444
2017,103656,"Albert Montanes",1,1,2,50
2017,103819,"Roger Federer",53,5,58,91.37931034482759
2017,103852,"Feliciano Lopez",25,24,49,51.02040816326531
2017,103893,"Paolo Lorenzi",24,32,56,42.857142857142854
2017,103898,"Julien Benneteau",13,13,26,50
2017,103908,"Paul Henri Mathieu",1,9,10,10
2017,103917,"Nicolas Mahut",14,19,33,42.42424242424242
2017,103970,"David Ferrer",25,21,46,54.34782608695652
2017,103990,"Tommy Robredo",6,11,17,35.294117647058826
2017,104022,"Mikhail Youzhny",10,20,30,33.333333333333336
2017,104098,"Dmitry Tursunov",1,5,6,16.666666666666668
2017,104117,"Giovanni Lapentti",1,1,2,50
2017,104122,"Carlos Berlocq",12,19,31,38.70967741935484
2017,104180,"Gilles Muller",32,18,50,64
2017,104198,"Guillermo Garcia Lopez",5,15,20,25
2017,104216,"Maximo Gonzalez",1,1,2,50
2017,104229,"Yen Hsun Lu",9,14,23,39.130434782608695
2017,104252,"Florian Mayer",10,17,27,37.03703703703704
2017,104259,"Philipp Kohlschreiber",32,20,52,61.53846153846154
2017,104268,"Alejandro Falla",1,1,2,50
2017,104269,"Fernando Verdasco",29,25,54,53.7037037037037
2017,104291,"Malek Jaziri",13,22,35,37.142857142857146
2017,104297,"Rogerio Dutra Silva",10,21,31,32.25806451612903
2017,104312,"Andreas Seppi",17,17,34,50
2017,104327,"Steve Darcis",16,18,34,47.05882352941177
2017,104330,"Rajeev Ram",2,2,4,50
2017,104386,"Janko Tipsarevic",5,12,17,29.41176470588235
2017,104433,"Frank Dancevic",1,1,2,50
2017,104460,"Dustin Brown",10,20,30,33.333333333333336
2017,104468,"Gilles Simon",15,25,40,37.5
2017,104471,"Ivan Dodig",3,2,5,60
2017,104505,"Konstantin Kravchuk",2,11,13,15.384615384615385
2017,104527,"Stan Wawrinka",26,11,37,70.27027027027027
2017,104534,"Dudi Sela",13,15,28,46.42857142857143
2017,104542,"Jo-Wilfried Tsonga",35,15,50,70
2017,104545,"John Isner",36,21,57,63.1578947368421
2017,104547,"Horacio Zeballos",20,22,42,47.61904761904762
2017,104571,"Marcos Baghdatis",18,16,34,52.94117647058823
2017,104586,"Lukas Rosol",2,3,5,40
2017,104597,"Nicolas Almagro",10,12,22,45.45454545454545
2017,104607,"Tomas Berdych",35,18,53,66.0377358490566
2017,104620,"Simone Bolelli",2,4,6,33.333333333333336
2017,104629,"Adrian Menendez Maceiras",2,4,6,33.333333333333336
2017,104655,"Pablo Cuevas",20,21,41,48.78048780487805
2017,104660,"Sergiy Stakhovsky",6,8,14,42.857142857142854
2017,104672,"Vincent Millot",2,5,7,28.571428571428573
2017,104678,"Viktor Troicki",23,28,51,45.09803921568628
2017,104719,"Marcel Granollers",4,17,21,19.047619047619047
2017,104731,"Kevin Anderson",32,21,53,60.37735849056604
2017,104735,"Tobias Kamke",2,2,4,50
2017,104745,"Rafael Nadal",67,12,79,84.81012658227849
2017,104755,"Richard Gasquet",28,18,46,60.869565217391305
2017,104792,"Gael Monfils",20,14,34,58.8235294117647
2017,104797,"Denis Istomin",15,18,33,45.45454545454545
2017,104871,"Jeremy Chardy",17,21,38,44.73684210526316
2017,104898,"Robin Haase",25,29,54,46.2962962962963
2017,104918,"Andy Murray",26,10,36,72.22222222222223
2017,104919,"Leonardo Mayer",11,8,19,57.89473684210526
2017,104925,"Novak Djokovic",31,8,39,79.48717948717949
2017,104926,"Fabio Fognini",35,23,58,60.3448275862069
2017,104932,"Kenny De Schepper",5,4,9,55.55555555555556
2017,104947,"Marsel Ilhan",1,1,2,50
2017,104978,"Daniel Brands",1,4,5,20
2017,104999,"Mischa Zverev",30,31,61,49.18032786885246
2017,105011,"Illya Marchenko",2,6,8,25
2017,105015,"Franko Skugor",1,3,4,25
2017,105023,"Sam Querrey",35,20,55,63.63636363636363
2017,105032,"Sam Groth",2,3,5,40
2017,105041,"Lukas Lacko",7,10,17,41.1764705882353
2017,105051,"Matthew Ebden",9,7,16,56.25
2017,105053,"Santiago Giraldo",3,10,13,23.076923076923077
2017,105062,"Mikhail Kukushkin",10,14,24,41.666666666666664
2017,105064,"Thomaz Bellucci",12,20,32,37.5
2017,105065,"Tim Smyczek",1,7,8,12.5
2017,105074,"Ruben Bemelmans",5,5,10,50
2017,105077,"Albert Ramos",33,30,63,52.38095238095238
2017,105132,"Jurgen Zopp",1,1,2,50
2017,105138,"Roberto Bautista Agut",46,22,68,67.6470588235294
2017,105149,"Reda El Amrani",1,1,2,50
2017,105154,"Joao Souza",1,3,4,25
2017,105155,"Pedro Sousa",1,1,2,50
2017,105163,"Gleb Sakharov",1,1,2,50
2017,105166,"Peter Polansky",2,4,6,33.333333333333336
2017,105173,"Adrian Mannarino",33,27,60,55
2017,105181,"Miljan Zekic",1,2,3,33.333333333333336
2017,105208,"Ernests Gulbis",6,8,14,42.857142857142854
2017,105216,"Yuichi Sugita",20,16,36,55.55555555555556
2017,105223,"Juan Martin del Potro",38,17,55,69.0909090909091
2017,105226,"Attila Balazs",1,1,2,50
2017,105227,"Marin Cilic",43,22,65,66.15384615384616
2017,105238,"Alexandr Dolgopolov",26,23,49,53.06122448979592
2017,105311,"Joao Sousa",22,30,52,42.30769230769231
2017,105332,"Benoit Paire",31,31,62,50
2017,105341,"Thomas Fabbiano",4,12,16,25
2017,105357,"John Millman",3,5,8,37.5
2017,105373,"Martin Klizan",10,15,25,40
2017,105376,"Peter Gojowczyk",14,9,23,60.869565217391305
2017,105379,"Aljaz Bedene",19,18,37,51.351351351351354
2017,105385,"Donald Young",25,22,47,53.191489361702125
2017,105413,"Andrej Martin",1,2,3,33.333333333333336
2017,105430,"Radu Albot",9,17,26,34.61538461538461
2017,105449,"Steve Johnson",29,23,52,55.76923076923077
2017,105453,"Kei Nishikori",30,14,44,68.18181818181819
2017,105454,"Brydan Klein",1,3,4,25
2017,105477,"Marco Trungelliti",1,2,3,33.333333333333336
2017,105487,"Facundo Bagnis",3,12,15,20
2017,105526,"Jan Lennard Struff",27,28,55,49.09090909090909
2017,105539,"Evgeny Donskoy",5,14,19,26.31578947368421
2017,105550,"Guido Pella",16,15,31,51.61290322580645
2017,105554,"Daniel Evans",11,10,21,52.38095238095238
2017,105561,"Alessandro Giannessi",5,9,14,35.714285714285715
2017,105575,"Ricardas Berankis",6,7,13,46.15384615384615
2017,105577,"Vasek Pospisil",6,13,19,31.57894736842105
2017,105583,"Dusan Lajovic",15,21,36,41.666666666666664
2017,105589,"Gerald Melzer",7,7,14,50
2017,105613,"Norbert Gombos",3,10,13,23.076923076923077
2017,105633,"Mohamed Safwat",1,4,5,20
2017,105643,"Federico Delbonis",11,10,21,52.38095238095238
2017,105649,"Cedrik Marcel Stebe",5,6,11,45.45454545454545
2017,105657,"Marius Copil",7,14,21,33.333333333333336
2017,105668,"Jerzy Janowicz",6,6,12,50
2017,105671,"Gastao Elias",5,11,16,31.25
2017,105676,"David Goffin",53,24,77,68.83116883116882
2017,105683,"Milos Raonic",29,14,43,67.44186046511628
2017,105723,"Andrey Kuznetsov",14,22,36,38.888888888888886
2017,105732,"Pierre Hugues Herbert",10,19,29,34.48275862068966
2017,105777,"Grigor Dimitrov",49,19,68,72.05882352941177
2017,105806,"Mirza Basic",3,1,4,75
2017,105807,"Pablo Carreno Busta",36,24,60,60
2017,105815,"Tennys Sandgren",2,6,8,25
2017,105819,"Guido Andreozzi",1,2,3,33.333333333333336
2017,105842,"Di Wu",1,3,4,25
2017,105870,"Yannick Hanfmann",7,4,11,63.63636363636363
2017,105881,"Matthew Barton",1,1,2,50
2017,105882,"Stefano Travaglia",1,3,4,25
2017,105916,"Marton Fucsovics",5,8,13,38.46153846153846
2017,105932,"Nikoloz Basilashvili",21,27,48,43.75
2017,105936,"Filip Krajinovic",6,2,8,75
2017,105943,"Federico Gaio",2,2,4,50
2017,105952,"Renzo Olivo",8,16,24,33.333333333333336
2017,105960,"Evan King",1,2,3,33.333333333333336
2017,105963,"Arthur De Greef",2,4,6,33.333333333333336
2017,105967,"Henri Laaksonen",10,10,20,50
2017,105985,"Darian King",3,4,7,42.857142857142854
2017,105992,"Ryan Harrison",20,23,43,46.51162790697674
2017,106000,"Damir Dzumhur",34,23,57,59.64912280701754
2017,106026,"Yuki Bhambri",5,3,8,62.5
2017,106034,"Yasutaka Uchiyama",1,2,3,33.333333333333336
2017,106043,"Diego Schwartzman",38,27,65,58.46153846153846
2017,106044,"Nicolas Kicker",10,13,23,43.47826086956522
2017,106045,"Denis Kudla",1,1,2,50
2017,106058,"Jack Sock",38,20,58,65.51724137931035
2017,106065,"Marco Cecchinato",1,5,6,16.666666666666668
2017,106071,"Bernard Tomic",10,20,30,33.333333333333336
2017,106075,"Jozef Kovalik",2,5,7,28.571428571428573
2017,106121,"Taro Daniel",4,9,13,30.76923076923077
2017,106148,"Roberto Carballes Baena",3,2,5,60
2017,106210,"Jiri Vesely",22,24,46,47.82608695652174
2017,106216,"Bjorn Fratangelo",8,11,19,42.10526315789474
2017,106225,"Andrew Whittington",1,2,3,33.333333333333336
2017,106233,"Dominic Thiem",47,27,74,63.513513513513516
2017,106249,"Joao Domingues",1,1,2,50
2017,106261,"Dennis Novikov",2,3,5,40
2017,106281,"Liam Broady",2,2,4,50
2017,106283,"Mitchell Krueger",1,3,4,25
2017,106298,"Lucas Pouille",34,20,54,62.96296296296296
2017,106329,"Thiago Monteiro",11,22,33,33.333333333333336
2017,106361,"Adam Pavlasek",1,5,6,16.666666666666668
2017,106368,"Ramkumar Ramanathan",3,4,7,42.857142857142854
2017,106378,"Kyle Edmund",29,27,56,51.785714285714285
2017,106393,"Frederico Ferreira Silva",1,1,2,50
2017,106401,"Nick Kyrgios",27,17,44,61.36363636363637
2017,106415,"Yoshihito Nishioka",9,7,16,56.25
2017,106420,"Gianluigi Quinzi",1,4,5,20
2017,106421,"Daniil Medvedev",25,25,50,50
2017,106423,"Thanasi Kokkinakis",6,7,13,46.15384615384615
2017,106432,"Borna Coric",24,27,51,47.05882352941177
2017,109303,"Stefano Napolitano",1,2,3,33.333333333333336
2017,110602,"Dennis Novak",1,1,2,50
2017,111153,"Christopher Eubanks",2,3,5,40
2017,111190,"Zhizhen Zhang",2,1,3,66.66666666666667
2017,111200,"Elias Ymer",1,5,6,16.666666666666668
2017,111202,"Hyeon Chung",26,18,44,59.09090909090909
2017,111442,"Jordan Thompson",10,16,26,38.46153846153846
2017,111460,"Quentin Halys",2,6,8,25
2017,111511,"Noah Rubin",1,2,3,33.333333333333336
2017,111513,"Laslo Djere",7,4,11,63.63636363636363
2017,111575,"Karen Khachanov",25,29,54,46.2962962962963
2017,111577,"Jared Donaldson",22,25,47,46.808510638297875
2017,111578,"Stefan Kozlov",2,9,11,18.181818181818183
2017,111815,"Cameron Norrie",2,4,6,33.333333333333336
2017,117361,"Akira Santillan",2,5,7,28.571428571428573
2017,120424,"Yannick Maden",1,1,2,50
2017,122330,"Alexander Bublik",3,3,6,50
2017,124014,"Ernesto Escobedo",9,15,24,37.5
2017,124116,"Sebastian Ofner",5,3,8,62.5
2017,124187,"Reilly Opelka",1,8,9,11.11111111111111
2017,126094,"Andrey Rublev",21,17,38,55.26315789473684
2017,126127,"Benjamin Bonzi",1,1,2,50
2017,126203,"Taylor Fritz",13,13,26,50
2017,126205,"Tommy Paul",6,4,10,60
2017,126207,"Frances Tiafoe",7,17,24,29.166666666666668
2017,126774,"Stefanos Tsitsipas",4,10,14,28.571428571428573
2017,127157,"Daniel Altmaier",2,3,5,40
2017,133430,"Denis Shapovalov",10,11,21,47.61904761904762
2017,134770,"Casper Ruud",5,8,13,38.46153846153846
2017,144760,"Amine Ahouda",1,1,2,50
2017,200282,"Alex De Minaur",2,5,7,28.571428571428573
2018,100644,"Alexander Zverev",55,18,73,75.34246575342466
2018,103333,"Ivo Karlovic",11,16,27,40.74074074074074
2018,103565,"Stephane Robert",1,2,3,33.333333333333336
2018,103607,"Victor Estrella",1,9,10,10
2018,103781,"Jurgen Melzer",1,1,2,50
2018,103819,"Roger Federer",49,10,59,83.05084745762711
2018,103852,"Feliciano Lopez",22,21,43,51.16279069767442
2018,103893,"Paolo Lorenzi",6,15,21,28.571428571428573
2018,103898,"Julien Benneteau",8,11,19,42.10526315789474
2018,103917,"Nicolas Mahut",5,8,13,38.46153846153846
2018,103970,"David Ferrer",8,17,25,32
2018,104022,"Mikhail Youzhny",7,18,25,28
2018,104122,"Carlos Berlocq",1,5,6,16.666666666666668
2018,104180,"Gilles Muller",9,19,28,32.142857142857146
2018,104198,"Guillermo Garcia Lopez",16,23,39,41.02564102564103
2018,104252,"Florian Mayer",2,15,17,11.764705882352942
2018,104259,"Philipp Kohlschreiber",24,22,46,52.17391304347826
2018,104269,"Fernando Verdasco",33,28,61,54.09836065573771
2018,104291,"Malek Jaziri",20,22,42,47.61904761904762
2018,104297,"Rogerio Dutra Silva",5,11,16,31.25
2018,104312,"Andreas Seppi",24,21,45,53.333333333333336
2018,104467,"Lamine Ouahab",1,1,2,50
2018,104468,"Gilles Simon",33,24,57,57.89473684210526
2018,104527,"Stan Wawrinka",17,17,34,50
2018,104534,"Dudi Sela",5,8,13,38.46153846153846
2018,104542,"Jo-Wilfried Tsonga",5,6,11,45.45454545454545
2018,104545,"John Isner",32,22,54,59.25925925925926
2018,104547,"Horacio Zeballos",10,14,24,41.666666666666664
2018,104571,"Marcos Baghdatis",12,17,29,41.37931034482759
2018,104586,"Lukas Rosol",2,2,4,50
2018,104607,"Tomas Berdych",11,12,23,47.82608695652174
2018,104620,"Simone Bolelli",5,4,9,55.55555555555556
2018,104629,"Adrian Menendez Maceiras",2,4,6,33.333333333333336
2018,104655,"Pablo Cuevas",13,14,27,48.148148148148145
2018,104660,"Sergiy Stakhovsky",2,5,7,28.571428571428573
2018,104665,"Pablo Andujar",7,7,14,50
2018,104672,"Vincent Millot",1,1,2,50
2018,104678,"Viktor Troicki",6,13,19,31.57894736842105
2018,104719,"Marcel Granollers",4,4,8,50
2018,104731,"Kevin Anderson",48,19,67,71.64179104477611
2018,104745,"Rafael Nadal",43,4,47,91.48936170212765
2018,104755,"Richard Gasquet",34,23,57,59.64912280701754
2018,104792,"Gael Monfils",30,20,50,60
2018,104797,"Denis Istomin",12,18,30,40
2018,104871,"Jeremy Chardy",24,21,45,53.333333333333336
2018,104882,"Blaz Kavcic",2,8,10,20
2018,104897,"Matthias Bachinger",5,4,9,55.55555555555556
2018,104898,"Robin Haase",24,28,52,46.15384615384615
2018,104918,"Andy Murray",7,6,13,53.84615384615385
2018,104919,"Leonardo Mayer",22,25,47,46.808510638297875
2018,104925,"Novak Djokovic",53,12,65,81.53846153846153
2018,104926,"Fabio Fognini",44,22,66,66.66666666666667
2018,104999,"Mischa Zverev",19,29,48,39.583333333333336
2018,105015,"Franko Skugor",2,4,6,33.333333333333336
2018,105023,"Sam Querrey",21,22,43,48.83720930232558
2018,105041,"Lukas Lacko",11,16,27,40.74074074074074
2018,105051,"Matthew Ebden",19,22,41,46.34146341463415
2018,105053,"Santiago Giraldo",1,1,2,50
2018,105062,"Mikhail Kukushkin",19,21,40,47.5
2018,105063,"Andrea Arnaboldi",1,1,2,50
2018,105064,"Thomaz Bellucci",1,5,6,16.666666666666668
2018,105065,"Tim Smyczek",6,12,18,33.333333333333336
2018,105074,"Ruben Bemelmans",5,14,19,26.31578947368421
2018,105077,"Albert Ramos",18,28,46,39.130434782608695
2018,105132,"Jurgen Zopp",5,6,11,45.45454545454545
2018,105138,"Roberto Bautista Agut",33,18,51,64.70588235294117
2018,105155,"Pedro Sousa",2,2,4,50
2018,105166,"Peter Polansky",3,11,14,21.428571428571427
2018,105173,"Adrian Mannarino",25,29,54,46.2962962962963
2018,105208,"Ernests Gulbis",9,6,15,60
2018,105216,"Yuichi Sugita",7,23,30,23.333333333333332
2018,105223,"Juan Martin del Potro",48,13,61,78.68852459016394
2018,105227,"Marin Cilic",40,19,59,67.79661016949153
2018,105238,"Alexandr Dolgopolov",5,5,10,50
2018,105311,"Joao Sousa",25,26,51,49.01960784313726
2018,105332,"Benoit Paire",26,28,54,48.148148148148145
2018,105341,"Thomas Fabbiano",8,12,20,40
2018,105357,"John Millman",19,19,38,50
2018,105359,"Jason Jung",2,3,5,40
2018,105373,"Martin Klizan",18,9,27,66.66666666666667
2018,105376,"Peter Gojowczyk",23,25,48,47.916666666666664
2018,105379,"Aljaz Bedene",17,19,36,47.22222222222222
2018,105385,"Donald Young",3,12,15,20
2018,105413,"Andrej Martin",3,2,5,60
2018,105430,"Radu Albot",12,23,35,34.285714285714285
2018,105432,"Prajnesh Gunneswaran",1,4,5,20
2018,105449,"Steve Johnson",27,22,49,55.10204081632653
2018,105453,"Kei Nishikori",43,21,64,67.1875
2018,105477,"Marco Trungelliti",5,3,8,62.5
2018,105487,"Facundo Bagnis",2,4,6,33.333333333333336
2018,105526,"Jan Lennard Struff",23,24,47,48.93617021276596
2018,105539,"Evgeny Donskoy",14,21,35,40
2018,105550,"Guido Pella",23,22,45,51.111111111111114
2018,105561,"Alessandro Giannessi",1,1,2,50
2018,105575,"Ricardas Berankis",7,15,22,31.818181818181817
2018,105577,"Vasek Pospisil",8,14,22,36.36363636363637
2018,105583,"Dusan Lajovic",23,23,46,50
2018,105589,"Gerald Melzer",3,6,9,33.333333333333336
2018,105614,"Bradley Klahn",5,8,13,38.46153846153846
2018,105634,"Viktor Galovic",2,2,4,50
2018,105643,"Federico Delbonis",11,18,29,37.93103448275862
2018,105657,"Marius Copil",15,20,35,42.857142857142854
2018,105671,"Gastao Elias",2,6,8,25
2018,105676,"David Goffin",27,16,43,62.7906976744186
2018,105683,"Milos Raonic",31,18,49,63.265306122448976
2018,105732,"Pierre Hugues Herbert",24,21,45,53.333333333333336
2018,105777,"Grigor Dimitrov",24,19,43,55.81395348837209
2018,105806,"Mirza Basic",13,17,30,43.333333333333336
2018,105807,"Pablo Carreno Busta",31,21,52,59.61538461538461
2018,105815,"Tennys Sandgren",16,20,36,44.44444444444444
2018,105819,"Guido Andreozzi",3,6,9,33.333333333333336
2018,105870,"Yannick Hanfmann",1,6,7,14.285714285714286
2018,105882,"Stefano Travaglia",3,7,10,30
2018,105902,"James Duckworth",2,6,8,25
2018,105916,"Marton Fucsovics",25,23,48,52.083333333333336
2018,105932,"Nikoloz Basilashvili",29,26,55,52.72727272727273
2018,105933,"Roberto Quiroz",1,2,3,33.333333333333336
2018,105936,"Filip Krajinovic",14,17,31,45.16129032258065
2018,105948,"Federico Coria",1,1,2,50
2018,105967,"Henri Laaksonen",5,4,9,55.55555555555556
2018,105992,"Ryan Harrison",21,21,42,50
2018,106000,"Damir Dzumhur",24,30,54,44.44444444444444
2018,106005,"Constant Lestienne",1,2,3,33.333333333333336
2018,106026,"Yuki Bhambri",4,10,14,28.571428571428573
2018,106043,"Diego Schwartzman",30,25,55,54.54545454545455
2018,106044,"Nicolas Kicker",8,11,19,42.10526315789474
2018,106045,"Denis Kudla",11,14,25,44
2018,106058,"Jack Sock",9,21,30,30
2018,106065,"Marco Cecchinato",23,23,46,50
2018,106071,"Bernard Tomic",9,7,16,56.25
2018,106072,"Alexey Vatutin",2,2,4,50
2018,106075,"Jozef Kovalik",7,5,12,58.333333333333336
2018,106078,"Egor Gerasimov",4,2,6,66.66666666666667
2018,106099,"Salvatore Caruso",1,3,4,25
2018,106105,"Guilherme Clezar",1,1,2,50
2018,106109,"Alex Bolt",1,7,8,12.5
2018,106110,"Filip Horansky",1,3,4,25
2018,106120,"Ricardo Ojeda Lara",3,3,6,50
2018,106121,"Taro Daniel",16,17,33,48.484848484848484
2018,106148,"Roberto Carballes Baena",14,17,31,45.16129032258065
2018,106177,"Oriol Roca Batalla",1,1,2,50
2018,106186,"Jason Kubler",1,4,5,20
2018,106210,"Jiri Vesely",14,17,31,45.16129032258065
2018,106214,"Oscar Otte",1,2,3,33.333333333333336
2018,106216,"Bjorn Fratangelo",2,6,8,25
2018,106218,"Marcos Giron",1,1,2,50
2018,106233,"Dominic Thiem",50,21,71,70.4225352112676
2018,106249,"Joao Domingues",1,2,3,33.333333333333336
2018,106281,"Liam Broady",1,2,3,33.333333333333336
2018,106283,"Mitchell Krueger",1,3,4,25
2018,106298,"Lucas Pouille",22,20,42,52.38095238095238
2018,106328,"Christian Harrison",1,2,3,33.333333333333336
2018,106329,"Thiago Monteiro",8,8,16,50
2018,106361,"Adam Pavlasek",1,1,2,50
2018,106368,"Ramkumar Ramanathan",6,5,11,54.54545454545455
2018,106378,"Kyle Edmund",37,21,58,63.793103448275865
2018,106401,"Nick Kyrgios",24,13,37,64.86486486486487
2018,106415,"Yoshihito Nishioka",9,11,20,45
2018,106421,"Daniil Medvedev",41,23,64,64.0625
2018,106423,"Thanasi Kokkinakis",3,6,9,33.333333333333336
2018,106432,"Borna Coric",35,19,54,64.81481481481481
2018,109054,"Daniel Masur",1,2,3,33.333333333333336
2018,109739,"Maximilian Marterer",18,23,41,43.90243902439025
2018,110602,"Dennis Novak",3,5,8,37.5
2018,111200,"Elias Ymer",3,7,10,30
2018,111202,"Hyeon Chung",29,18,47,61.702127659574465
2018,111442,"Jordan Thompson",1,10,11,9.090909090909092
2018,111456,"Mackenzie Mcdonald",9,13,22,40.90909090909091
2018,111460,"Quentin Halys",1,4,5,20
2018,111511,"Noah Rubin",4,6,10,40
2018,111513,"Laslo Djere",11,16,27,40.74074074074074
2018,111575,"Karen Khachanov",44,22,66,66.66666666666667
2018,111577,"Jared Donaldson",14,19,33,42.42424242424242
2018,111581,"Michael Mmoh",6,6,12,50
2018,111797,"Nicolas Jarry",25,21,46,54.34782608695652
2018,111815,"Cameron Norrie",17,16,33,51.515151515151516
2018,120424,"Yannick Maden",5,8,13,38.46153846153846
2018,122330,"Alexander Bublik",1,4,5,20
2018,123921,"Calvin Hemery",1,5,6,16.666666666666668
2018,124014,"Ernesto Escobedo",3,8,11,27.272727272727273
2018,124116,"Sebastian Ofner",1,2,3,33.333333333333336
2018,124187,"Reilly Opelka",2,2,4,50
2018,125802,"Ilya Ivashka",8,12,20,40
2018,126094,"Andrey Rublev",20,22,42,47.61904761904762
2018,126203,"Taylor Fritz",23,20,43,53.48837209302326
2018,126205,"Tommy Paul",2,2,4,50
2018,126207,"Frances Tiafoe",28,24,52,53.84615384615385
2018,126523,"Bernabe Zapata Miralles",1,1,2,50
2018,126535,"Carlos Taberner",1,2,3,33.333333333333336
2018,126610,"Matteo Berrettini",19,19,38,50
2018,126652,"Jay Clarke",1,3,4,25
2018,126774,"Stefanos Tsitsipas",46,27,73,63.013698630136986
2018,128034,"Hubert Hurkacz",4,10,14,28.571428571428573
2018,132283,"Lorenzo Sonego",5,6,11,45.45454545454545
2018,133297,"Yosuke Watanuki",1,2,3,33.333333333333336
2018,133430,"Denis Shapovalov",33,27,60,55
2018,134770,"Casper Ruud",6,9,15,40
2018,134868,"Tallon Griekspoor",1,1,2,50
2018,136440,"Dominik Koepfer",1,2,3,33.333333333333336
2018,144707,"Mikael Ymer",2,3,5,40
2018,144719,"Jaume Munar",10,14,24,41.666666666666664
2018,144750,"Lloyd Harris",1,2,3,33.333333333333336
2018,144817,"Marc Andrea Huesler",1,1,2,50
2018,144895,"Corentin Moutet",3,11,14,21.428571428571427
2018,200000,"Felix Auger Aliassime",6,10,16,37.5
2018,200005,"Ugo Humbert",2,3,5,40
2018,200059,"Yibing Wu",1,4,5,20
2018,200095,"Nicola Kuhn",1,1,2,50
2018,200282,"Alex De Minaur",29,20,49,59.183673469387756
2018,200484,"Rudolf Molleker",2,3,5,40
2018,200615,"Alexei Popyrin",1,4,5,20
2019,100644,"Alexander Zverev",41,24,65,63.07692307692308
2019,103333,"Ivo Karlovic",11,15,26,42.30769230769231
2019,103819,"Roger Federer",53,11,64,82.8125
2019,103852,"Feliciano Lopez",13,15,28,46.42857142857143
2019,103893,"Paolo Lorenzi",6,10,16,37.5
2019,103917,"Nicolas Mahut",4,3,7,57.142857142857146
2019,103970,"David Ferrer",8,6,14,57.142857142857146
2019,104198,"Guillermo Garcia Lopez",6,10,16,37.5
2019,104259,"Philipp Kohlschreiber",17,21,38,44.73684210526316
2019,104269,"Fernando Verdasco",26,27,53,49.056603773584904
2019,104291,"Malek Jaziri",6,17,23,26.08695652173913
2019,104312,"Andreas Seppi",17,24,41,41.46341463414634
2019,104327,"Steve Darcis",4,11,15,26.666666666666668
2019,104386,"Janko Tipsarevic",7,11,18,38.888888888888886
2019,104424,"Go Soeda",1,1,2,50
2019,104460,"Dustin Brown",2,1,3,66.66666666666667
2019,104468,"Gilles Simon",27,28,55,49.09090909090909
2019,104527,"Stan Wawrinka",33,20,53,62.264150943396224
2019,104542,"Jo-Wilfried Tsonga",32,18,50,64
2019,104545,"John Isner",29,17,46,63.04347826086956
2019,104571,"Marcos Baghdatis",4,3,7,57.142857142857146
2019,104586,"Lukas Rosol",1,3,4,25
2019,104607,"Tomas Berdych",13,9,22,59.09090909090909
2019,104620,"Simone Bolelli",1,3,4,25
2019,104629,"Adrian Menendez Maceiras",1,3,4,25
2019,104655,"Pablo Cuevas",22,23,45,48.888888888888886
2019,104660,"Sergiy Stakhovsky",3,6,9,33.333333333333336
2019,104665,"Pablo Andujar",15,18,33,45.45454545454545
2019,104678,"Viktor Troicki",4,4,8,50
2019,104719,"Marcel Granollers",8,12,20,40
2019,104731,"Kevin Anderson",11,4,15,73.33333333333333
2019,104745,"Rafael Nadal",54,9,63,85.71428571428571
2019,104755,"Richard Gasquet",17,18,35,48.57142857142857
2019,104792,"Gael Monfils",37,20,57,64.91228070175438
2019,104797,"Denis Istomin",3,11,14,21.428571428571427
2019,104871,"Jeremy Chardy",28,27,55,50.90909090909091
2019,104897,"Matthias Bachinger",3,4,7,42.857142857142854
2019,104898,"Robin Haase",11,18,29,37.93103448275862
2019,104907,"Jose Rubin Statham",1,1,2,50
2019,104918,"Andy Murray",10,7,17,58.8235294117647
2019,104919,"Leonardo Mayer",16,18,34,47.05882352941177
2019,104925,"Novak Djokovic",55,11,66,83.33333333333333
2019,104926,"Fabio Fognini",30,22,52,57.69230769230769
2019,104978,"Daniel Brands",1,1,2,50
2019,104999,"Mischa Zverev",3,12,15,20
2019,105023,"Sam Querrey",24,17,41,58.53658536585366
2019,105041,"Lukas Lacko",1,3,4,25
2019,105051,"Matthew Ebden",5,16,21,23.80952380952381
2019,105053,"Santiago Giraldo",1,2,3,33.333333333333336
2019,105062,"Mikhail Kukushkin",19,25,44,43.18181818181818
2019,105065,"Tim Smyczek",1,3,4,25
2019,105077,"Albert Ramos",30,24,54,55.55555555555556
2019,105138,"Roberto Bautista Agut",40,22,62,64.51612903225806
2019,105173,"Adrian Mannarino",27,26,53,50.943396226415096
2019,105208,"Ernests Gulbis",6,17,23,26.08695652173913
2019,105216,"Yuichi Sugita",3,3,6,50
2019,105223,"Juan Martin del Potro",8,5,13,61.53846153846154
2019,105226,"Attila Balazs",6,2,8,75
2019,105227,"Marin Cilic",22,20,42,52.38095238095238
2019,105311,"Joao Sousa",25,28,53,47.16981132075472
2019,105332,"Benoit Paire",34,28,62,54.83870967741935
2019,105341,"Thomas Fabbiano",10,18,28,35.714285714285715
2019,105357,"John Millman",20,27,47,42.5531914893617
2019,105359,"Jason Jung",2,6,8,25
2019,105373,"Martin Klizan",9,18,27,33.333333333333336
2019,105376,"Peter Gojowczyk",10,21,31,32.25806451612903
2019,105379,"Aljaz Bedene",18,18,36,50
2019,105430,"Radu Albot",31,26,57,54.3859649122807
2019,105432,"Prajnesh Gunneswaran",5,12,17,29.41176470588235
2019,105449,"Steve Johnson",14,21,35,40
2019,105453,"Kei Nishikori",29,14,43,67.44186046511628
2019,105477,"Marco Trungelliti",2,3,5,40
2019,105487,"Facundo Bagnis",2,5,7,28.571428571428573
2019,105526,"Jan Lennard Struff",34,27,61,55.73770491803279
2019,105539,"Evgeny Donskoy",3,6,9,33.333333333333336
2019,105550,"Guido Pella",34,25,59,57.6271186440678
2019,105554,"Daniel Evans",18,18,36,50
2019,105561,"Alessandro Giannessi",1,2,3,33.333333333333336
2019,105575,"Ricardas Berankis",7,12,19,36.8421052631579
2019,105577,"Vasek Pospisil",3,5,8,37.5
2019,105583,"Dusan Lajovic",20,26,46,43.47826086956522
2019,105613,"Norbert Gombos",2,1,3,66.66666666666667
2019,105614,"Bradley Klahn",4,14,18,22.22222222222222
2019,105643,"Federico Delbonis",14,20,34,41.1764705882353
2019,105649,"Cedrik Marcel Stebe",7,10,17,41.1764705882353
2019,105657,"Marius Copil",7,19,26,26.923076923076923
2019,105676,"David Goffin",36,26,62,58.064516129032256
2019,105683,"Milos Raonic",23,13,36,63.888888888888886
2019,105731,"Steven Diez",1,1,2,50
2019,105732,"Pierre Hugues Herbert",22,24,46,47.82608695652174
2019,105777,"Grigor Dimitrov",23,21,44,52.27272727272727
2019,105807,"Pablo Carreno Busta",30,21,51,58.8235294117647
2019,105815,"Tennys Sandgren",13,17,30,43.333333333333336
2019,105819,"Guido Andreozzi",6,14,20,30
2019,105842,"Di Wu",1,1,2,50
2019,105882,"Stefano Travaglia",5,7,12,41.666666666666664
2019,105906,"Kevin Krawietz",1,1,2,50
2019,105916,"Marton Fucsovics",22,25,47,46.808510638297875
2019,105932,"Nikoloz Basilashvili",28,24,52,53.84615384615385
2019,105936,"Filip Krajinovic",27,17,44,61.36363636363637
2019,105967,"Henri Laaksonen",6,8,14,42.857142857142854
2019,105992,"Ryan Harrison",3,7,10,30
2019,106000,"Damir Dzumhur",13,21,34,38.23529411764706
2019,106034,"Yasutaka Uchiyama",4,3,7,57.142857142857146
2019,106043,"Diego Schwartzman",39,24,63,61.904761904761905
2019,106045,"Denis Kudla",11,22,33,33.333333333333336
2019,106065,"Marco Cecchinato",14,25,39,35.8974358974359
2019,106071,"Bernard Tomic",7,15,22,31.818181818181817
2019,106075,"Jozef Kovalik",1,9,10,10
2019,106078,"Egor Gerasimov",8,7,15,53.333333333333336
2019,106099,"Salvatore Caruso",6,6,12,50
2019,106109,"Alex Bolt",3,4,7,42.857142857142854
2019,106121,"Taro Daniel",11,18,29,37.93103448275862
2019,106137,"Tristan Lamasine",1,1,2,50
2019,106148,"Roberto Carballes Baena",19,20,39,48.717948717948715
2019,106198,"Hugo Dellien",10,16,26,38.46153846153846
2019,106210,"Jiri Vesely",7,11,18,38.888888888888886
2019,106214,"Oscar Otte",1,3,4,25
2019,106216,"Bjorn Fratangelo",3,6,9,33.333333333333336
2019,106218,"Marcos Giron",2,4,6,33.333333333333336
2019,106228,"Juan Ignacio Londero",22,21,43,51.16279069767442
2019,106233,"Dominic Thiem",48,17,65,73.84615384615384
2019,106249,"Joao Domingues",2,1,3,66.66666666666667
2019,106296,"Gregoire Barrere",6,7,13,46.15384615384615
2019,106298,"Lucas Pouille",21,21,42,50
2019,106329,"Thiago Monteiro",2,11,13,15.384615384615385
2019,106368,"Ramkumar Ramanathan",2,4,6,33.333333333333336
2019,106378,"Kyle Edmund",14,22,36,38.888888888888886
2019,106398,"Pedro Cachin",2,1,3,66.66666666666667
2019,106401,"Nick Kyrgios",21,14,35,60
2019,106415,"Yoshihito Nishioka",17,19,36,47.22222222222222
2019,106421,"Daniil Medvedev",58,21,79,73.41772151898734
2019,106423,"Thanasi Kokkinakis",3,4,7,42.857142857142854
2019,106426,"Cristian Garin",30,22,52,57.69230769230769
2019,106432,"Borna Coric",27,22,49,55.10204081632653
2019,109739,"Maximilian Marterer",5,11,16,31.25
2019,110536,"Kevin King",1,1,2,50
2019,110602,"Dennis Novak",2,6,8,25
2019,110748,"Nikola Milojevic",1,1,2,50
2019,111153,"Christopher Eubanks",2,6,8,25
2019,111190,"Zhizhen Zhang",2,3,5,40
2019,111200,"Elias Ymer",1,5,6,16.666666666666668
2019,111202,"Hyeon Chung",6,8,14,42.857142857142854
2019,111442,"Jordan Thompson",26,22,48,54.166666666666664
2019,111456,"Mackenzie Mcdonald",10,12,22,45.45454545454545
2019,111513,"Laslo Djere",21,22,43,48.83720930232558
2019,111575,"Karen Khachanov",27,26,53,50.943396226415096
2019,111577,"Jared Donaldson",1,2,3,33.333333333333336
2019,111581,"Michael Mmoh",1,2,3,33.333333333333336
2019,111790,"Brayden Schnur",4,8,12,33.333333333333336
2019,111794,"Kamil Majchrzak",3,6,9,33.333333333333336
2019,111797,"Nicolas Jarry",17,19,36,47.22222222222222
2019,111815,"Cameron Norrie",21,25,46,45.65217391304348
2019,117353,"Duck Hee Lee",1,1,2,50
2019,117360,"Marc Polmans",1,2,3,33.333333333333336
2019,120424,"Yannick Maden",3,6,9,33.333333333333336
2019,122330,"Alexander Bublik",13,14,27,48.148148148148145
2019,123755,"Daniel Elahi Galan",3,2,5,60
2019,123795,"Altug Celikbilek",1,1,2,50
2019,124116,"Sebastian Ofner",1,1,2,50
2019,124187,"Reilly Opelka",27,21,48,56.25
2019,125802,"Ilya Ivashka",7,11,18,38.888888888888886
2019,126094,"Andrey Rublev",34,19,53,64.15094339622641
2019,126120,"Nino Serdarusic",1,1,2,50
2019,126149,"Gianluca Mager",1,1,2,50
2019,126156,"Antoine Hoang",5,7,12,41.666666666666664
2019,126203,"Taylor Fritz",30,28,58,51.724137931034484
2019,126205,"Tommy Paul",2,4,6,33.333333333333336
2019,126207,"Frances Tiafoe",23,27,50,46
2019,126237,"Gian Marco Moroni",1,1,2,50
2019,126610,"Matteo Berrettini",42,23,65,64.61538461538461
2019,126652,"Jay Clarke",1,3,4,25
2019,126774,"Stefanos Tsitsipas",54,25,79,68.35443037974683
2019,126952,"Soon Woo Kwon",5,7,12,41.666666666666664
2019,128034,"Hubert Hurkacz",25,24,49,51.02040816326531
2019,132283,"Lorenzo Sonego",20,23,43,46.51162790697674
2019,133430,"Denis Shapovalov",34,25,59,57.6271186440678
2019,134770,"Casper Ruud",21,19,40,52.5
2019,134868,"Tallon Griekspoor",1,1,2,50
2019,136440,"Dominik Koepfer",4,4,8,50
2019,144707,"Mikael Ymer",4,6,10,40
2019,144719,"Jaume Munar",17,22,39,43.58974358974359
2019,144750,"Lloyd Harris",8,13,21,38.095238095238095
2019,144895,"Corentin Moutet",5,10,15,33.333333333333336
2019,200000,"Felix Auger Aliassime",33,21,54,61.111111111111114
2019,200005,"Ugo Humbert",16,23,39,41.02564102564103
2019,200095,"Nicola Kuhn",1,2,3,33.333333333333336
2019,200175,"Miomir Kecmanovic",24,22,46,52.17391304347826
2019,200221,"Alejandro Davidovich Fokina",3,10,13,23.076923076923077
2019,200282,"Alex De Minaur",38,20,58,65.51724137931035
2019,200484,"Rudolf Molleker",2,5,7,28.571428571428573
2019,200553,"Alen Avidzba",1,1,2,50
2019,200611,"Elliot Benchetrit",1,2,3,33.333333333333336
2019,200615,"Alexei Popyrin",11,19,30,36.666666666666664
2019,202385,"Jenson Brooksby",1,1,2,50
2019,205734,"Thiago Seyboth Wild",1,3,4,25
2019,206173,"Jannik Sinner",11,10,21,52.38095238095238
1969,100013,"Neale Fraser",0,1,1,0
1969,100020,"Alejandro Olmedo",0,5,5,0
1969,100024,"Jan Eric Lundquist",0,1,1,0
1969,100031,"Dimitri Sturdza",0,3,3,0
1969,100045,"John Paish",0,1,1,0
1969,100052,"Keishiro Yanagi",0,1,1,0
1969,100054,"Jose Mandarino",0,2,2,0
1969,100064,"Juan Gisbert",0,1,1,0
1969,100072,"Bailey Brown",0,1,1,0
1969,100082,"Roger Dowdeswell",0,1,1,0
1969,100093,"William Brown",0,1,1,0
1969,100095,"Tony Bardsley",0,4,4,0
1969,100133,"Pat Cramer",0,1,1,0
1969,100143,"Peter Fishbach",0,1,1,0
1969,100149,"Toshiro Sakai",0,1,1,0
1969,100169,"Ian Fletcher",0,2,2,0
1969,100178,"Bob Giltinan",0,6,6,0
1969,100193,"Wanaro N'Godrella",0,3,3,0
1969,100204,"Pancho Walthall",0,1,1,0
1969,100205,"Paul Gerken",0,4,4,0
1969,100208,"Dick R Bohrnstedt",0,1,1,0
1969,100209,"George Taylor",0,3,3,0
1969,100213,"Fred Hemmes",0,1,1,0
1969,100216,"Charles Owens",0,2,2,0
1969,100223,"Jeff Simpson",0,1,1,0
1969,100224,"Peter Campbell",0,1,1,0
1969,100226,"Mike Machette",0,3,3,0
1969,100228,"Kjell Johansson",0,1,1,0
1969,100234,"Allan McDonald",0,2,2,0
1969,100243,"Steve Krulevitz",0,1,1,0
1969,100245,"Jeff Austin",0,1,1,0
1969,100249,"Paolo Bertolucci",0,1,1,0
1969,100255,"Roscoe Tanner",0,2,2,0
1969,100257,"Ross Case",0,3,3,0
1969,100262,"Rolf Norberg",0,1,1,0
1969,100267,"Rayno Seegers",0,3,3,0
1969,100277,"Jacques Thamin",0,1,1,0
1969,100284,"Jimmy Connors",0,1,1,0
1969,100286,"Harold Solomon",0,1,1,0
1969,100289,"Byron Bertram",0,3,3,0
1969,100300,"Jose Higueras",0,1,1,0
1969,100303,"Henry Bunis",0,1,1,0
1969,100304,"Robert Kreiss",0,1,1,0
1969,100312,"Chiraid Mukherjea",0,2,2,0
1969,100336,"Guillermo Aubone",0,1,1,0
1969,100740,"Dan Cassidy",0,1,1,0
1969,103616,"Andre Van Der Merwe B",0,1,1,0
1969,104828,"Alejandro Kon",0,1,1,0
1969,106564,"Anton Ivanov",0,1,1,0
1969,106594,"Attila Korpas",0,1,1,0
1969,106616,"Bernard Montrenaud",0,5,5,0
1969,106629,"Birger Andersson",0,1,1,0
1969,106634,"Bob Brien",0,1,1,0
1969,106875,"Dick Klitch",0,1,1,0
1969,106968,"Eugenio Castigliano",0,4,4,0
1969,106971,"Ezio Di Matteo",0,2,2,0
1969,107217,"Ian Crookenden",0,1,1,0
1969,107311,"Jean Paul Meyer",0,1,1,0
1969,107394,"John Peckskamp",0,1,1,0
1969,107439,"Jose Maria Blasi",0,1,1,0
1969,107452,"Juan Carlos Rodriguez",0,1,1,0
1969,107561,"Leif Johansson",0,1,1,0
1969,107591,"Luis Bruguera",0,1,1,0
1969,107760,"Max Senior",0,1,1,0
1969,107796,"Miecyslav Rybarczyk",0,1,1,0
1969,107810,"Mike Kreiss",0,1,1,0
1969,107825,"Mohammad Hossein Akbari",0,1,1,0
1969,107853,"Nick Barone",0,1,1,0
1969,108036,"Rafael Ruiz",0,1,1,0
1969,108310,"Steve Tidball",0,1,1,0
1969,108343,"Taghi Akbari",0,2,2,0
1969,108364,"Terry Bennett",0,1,1,0
1969,108374,"Thierry Bernasconi",0,3,3,0
1969,108434,"Tony Parun P071",0,1,1,0
1969,108579,"Zlatko Ivancic",0,1,1,0
1969,109742,"Berry Geraghty",0,1,1,0
1969,109748,"John Barrett",0,4,4,0
1969,109751,"Sever Dron",0,2,2,0
1969,109755,"V Kazarevitch",0,1,1,0
1969,109757,"Detler Herdy",0,1,1,0
1969,109759,"Michael Sangster",0,1,1,0
1969,109763,"Eduardo Zuleta",0,1,1,0
1969,109765,"Marco Gilardelli",0,1,1,0
1969,109767,"Claude De Gronckel",0,2,2,0
1969,109773,"Bernard De Troye",0,1,1,0
1969,109777,"Alan Fox",0,1,1,0
1969,109784,"Lance Lumsden",0,2,2,0
1969,109794,"C Burr",0,1,1,0
1969,109800,"Mathias Werren",0,2,2,0
1969,109801,"Ken Stuart",0,2,2,0
1969,109810,"Dave Simmonds",0,1,1,0
1969,109814,"Donald Dell",0,5,5,0
1969,109818,"Gordon Forbes",0,3,3,0
1969,109820,"Alan Mills",0,1,1,0
1969,109827,"Patricio Apey",0,1,1,0
1969,109828,"Hector Romani",0,1,1,0
1969,109829,"Eduardo Soriano",0,1,1,0
1969,109848,"Danny Obryant",0,4,4,0
1969,109850,"Nick Fleury",0,1,1,0
1969,109862,"Alex Kurucz",0,2,2,0
1969,109870,"Gary Penberthy",0,1,1,0
1969,109875,"Victor Egorov",0,1,1,0
1969,109878,"Franco Bartoni",0,1,1,0
1969,109892,"Kenneth Andersson",0,1,1,0
1969,109893,"Don Mccormick",0,1,1,0
1969,109912,"Ricky Buwalda",0,1,1,0
1969,109928,"Luis Garcia",0,1,1,0
1969,109929,"John Hammill",0,1,1,0
1969,109932,"Charles Mckinley",0,1,1,0
1969,109933,"Martin Carlstein",0,2,2,0
1969,109936,"Antonio Palafox",0,2,2,0
1969,109937,"Robert Potthast",0,1,1,0
1969,109939,"Ted Hoehn",0,1,1,0
1969,109948,"Clive Brebnor",0,2,2,0
1969,109957,"Gerry Perry",0,2,2,0
1969,109959,"Jim Bentley",0,1,1,0
1969,109962,"Doug Tough",0,1,1,0
1969,109963,"Bob Bardsley",0,1,1,0
1969,109965,"Roy Sprengelmeyer",0,4,4,0
1969,109966,"Warren Jacques",0,1,1,0
1969,109967,"Vic Rollins",0,1,1,0
1969,109969,"Bob French",0,1,1,0
1969,109970,"John Swann",0,1,1,0
1969,109972,"Hector Gonzalez",0,2,2,0
1969,109973,"Andre Cote",0,1,1,0
1969,109974,"Steve Cornell",0,3,3,0
1969,109975,"George Andrews",0,1,1,0
1969,109976,"Joe Osadca",0,1,1,0
1969,109979,"Bill Mcdonnell",0,1,1,0
1969,109980,"Don Fontana",0,1,1,0
1969,109981,"Richard Evans",0,1,1,0
1969,109984,"Joe Foley",0,1,1,0
1969,109986,"Glenn Mccoll",0,1,1,0
1969,109987,"Al Bunis",0,1,1,0
1969,109988,"Dick Knight",0,3,3,0
1969,109989,"Ron Goldman",0,3,3,0
1969,109990,"David Mehl",0,1,1,0
1969,109991,"Tom Loring",0,1,1,0
1969,109993,"Fred Mcnair Iii",0,1,1,0
1969,109995,"Herbert Rapp",0,1,1,0
1969,109996,"Bob Alloo",0,2,2,0
1969,109997,"Carlos Schettwein",0,1,1,0
1969,109998,"Robin Fry",0,1,1,0
1969,109999,"Peter Van Lingen",0,2,2,0
1969,110000,"Bill Colson",0,3,3,0
1969,110002,"Tom Karp",0,1,1,0
1969,110003,"Jerry De Witts",0,1,1,0
1969,110005,"Bryan Burrell",0,1,1,0
1969,110006,"Jean Pierre Loizeau",0,3,3,0
1969,110008,"Uriel Oquendo Sr",0,1,1,0
1969,110009,"Birger Folke",0,1,1,0
1969,110039,"Sutarjo Sugiarto",0,1,1,0
1969,110040,"R Campbell",0,1,1,0
1969,110047,"John Ward",0,1,1,0
1969,110049,"Mel Baleson",0,2,2,0
1969,110054,"Paul Thompson",0,1,1,0
1969,110055,"Kevin Long",0,1,1,0
1969,110070,"Robert Perry",0,1,1,0
1969,110086,"Bob Goeltz",0,1,1,0
1969,110111,"Antonio Mennella",0,1,1,0
1969,110124,"Alain Bouteleux",0,1,1,0
1969,110177,"Jan Hajer",0,1,1,0
1969,110180,"Gaetano Di Maso",0,2,2,0
1969,110182,"L Palman",0,1,1,0
1969,110183,"Francois Pierson",0,1,1,0
1969,110184,"Robert Haillet",0,1,1,0
1969,110185,"Michael Hickey",0,1,1,0
1969,110186,"Davor Stolcer",0,1,1,0
1969,110187,"Chuck De Voe",0,1,1,0
1969,110188,"Michele Pirro",0,2,2,0
1969,110189,"Richard Bray",0,1,1,0
1969,110190,"Franco Belli",0,2,2,0
1969,110191,"Francois Battegay",0,1,1,0
1969,110192,"Bernd Kube",0,1,1,0
1969,110193,"Lothar Lanz",0,1,1,0
1969,110194,"Uwe Gottschalk",0,1,1,0
1969,110196,"Peter Ledbetter",0,1,1,0
1969,110197,"James Mcardle",0,1,1,0
1969,110203,"Pancho Castillo",0,1,1,0
1969,110210,"Donald Lutz",0,1,1,0
1969,110247,"Colin Mchugo",0,1,1,0
1969,110277,"Giorgio Bologna",0,1,1,0
1969,110292,"Eddie Knol",0,1,1,0
1969,110293,"Peter Schlotz",0,1,1,0
1969,110327,"Jose Maria Gisbert",0,1,1,0
1969,110349,"Marc Bolle",0,1,1,0
1969,110350,"Harold Hunt",0,2,2,0
1969,110376,"Myron Franks",0,1,1,0
1969,110380,"Manlio Bartoni",0,1,1,0
1969,110952,"Alfredo Vaz Pinto",0,1,1,0
1969,110991,"Jaidip Mukerjea",0,2,2,0
1969,111006,"William Brown",0,1,1,0
1969,111135,"Greg Perkins",0,1,1,0
1969,111138,"Dennis Matthews",0,1,1,0
1969,112473,"Lew Gerrard",0,1,1,0
1969,116790,"James Rombeau",0,1,1,0
1969,117308,"Eduardo Zuleta",0,2,2,0
1969,117315,"Stepan Koudelka",0,2,2,0
1969,125578,"Tomas Lynch",0,1,1,0
1969,125614,"Eduardo Gorostiaga",0,3,3,0
1969,125717,"Jurg Siegrist",0,1,1,0
1969,202588,"Oscar Escribano",0,1,1,0
1969,202652,"Peter Holenstein",0,1,1,0
1969,202871,"Barry Geraghty",0,2,2,0
1969,202875,"Allan Wall",0,1,1,0
1969,202909,"Frank McDonald",0,1,1,0
1969,207077,"Desmond Early",0,1,1,0
1969,208953,"D Belesson",0,1,1,0
1969,209419,"Bill Brown",0,1,1,0
1969,209427,"Lewis Sylvester",0,1,1,0
1969,209438,"Peter Tudhope",0,1,1,0
1969,209439,"Kenny Smith",0,1,1,0
1969,209441,"Dennis Breetzke",0,1,1,0
1969,209524,"Harry Barniville",0,1,1,0
1969,209525,"Dennis Foley",0,1,1,0
1969,209535,"John Mulvey",0,1,1,0
1969,209537,"Brendan O'Shea",0,1,1,0
1969,209538,"Junjo Kawamuri",0,1,1,0
1969,209546,"R Hunt",0,1,1,0
1969,209547,"Andy Fanowries",0,1,1,0
1969,209548,"A D'Orsongna",0,1,1,0
1969,209549,"N Trotter",0,1,1,0
1969,209550,"G Miles",0,1,1,0
1969,209551,"K Lonsdale",0,1,1,0
1969,209552,"D Watts",0,1,1,0
1969,209553,"V Bercham",0,1,1,0
1969,209554,"M Patterson",0,1,1,0
1969,209555,"K Tobin",0,1,1,0
1969,209556,"M Bonner",0,1,1,0
1969,209557,"Alan Gooch",0,1,1,0
1969,209559,"Robert Brien",0,1,1,0
1969,209560,"Howard Broun",0,1,1,0
1969,209562,"J Sacks",0,1,1,0
1969,209563,"B Niemand",0,1,1,0
1969,209564,"L Ploughman",0,1,1,0
1969,209565,"G Nel",0,1,1,0
1969,209566,"A Sapire",0,1,1,0
1969,209567,"Peter Gray",0,1,1,0
1969,209568,"J Rudman",0,1,1,0
1969,209569,"S Le Roux",0,1,1,0
1969,209570,"Colin Zeeman",0,1,1,0
1969,209571,"A Jammond",0,1,1,0
1969,209572,"P Michau",0,1,1,0
1969,209574,"Roy Schwegman",0,1,1,0
1969,209575,"A Saul",0,1,1,0
1969,209576,"B Akbari",0,1,1,0
1969,209577,"Dave Phillips",0,1,1,0
1969,209578,"G Loader",0,1,1,0
1969,209579,"B Butcher",0,1,1,0
1969,209581,"Mark Conti",0,1,1,0
1969,209582,"Les Nicholson",0,1,1,0
1969,209583,"Don Candy",0,1,1,0
1969,209584,"Gustavo Castillo",0,1,1,0
1969,209585,"J Walsh",0,1,1,0
1969,209586,"K Kelkher",0,1,1,0
1969,209587,"B Moran",0,1,1,0
1969,209588,"J Drury Byrne",0,1,1,0
1969,209589,"Jimmy Casey",0,1,1,0
1969,209590,"Paul Fitz Simmons",0,1,1,0
1969,209591,"N Lennon",0,1,1,0
1969,209592,"Ronan Fearon",0,1,1,0
1969,209593,"G Doughty",0,1,1,0
1969,209594,"P Coyle",0,1,1,0
1969,209595,"John Schaefer",0,1,1,0
1969,209596,"Bobby Odasz",0,1,1,0
1969,209597,"Mervyn Webster",0,1,1,0
1969,209818,"Peter Keller",0,1,1,0
1969,209819,"Hans Van Scheltema",0,1,1,0
1969,209820,"F De Kort",0,1,1,0
1970,100004,"Giuseppe Merlo",0,1,1,0
1970,100031,"Dimitri Sturdza",0,4,4,0
1970,100044,"Sergei Likhachev",0,3,3,0
1970,100045,"John Paish",0,1,1,0
1970,100082,"Roger Dowdeswell",0,2,2,0
1970,100091,"Colin Dibley",0,6,6,0
1970,100096,"Peter Burwash",0,1,1,0
1970,100107,"Robert Rheinberger",0,3,3,0
1970,100124,"Steve Turner",0,2,2,0
1970,100131,"Guillermo Oropez",0,1,1,0
1970,100132,"Armistead Neely",0,1,1,0
1970,100140,"Steve Faulk",0,1,1,0
1970,100143,"Peter Fishbach",0,1,1,0
1970,100145,"Dick Dell",0,4,4,0
1970,100151,"Karl Coombes",0,1,1,0
1970,100155,"Ramiro Benavides",0,3,3,0
1970,100156,"Jasjit Singh",0,2,2,0
1970,100170,"Bernard Mignot",0,2,2,0
1970,100185,"Patrick Proisy",0,3,3,0
1970,100188,"John Fort",0,1,1,0
1970,100191,"Doug Crawford",0,1,1,0
1970,100193,"Wanaro N'Godrella",0,2,2,0
1970,100194,"Larry Parker",0,1,1,0
1970,100199,"Patrice Dominguez",0,2,2,0
1970,100201,"Syd Ball",0,3,3,0
1970,100204,"Pancho Walthall",0,3,3,0
1970,100209,"George Taylor",0,3,3,0
1970,100212,"Franklin Robbins",0,3,3,0
1970,100215,"Fred Mcnair",0,3,3,0
1970,100216,"Charles Owens",0,4,4,0
1970,100226,"Mike Machette",0,5,5,0
1970,100228,"Kjell Johansson",0,2,2,0
1970,100233,"Ricardo Cano",0,1,1,0
1970,100238,"Rick Fisher",0,1,1,0
1970,100239,"Hans Engert",0,4,4,0
1970,100242,"Mike Collins",0,1,1,0
1970,100243,"Steve Krulevitz",0,4,4,0
1970,100245,"Jeff Austin",0,1,1,0
1970,100247,"Rolf Thung",0,1,1,0
1970,100255,"Roscoe Tanner",0,6,6,0
1970,100261,"Brian Gottfried",0,4,4,0
1970,100267,"Rayno Seegers",0,2,2,0
1970,100271,"Jean Francois Caujolle",0,1,1,0
1970,100277,"Jacques Thamin",0,1,1,0
1970,100283,"Andre Zietsmann",0,1,1,0
1970,100300,"Jose Higueras",0,1,1,0
1970,100304,"Robert Kreiss",0,3,3,0
1970,100305,"Mark Farrell",0,1,1,0
1970,100346,"Paul Kronk",0,1,1,0
1970,100351,"Freddie De Jesus",0,1,1,0
1970,100376,"Buster C Mottram",0,1,1,0
1970,106468,"Alberto Martorell",0,1,1,0
1970,106517,"Anatoli Volkov",0,3,3,0
1970,106542,"Andrew Rae",0,1,1,0
1970,106562,"Anthony Hammond",0,2,2,0
1970,106765,"Christopher Wolff",0,1,1,0
1970,106797,"Cyril Rudman",0,1,1,0
1970,106910,"Eddie Cruz",0,1,1,0
1970,106968,"Eugenio Castigliano",0,3,3,0
1970,107034,"Frank Falderbaum",0,1,1,0
1970,107071,"Gene Hamilton",0,1,1,0
1970,107092,"Geza Varga",0,1,1,0
1970,107140,"Greg Perkins",0,1,1,0
1970,107215,"Hugo Varela",0,1,1,0
1970,107217,"Ian Crookenden",0,3,3,0
1970,107353,"Joe Bouquin",0,1,1,0
1970,107358,"Joe Ragland",0,1,1,0
1970,107425,"Jose Moreno",0,1,1,0
1970,107429,"Jose Castanon",0,1,1,0
1970,107561,"Leif Johansson",0,1,1,0
1970,107591,"Luis Bruguera",0,1,1,0
1970,107669,"Marian Laudin",0,1,1,0
1970,107796,"Miecyslav Rybarczyk",0,1,1,0
1970,107825,"Mohammad Hossein Akbari",0,1,1,0
1970,107830,"Munawar Iqbal",0,1,1,0
1970,107954,"Paul Van Min",0,1,1,0
1970,108017,"Pierre Joly",0,1,1,0
1970,108021,"Pietro Marzano",0,2,2,0
1970,108118,"Robert Machan",0,1,1,0
1970,108374,"Thierry Bernasconi",0,2,2,0
1970,108579,"Zlatko Ivancic",0,1,1,0
1970,109262,"Milan Vopicka",0,1,1,0
1970,109754,"Petr Strobl",0,1,1,0
1970,109758,"Christian Duxin",0,1,1,0
1970,109760,"Jean Courcol",0,1,1,0
1970,109767,"Claude De Gronckel",0,1,1,0
1970,109772,"Sergio Palmieri",0,1,1,0
1970,109775,"Robert Wilson",0,5,5,0
1970,109782,"William Alvarez",0,2,2,0
1970,109784,"Lance Lumsden",0,1,1,0
1970,109795,"Keith Carpenter",0,1,1,0
1970,109799,"Geoff Pollard",0,1,1,0
1970,109802,"Allen Shapter",0,1,1,0
1970,109804,"Rod Brent",0,1,1,0
1970,109805,"Ian Bidmeade",0,2,2,0
1970,109819,"Keith Wooldridge",0,1,1,0
1970,109821,"Jorgen Ulrich",0,2,2,0
1970,109822,"Thomas Lejus",0,2,2,0
1970,109824,"Julian Krinsky",0,2,2,0
1970,109825,"Koji Watanabe",0,3,3,0
1970,109826,"Dave Bohrnstedt",0,1,1,0
1970,109828,"Hector Romani",0,1,1,0
1970,109836,"Ken Weatherley",0,1,1,0
1970,109838,"Henry Hank Irvine",0,2,2,0
1970,109848,"Danny Obryant",0,3,3,0
1970,109850,"Nick Fleury",0,1,1,0
1970,109853,"U Markoff",0,1,1,0
1970,109857,"Brian Cheney",0,1,1,0
1970,109859,"Jimmy Parker",0,1,1,0
1970,109878,"Franco Bartoni",0,2,2,0
1970,109879,"Jose Luis Arillla",0,2,2,0
1970,109881,"Atet Wijono",0,4,4,0
1970,109891,"Hakar Zahr",0,4,4,0
1970,109895,"Ken Binns",0,1,1,0
1970,109900,"Greg Shephard",0,1,1,0
1970,109903,"Whitney Reed",0,1,1,0
1970,109904,"Rich Anderson",0,1,1,0
1970,109906,"Don Kierbow",0,1,1,0
1970,109908,"Tom Brown",0,2,2,0
1970,109909,"Bobby Siska",0,1,1,0
1970,109911,"Jose Cordon",0,2,2,0
1970,109916,"Larry Miller",0,1,1,0
1970,109917,"Dick Horowitz",0,1,1,0
1970,109923,"Roberto Aubone",0,1,1,0
1970,109926,"Ron Barnes",0,1,1,0
1970,109935,"John Sharpe",0,2,2,0
1970,109936,"Antonio Palafox",0,1,1,0
1970,109937,"Robert Potthast",0,1,1,0
1970,109938,"Tom Mozur",0,3,3,0
1970,109948,"Clive Brebnor",0,1,1,0
1970,109966,"Warren Jacques",0,1,1,0
1970,109974,"Steve Cornell",0,1,1,0
1970,109985,"Tico Carrero",0,1,1,0
1970,109988,"Dick Knight",0,1,1,0
1970,109989,"Ron Goldman",0,1,1,0
1970,109996,"Bob Alloo",0,3,3,0
1970,110000,"Bill Colson",0,1,1,0
1970,110001,"John Yeomans",0,1,1,0
1970,110008,"Uriel Oquendo Sr",0,1,1,0
1970,110015,"Doug Verdieck",0,1,1,0
1970,110016,"Alan Kendal",0,2,2,0
1970,110019,"Francois Matheu",0,1,1,0
1970,110020,"Jean Lovera",0,3,3,0
1970,110021,"Raul Peralta",0,1,1,0
1970,110039,"Sutarjo Sugiarto",0,4,4,0
1970,110049,"Mel Baleson",0,3,3,0
1970,110090,"Roberto Marcher",0,1,1,0
1970,110117,"Roberto Graetz",0,1,1,0
1970,110120,"Gary Rose",0,1,1,0
1970,110122,"Bud Guion",0,1,1,0
1970,110123,"Steve Fiske",0,2,2,0
1970,110124,"Alain Bouteleux",0,1,1,0
1970,110159,"Gaurav Misra",0,2,2,0
1970,110175,"Thedy Stalder",0,1,1,0
1970,110192,"Bernd Kube",0,2,2,0
1970,110197,"James Mcardle",0,1,1,0
1970,110210,"Donald Lutz",0,1,1,0
1970,110212,"King Van Nostrand",0,1,1,0
1970,110224,"Robert Bedard",0,1,1,0
1970,110249,"Karl Fichtel",0,1,1,0
1970,110258,"Milan Tajenar",0,1,1,0
1970,110289,"Geoff Paish",0,1,1,0
1970,110290,"Piet Van Eysden",0,1,1,0
1970,110291,"Boris Breskvar",0,1,1,0
1970,110292,"Eddie Knol",0,1,1,0
1970,110293,"Peter Schlotz",0,1,1,0
1970,110294,"Evert Schneider",0,1,1,0
1970,110295,"Piet Veentjer",0,1,1,0
1970,110299,"U Friscic",0,1,1,0
1970,110300,"U Zollner",0,1,1,0
1970,110301,"Patrick Platzer",0,1,1,0
1970,110302,"U Futternecht",0,1,1,0
1970,110304,"U Ostroff",0,1,1,0
1970,110305,"U Hamza",0,1,1,0
1970,110306,"U Bahr",0,1,1,0
1970,110307,"U Kreuzhuber",0,1,1,0
1970,110309,"U Kolik",0,1,1,0
1970,110310,"R Garmany",0,1,1,0
1970,110318,"Dave George",0,1,1,0
1970,110319,"John Levin",0,1,1,0
1970,110320,"Butch Kirkorian",0,1,1,0
1970,110321,"Paul Sidone",0,1,1,0
1970,110322,"Dean Penero",0,1,1,0
1970,110323,"Charles Hoeveler",0,1,1,0
1970,110324,"Jack Acheson",0,1,1,0
1970,110325,"John Zweig",0,1,1,0
1970,110326,"John Tidball",0,1,1,0
1970,110327,"Jose Maria Gisbert",0,1,1,0
1970,110328,"Pedro Loewe",0,1,1,0
1970,110329,"Robert Puddicombe",0,1,1,0
1970,110330,"Bob Joyner",0,1,1,0
1970,110331,"Allen Morris",0,1,1,0
1970,110332,"Keith Stoneman",0,1,1,0
1970,110339,"Rodolfo Cisneros",0,1,1,0
1970,110403,"Geoffery Newton",0,1,1,0
1970,110413,"Norberto Herrero",0,1,1,0
1970,110414,"Carlos Junquet",0,1,1,0
1970,110415,"Jost Remmert",0,1,1,0
1970,110416,"Matthias Mauritz",0,1,1,0
1970,110417,"Christian Pieper",0,1,1,0
1970,110802,"Julio Van Kerckhoven",0,1,1,0
1970,111006,"William Brown",0,2,2,0
1970,112409,"Andre Thielemans",0,1,1,0
1970,112526,"Ian C Vermaak",0,1,1,0
1970,112608,"Armando Vieira",0,1,1,0
1970,112611,"Vladimir Petrovic",0,1,1,0
1970,112872,"Fritz Kuhlmann",0,1,1,0
1970,125578,"Tomas Lynch",0,1,1,0
1970,125614,"Eduardo Gorostiaga",0,1,1,0
1970,125672,"Kenneth Reid",0,1,1,0
1970,125716,"James Buckley",0,1,1,0
1970,201293,"Paul Sullivan",0,1,1,0
1970,201749,"Graydon Garner",0,2,2,0
1970,202515,"Pancho Segura",0,3,3,0
1970,202551,"Graeme Notman",0,1,1,0
1970,202588,"Oscar Escribano",0,1,1,0
1970,202616,"Octavio Piva",0,1,1,0
1970,202652,"Peter Holenstein",0,1,1,0
1970,202707,"Jannie Louw",0,1,1,0
1970,202715,"Peter Mors",0,1,1,0
1970,202757,"David Cantrell",0,1,1,0
1970,202758,"Lamar Roemer",0,1,1,0
1970,202761,"Terry Hassall",0,1,1,0
1970,202860,"Ron Bohrnstedt",0,1,1,0
1970,202896,"Rohan Summers",0,2,2,0
1970,202898,"Quentin Pretorius",0,2,2,0
1970,202955,"William Tym",0,1,1,0
1970,202982,"Norman Schellenger",0,1,1,0
1970,206972,"Fritz Kolbinger",0,1,1,0
1970,208955,"Antonio Garoni",0,1,1,0
1970,208956,"Carlos Romero",0,1,1,0
1970,208957,"Gerardo Miceli",0,1,1,0
1970,208958,"Fernando Demattei",0,1,1,0
1970,208959,"U Michod",0,1,1,0
1970,208960,"U Warfield",0,1,1,0
1970,208961,"U Stebler",0,1,1,0
1970,208962,"Dave Ranney",0,1,1,0
1970,208963,"David Borelli",0,1,1,0
1970,208990,"Elwyn Mccabe",0,1,1,0
1970,209422,"Colin Rees",0,1,1,0
1970,209423,"Stan Myerson",0,1,1,0
1970,209445,"Alvin Schwarz",0,1,1,0
1970,209446,"Unknown Seymour",0,1,1,0
1970,209447,"R Gray",0,1,1,0
1970,209535,"John Mulvey",0,1,1,0
1970,209577,"Dave Phillips",0,1,1,0
1970,209592,"Ronan Fearon",0,1,1,0
1970,209598,"Unknown Stern",0,1,1,0
1970,209599,"Unknown Rios",0,1,1,0
1970,209600,"Unknown Alvarez",0,1,1,0
1970,209601,"Unknown Orasz",0,1,1,0
1970,209602,"Unknown Braschi",0,1,1,0
1970,209603,"Tony Ortiz",0,1,1,0
1970,209604,"Colin Diederichs",0,1,1,0
1970,209605,"B Johnson",0,1,1,0
1970,209606,"Dave Michau",0,1,1,0
1970,209607,"Jim Oescher",0,1,1,0
1970,209608,"Sven Ginman",0,1,1,0
1970,209609,"Don Bitler",0,1,1,0
1970,209611,"Jim Bochte",0,1,1,0
1970,209612,"Steve Beeland",0,1,1,0
1970,209613,"Herbert Browne",0,1,1,0
1970,209614,"Jack Lowe",0,1,1,0
1970,209615,"Lornie Kuhle",0,1,1,0
1970,209616,"Jack Jackson",0,1,1,0
1970,209617,"Jiri Medonos",0,1,1,0
1970,209618,"Ivan Mikysa",0,1,1,0
1970,209619,"Victor Palman",0,1,1,0
1970,209620,"V Rudj",0,1,1,0
1970,209621,"J Jetson",0,1,1,0
1970,209622,"J Bryant",0,1,1,0
1970,209623,"R Hayes",0,1,1,0
1970,209625,"Paul Spengler",0,1,1,0
1970,209626,"R Pinchin",0,1,1,0
1970,209627,"R Lovell",0,1,1,0
1970,209628,"A Webb",0,1,1,0
1970,209629,"Bill Joiner",0,1,1,0
1970,209630,"L Kroll",0,1,1,0
1970,209631,"K French",0,1,1,0
1970,209632,"V Skacel",0,1,1,0
1970,209633,"P Frymann",0,1,1,0
1970,209634,"D Carter",0,1,1,0
1970,209635,"R Armytage",0,1,1,0
1970,209636,"J J F Robinson",0,1,1,0
1970,209637,"T Ayling",0,1,1,0
1970,209638,"Alan Fawcett",0,1,1,0
1970,209640,"B Morgan",0,1,1,0
1970,209647,"R P Tuck",0,1,1,0
1970,209649,"A Fine",0,1,1,0
1970,209650,"D B Huges",0,1,1,0
1970,209652,"M S Palmer",0,1,1,0
1970,209653,"R Mortoire",0,1,1,0
1970,209654,"R S Edwards",0,1,1,0
1970,209655,"A Jordan",0,1,1,0
1970,209656,"P Corne",0,1,1,0
1970,209657,"J C Edwards",0,1,1,0
1970,209658,"T L Darcy",0,1,1,0
1970,209659,"B Mortoire",0,1,1,0
1970,209660,"A M Thomas",0,1,1,0
1970,209661,"M M Griffiths",0,1,1,0
1970,209662,"P D R Williams",0,1,1,0
1970,209663,"C Graham",0,1,1,0
1970,209664,"D J Sheperd",0,1,1,0
1970,209665,"B L Jones",0,1,1,0
1970,209666,"C Ryan",0,1,1,0
1970,209667,"J Drory Byrne",0,1,1,0
1970,209668,"Anthony Brennan",0,1,1,0
1970,209669,"J Young",0,1,1,0
1970,209670,"Gerry Doherty",0,1,1,0
1970,209671,"J Williamson",0,1,1,0
1970,209672,"D O'Keefe",0,1,1,0
1970,209673,"T Grane",0,1,1,0
1970,209674,"Frank Mcardle",0,1,1,0
1970,209675,"B Sweeney",0,1,1,0
1970,209676,"P Smith",0,1,1,0
1970,209677,"M J R Hales",0,1,1,0
1970,209678,"S J Parry",0,1,1,0
1970,209680,"R E Williams",0,1,1,0
1970,209681,"J A Southworth",0,1,1,0
1970,209682,"A H Davies",0,1,1,0
1970,209683,"R L Cross",0,1,1,0
1970,209684,"Geoff Roberts",0,1,1,0
1970,209687,"R G Moore",0,1,1,0
1970,209688,"G Atwell",0,1,1,0
1970,209689,"G Mcvicar",0,1,1,0
1970,209690,"R D J Lee",0,1,1,0
1970,209691,"F R Burns",0,1,1,0
1970,209692,"N L Reevell",0,1,1,0
1970,209693,"K C Cook",0,1,1,0
1970,209694,"J Lascelle",0,1,1,0
1970,209695,"R Frost",0,1,1,0
1970,209696,"G R D Porteus",0,1,1,0
1970,209697,"J A Underwood",0,1,1,0
1970,209698,"S G Laing",0,1,1,0
1970,209699,"Unknown Schoenberger",0,1,1,0
1970,209700,"Wolfgang Spannagel",0,1,1,0
1970,209701,"Unknown Schroeder",0,1,1,0
1970,209702,"William Krulewitz",0,1,1,0
1970,209703,"Alan Koth",0,1,1,0
1970,209704,"Dave Snyder",0,1,1,0
1971,100015,"Sammy Giammalva",0,1,1,0
1971,100018,"Barry Mackay",0,7,7,0
1971,100024,"Jan Eric Lundquist",0,1,1,0
1971,100031,"Dimitri Sturdza",0,2,2,0
1971,100036,"Rudy Hernando",0,1,1,0
1971,100046,"Larry Nagler",0,1,1,0
1971,100052,"Keishiro Yanagi",0,2,2,0
1971,100095,"Tony Bardsley",0,1,1,0
1971,100096,"Peter Burwash",0,2,2,0
1971,100104,"D Richard Russell",0,6,6,0
1971,100116,"Sherwood Stewart",0,3,3,0
1971,100124,"Steve Turner",0,5,5,0
1971,100157,"Stanley Pasarell",0,1,1,0
1971,100167,"Sever Muresan",0,1,1,0
1971,100180,"Bill Lloyd",0,1,1,0
1971,100181,"Larry Turville",0,1,1,0
1971,100187,"Luis Felipe Tavares",0,1,1,0
1971,100204,"Pancho Walthall",0,1,1,0
1971,100208,"Dick R Bohrnstedt",0,1,1,0
1971,100209,"George Taylor",0,1,1,0
1971,100212,"Franklin Robbins",0,3,3,0
1971,100223,"Jeff Simpson",0,4,4,0
1971,100233,"Ricardo Cano",0,1,1,0
1971,100239,"Hans Engert",0,1,1,0
1971,100258,"Jorge Andrew",0,2,2,0
1971,100260,"Gary Groslimond",0,1,1,0
1971,100263,"John Andrews",0,1,1,0
1971,100266,"John Feaver",0,3,3,0
1971,100270,"Anand Amritraj",0,3,3,0
1971,100273,"Kim Warwick",0,5,5,0
1971,100274,"Eric Deblicker",0,1,1,0
1971,100281,"Sashi Menon",0,4,4,0
1971,100285,"Rod Frawley",0,3,3,0
1971,100293,"John Marks",0,1,1,0
1971,100297,"Corrado Barazzutti",0,5,5,0
1971,100308,"Robert Trogolo",0,1,1,0
1971,100310,"Mike Myburg",0,1,1,0
1971,100312,"Chiraid Mukherjea",0,1,1,0
1971,100321,"Vijay Amritraj",0,1,1,0
1971,100342,"Vitas Gerulaitis",0,1,1,0
1971,100354,"Bernard Mitton",0,1,1,0
1971,100360,"Brian Teacher",0,1,1,0
1971,100437,"Bjorn Borg",0,1,1,0
1971,100492,"John Austin",0,1,1,0
1971,100630,"Gustavo Guerrero",0,1,1,0
1971,101014,"John Ross",0,1,1,0
1971,103616,"Andre Van Der Merwe B",0,1,1,0
1971,106542,"Andrew Rae",0,1,1,0
1971,106613,"Bengt Aberg",0,2,2,0
1971,106631,"Bo Holmstrom",0,1,1,0
1971,106634,"Bob Brien",0,2,2,0
1971,106657,"Brant Bailey",0,1,1,0
1971,106923,"Eduardo Mandarino",0,1,1,0
1971,106951,"Eric Baer",0,1,1,0
1971,107074,"George Berner",0,1,1,0
1971,107123,"Graeme Thomson",0,1,1,0
1971,107132,"Greg Braun",0,1,1,0
1971,107137,"Greg Muller",0,1,1,0
1971,107140,"Greg Perkins",0,1,1,0
1971,107157,"Guy Fritz",0,1,1,0
1971,107217,"Ian Crookenden",0,3,3,0
1971,107281,"Jan Zabrodsky",0,2,2,0
1971,107378,"John Burrman",0,1,1,0
1971,107394,"John Peckskamp",0,1,1,0
1971,107541,"Larry Collins",0,1,1,0
1971,107577,"Lorenzo Soriano",0,1,1,0
1971,107599,"Luis Riba",0,1,1,0
1971,107677,"Mario Piuk",0,1,1,0
1971,107756,"Maurizio Bonaiti",0,2,2,0
1971,107759,"Max Pettman",0,1,1,0
1971,107761,"Max Wunschig",0,1,1,0
1971,107796,"Miecyslav Rybarczyk",0,1,1,0
1971,107815,"Mike Styles",0,1,1,0
1971,107898,"Osamu Ishiguro",0,1,1,0
1971,107954,"Paul Van Min",0,1,1,0
1971,107998,"Phil Gunning",0,1,1,0
1971,108017,"Pierre Joly",0,1,1,0
1971,108021,"Pietro Marzano",0,3,3,0
1971,108085,"Richard Hawkes",0,1,1,0
1971,108101,"Robbie Smith",0,1,1,0
1971,108115,"Robert Lamarche",0,1,1,0
1971,108118,"Robert Machan",0,3,3,0
1971,108198,"Salvador Cabeza",0,1,1,0
1971,108434,"Tony Parun P071",0,3,3,0
1971,108519,"William Coghlan",0,1,1,0
1971,108525,"William Durham",0,1,1,0
1971,108579,"Zlatko Ivancic",0,2,2,0
1971,109743,"Paul Hutchins",0,2,2,0
1971,109745,"Lew Hoad",0,1,1,0
1971,109748,"John Barrett",0,1,1,0
1971,109751,"Sever Dron",0,3,3,0
1971,109764,"Bernard Paul",0,1,1,0
1971,109767,"Claude De Gronckel",0,1,1,0
1971,109775,"Robert Wilson",0,2,2,0
1971,109782,"William Alvarez",0,2,2,0
1971,109783,"Bob Howe",0,1,1,0
1971,109795,"Keith Carpenter",0,1,1,0
1971,109799,"Geoff Pollard",0,1,1,0
1971,109800,"Mathias Werren",0,2,2,0
1971,109810,"Dave Simmonds",0,1,1,0
1971,109813,"Ken Fletcher",0,1,1,0
1971,109818,"Gordon Forbes",0,1,1,0
1971,109822,"Thomas Lejus",0,1,1,0
1971,109828,"Hector Romani",0,1,1,0
1971,109834,"Dan Birchmore",0,2,2,0
1971,109836,"Ken Weatherley",0,1,1,0
1971,109837,"John De Mendoza",0,2,2,0
1971,109850,"Nick Fleury",0,1,1,0
1971,109851,"Manuel Gallardo",0,1,1,0
1971,109852,"Amable Plaza",0,1,1,0
1971,109853,"U Markoff",0,1,1,0
1971,109854,"Gerry Gomes",0,1,1,0
1971,109855,"R Blanco",0,1,1,0
1971,109857,"Brian Cheney",0,1,1,0
1971,109858,"Dick Johnson",0,1,1,0
1971,109859,"Jimmy Parker",0,2,2,0
1971,109867,"D Turner",0,1,1,0
1971,109876,"Peter Lamp",0,1,1,0
1971,109877,"Rainer Kuhlmey",0,1,1,0
1971,109880,"Hendrick Sepp",0,1,1,0
1971,109889,"Tim Sturdza",0,1,1,0
1971,109896,"Jim Boyce",0,1,1,0
1971,109898,"Jon Hainline",0,1,1,0
1971,109904,"Rich Anderson",0,1,1,0
1971,109905,"Charles Darley",0,1,1,0
1971,109906,"Don Kierbow",0,1,1,0
1971,109926,"Ron Barnes",0,1,1,0
1971,109940,"Ernesto Lingen",0,1,1,0
1971,109950,"Francois Van Der Merwe",0,1,1,0
1971,109954,"John Stephens",0,1,1,0
1971,109957,"Gerry Perry",0,3,3,0
1971,109958,"Viorel Marcu",0,2,2,0
1971,109960,"Harry Fauquier",0,1,1,0
1971,109965,"Roy Sprengelmeyer",0,1,1,0
1971,109971,"Bill Monan",0,1,1,0
1971,109974,"Steve Cornell",0,1,1,0
1971,109988,"Dick Knight",0,5,5,0
1971,109995,"Herbert Rapp",0,1,1,0
1971,109999,"Peter Van Lingen",0,1,1,0
1971,110015,"Doug Verdieck",0,1,1,0
1971,110017,"John McDonald",0,1,1,0
1971,110022,"Steve Wedderburn",0,2,2,0
1971,110024,"Gondo Widjojo",0,1,1,0
1971,110053,"Ian Beverly",0,1,1,0
1971,110054,"Paul Thompson",0,1,1,0
1971,110055,"Kevin Long",0,1,1,0
1971,110056,"Ray Keenan",0,1,1,0
1971,110057,"Ross Mcghie",0,1,1,0
1971,110058,"David Mitchell",0,1,1,0
1971,110059,"James Ferguson",0,1,1,0
1971,110060,"Peter Fletcher",0,1,1,0
1971,110061,"Allan Burns",0,1,1,0
1971,110062,"Bobby Heald",0,1,1,0
1971,110063,"Frank Parker",0,1,1,0
1971,110073,"Anthony Billington",0,1,1,0
1971,110090,"Roberto Marcher",0,2,2,0
1971,110117,"Roberto Graetz",0,1,1,0
1971,110119,"Ricardo Aubone",0,1,1,0
1971,110120,"Gary Rose",0,1,1,0
1971,110172,"John Segal",0,1,1,0
1971,110173,"Jan Coebergh",0,2,2,0
1971,110174,"Fred Blatter",0,1,1,0
1971,110175,"Thedy Stalder",0,1,1,0
1971,110176,"Peter Soeters",0,1,1,0
1971,110177,"Jan Hajer",0,1,1,0
1971,110178,"Richard Kasten",0,1,1,0
1971,110179,"Mikael Stig",0,1,1,0
1971,110187,"Chuck De Voe",0,1,1,0
1971,110193,"Lothar Lanz",0,1,1,0
1971,110195,"Jan Erik Lindquist",0,1,1,0
1971,110196,"Peter Ledbetter",0,1,1,0
1971,110197,"James Mcardle",0,1,1,0
1971,110199,"Kevin Menton",0,1,1,0
1971,110249,"Karl Fichtel",0,1,1,0
1971,110285,"John Adams",0,1,1,0
1971,110323,"Charles Hoeveler",0,1,1,0
1971,110330,"Bob Joyner",0,1,1,0
1971,110331,"Allen Morris",0,2,2,0
1971,110332,"Keith Stoneman",0,1,1,0
1971,110346,"Larry Dodge",0,1,1,0
1971,110347,"Terry Ehlers",0,1,1,0
1971,110348,"John Norgauer",0,1,1,0
1971,110364,"Fabrizio Matteoli",0,1,1,0
1971,110400,"Andres Thielemans",0,1,1,0
1971,110413,"Norberto Herrero",0,1,1,0
1971,110447,"Leo Rolle",0,1,1,0
1971,110449,"Rob Danner",0,1,1,0
1971,110450,"Rob Cadwaller",0,1,1,0
1971,110451,"U Sacoldelli",0,1,1,0
1971,110873,"Compton Russell",0,1,1,0
1971,110987,"Saeed Meer",0,1,1,0
1971,110991,"Jaidip Mukerjea",0,1,1,0
1971,111006,"William Brown",0,3,3,0
1971,112337,"John B Hillebrand",0,1,1,0
1971,112457,"Lennart Bergelin",0,1,1,0
1971,112498,"Ronald S Mckenzie",0,1,1,0
1971,116790,"James Rombeau",0,2,2,0
1971,117315,"Stepan Koudelka",0,4,4,0
1971,124487,"Ernesto Vazquez Barreira",0,1,1,0
1971,125625,"David Tate",0,1,1,0
1971,199999,"U Unknown",0,14,14,0
1971,201233,"Miecyslav Rybarczyk",0,1,1,0
1971,202588,"Oscar Escribano",0,1,1,0
1971,202661,"Mario Brenner",0,1,1,0
1971,202674,"Keith Brebnor",0,2,2,0
1971,202705,"Danny Sullivan",0,2,2,0
1971,202715,"Peter Mors",0,1,1,0
1971,202720,"Waldemar Timm",0,1,1,0
1971,202792,"Carlo Borea",0,1,1,0
1971,202793,"Fabrizio Gasparini",0,1,1,0
1971,202842,"Henry Whitesell",0,1,1,0
1971,202881,"Ian Pollard",0,1,1,0
1971,202909,"Frank McDonald",0,1,1,0
1971,202946,"Gordon Birt",0,2,2,0
1971,208964,"U Savoldelli",0,1,1,0
1971,208990,"Elwyn Mccabe",0,1,1,0
1971,209420,"Helmut Fickentscher",0,1,1,0
1971,209432,"Anthony Niland",0,1,1,0
1971,209433,"Jeremy Smith",0,1,1,0
1971,209434,"R Orford",0,2,2,0
1971,209435,"Andre Makkink",0,1,1,0
1971,209436,"Theo Du Plessis",0,1,1,0
1971,209437,"Tony Bowles",0,1,1,0
1971,209438,"Peter Tudhope",0,1,1,0
1971,209439,"Kenny Smith",0,1,1,0
1971,209440,"Jan Botha",0,1,1,0
1971,209441,"Dennis Breetzke",0,1,1,0
1971,209442,"Craig Gold",0,1,1,0
1971,209443,"A Hill",0,1,1,0
1971,209444,"Jeremie Malan",0,1,1,0
1971,209526,"Derek Pollock",0,1,1,0
1971,209529,"Gerry Waldron",0,1,1,0
1971,209531,"Vivian Gotto",0,1,1,0
1971,209536,"Maurice Pollock",0,1,1,0
1971,209538,"Junjo Kawamuri",0,1,1,0
1971,209575,"A Saul",0,1,1,0
1971,209590,"Paul Fitz Simmons",0,1,1,0
1971,209592,"Ronan Fearon",0,1,1,0
1971,209606,"Dave Michau",0,1,1,0
1971,209670,"Gerry Doherty",0,1,1,0
1971,209708,"A Mcgrath",0,1,1,0
1971,209709,"Noel Holland",0,1,1,0
1971,209710,"Roland Russo",0,1,1,0
1971,209711,"D Morgan",0,1,1,0
1971,209712,"P Arndt",0,1,1,0
1971,209713,"P Deuble",0,1,1,0
1971,209714,"R Watts",0,1,1,0
1971,209715,"Lee Langstroth",0,2,2,0
1971,209716,"Ralph Geiger",0,2,2,0
1971,209717,"Jay Isqur",0,1,1,0
1971,209718,"Peter Wilson",0,1,1,0
1971,209719,"Dennis Hayes",0,1,1,0
1971,209720,"Michael Reynolds",0,1,1,0
1971,209721,"John Bozas",0,1,1,0
1971,209722,"Larry Cousins",0,1,1,0
1971,209723,"D Tomlinson",0,1,1,0
1971,209724,"Leslie Dodson",0,1,1,0
1971,209725,"Lou Monte",0,1,1,0
1971,209727,"Keith Watson",0,1,1,0
1971,209728,"Mike Hatfield",0,1,1,0
1971,209729,"Alcides Procopio Jr",0,1,1,0
1971,209730,"Chuck Saacke",0,1,1,0
1971,209737,"Julian Olave",0,1,1,0
1971,209738,"Pedro Barrios",0,1,1,0
1971,209739,"Teodoro Gurrea",0,1,1,0
1971,209740,"E Torriente",0,1,1,0
1971,209741,"Luis Moreira",0,1,1,0
1971,209742,"J Griman",0,1,1,0
1971,209743,"Alberto Comas",0,1,1,0
1971,209744,"Jose Manuel Villota",0,1,1,0
1971,209745,"Ramon Gallardo",0,1,1,0
1971,209746,"JL Cue",0,1,1,0
1971,209747,"Pedro Figar",0,1,1,0
1971,209749,"Gottfried Dallwitz",0,1,1,0
1971,209751,"Dieter Stoffer",0,1,1,0
1971,209752,"Bill Light",0,1,1,0
1971,209753,"M Munoz",0,1,1,0
1971,209754,"Des Hill",0,1,1,0
1971,209755,"L Turner",0,1,1,0
1971,209756,"I Mckenzie",0,1,1,0
1971,209757,"Don Ernst",0,1,1,0
1971,209758,"John O'Shea",0,1,1,0
1971,209759,"Anthony Ensor",0,1,1,0
1971,209760,"Erwin Jager",0,1,1,0
1971,209761,"Jock Eitel Reetz",0,1,1,0
1971,209763,"Bruno Chimenti",0,1,1,0
1971,209764,"Giuseppe Belli",0,1,1,0
1971,209765,"Mauro Rezzonico",0,1,1,0
1971,209767,"Unknown Marchiori",0,1,1,0
1971,209768,"Unknown Quartarolo",0,1,1,0
1971,209769,"Unknown Daniele",0,1,1,0
1971,209770,"S Matteoli",0,1,1,0
1971,209771,"Unknown Terrade",0,1,1,0
1971,209772,"Giuseppe Verri",0,1,1,0
1971,209773,"Unknown Salsi",0,1,1,0
1971,209774,"Randall Verdieck",0,1,1,0
1971,209775,"Massimo Pelosini",0,1,1,0
1971,209776,"Unknown Cimurri",0,1,1,0
1971,209777,"Unknown Vinti",0,1,1,0
1971,209778,"Win Irwin",0,1,1,0
1971,209779,"Lester Brown",0,1,1,0
1971,209780,"Lindsay Murphy",0,1,1,0
1971,209821,"Rod Flores",0,1,1,0
1972,100018,"Barry Mackay",0,1,1,0
1972,100024,"Jan Eric Lundquist",0,1,1,0
1972,100031,"Dimitri Sturdza",0,2,2,0
1972,100036,"Rudy Hernando",0,1,1,0
1972,100044,"Sergei Likhachev",0,2,2,0
1972,100053,"Colin Stubs",0,3,3,0
1972,100089,"Patrice Beust",0,2,2,0
1972,100095,"Tony Bardsley",0,2,2,0
1972,100103,"Peter Curtis",0,2,2,0
1972,100107,"Robert Rheinberger",0,2,2,0
1972,100112,"John Clifton",0,2,2,0
1972,100124,"Steve Turner",0,5,5,0
1972,100132,"Armistead Neely",0,3,3,0
1972,100137,"Hans Jurgen Pohmann",0,4,4,0
1972,100150,"Lito Alvarez",0,2,2,0
1972,100155,"Ramiro Benavides",0,1,1,0
1972,100165,"Steve Siegel",0,1,1,0
1972,100166,"Gene Stuart Malin",0,2,2,0
1972,100168,"Kenneth McMillan",0,1,1,0
1972,100172,"Modesto Tito Vazquez",0,1,1,0
1972,100181,"Larry Turville",0,1,1,0
1972,100183,"Jim Ward",0,1,1,0
1972,100184,"Lars Elvstrom",0,1,1,0
1972,100188,"John Fort",0,2,2,0
1972,100189,"Dale Power",0,1,1,0
1972,100195,"Nicolas Kelaidis",0,1,1,0
1972,100198,"Alvaro Betancur",0,1,1,0
1972,100208,"Dick R Bohrnstedt",0,2,2,0
1972,100210,"Steve Docherty",0,1,1,0
1972,100221,"Carlos Kirmayr",0,1,1,0
1972,100224,"Peter Campbell",0,1,1,0
1972,100237,"Bill Freer",0,1,1,0
1972,100243,"Steve Krulevitz",0,3,3,0
1972,100247,"Rolf Thung",0,1,1,0
1972,100250,"Woody Blocher",0,2,2,0
1972,100256,"Luis Baraldi",0,1,1,0
1972,100263,"John Andrews",0,1,1,0
1972,100274,"Eric Deblicker",0,1,1,0
1972,100294,"Rejean Genois",0,1,1,0
1972,100295,"Richard Legendre",0,1,1,0
1972,100298,"George Hardie",0,3,3,0
1972,100303,"Henry Bunis",0,2,2,0
1972,100319,"Rick Fagel",0,1,1,0
1972,100326,"Russell Simpson",0,1,1,0
1972,100334,"Ernie Ewert",0,1,1,0
1972,100337,"Mark Edmondson",0,1,1,0
1972,100343,"John Lloyd",0,1,1,0
1972,100345,"Pat Dupre",0,2,2,0
1972,100346,"Paul Kronk",0,2,2,0
1972,100355,"Victor Eke",0,1,1,0
1972,100359,"Richard Lewis",0,1,1,0
1972,100362,"Peter Fleming",0,1,1,0
1972,100363,"Jiri Granat",0,1,1,0
1972,100367,"Belus Prajoux",0,2,2,0
1972,100392,"Richard Meyer",0,1,1,0
1972,100395,"Victor Pecci",0,1,1,0
1972,100416,"Bill Maze",0,1,1,0
1972,100461,"Billy Martin",0,1,1,0
1972,100777,"Doug Stone",0,1,1,0
1972,100824,"Peter Bastiansen",0,1,1,0
1972,100859,"Robert Casey C100",0,1,1,0
1972,101014,"John Ross",0,1,1,0
1972,101057,"Peter Carter",0,1,1,0
1972,101131,"Jimmy Brown",0,2,2,0
1972,103616,"Andre Van Der Merwe B",0,1,1,0
1972,104225,"Jan Hajek",0,1,1,0
1972,106468,"Alberto Martorell",0,1,1,0
1972,106562,"Anthony Hammond",0,1,1,0
1972,106583,"Armando Cornejo",0,1,1,0
1972,106589,"Arthur Carrington",0,2,2,0
1972,106611,"Ben Bishop",0,1,1,0
1972,106631,"Bo Holmstrom",0,2,2,0
1972,106686,"Carlo Zugarelli",0,1,1,0
1972,106722,"Chip Fisher",0,1,1,0
1972,106801,"Dale Ogden",0,1,1,0
1972,106832,"David Collins",0,1,1,0
1972,106867,"Derek Schroder",0,7,7,0
1972,106871,"Desmond Ward",0,1,1,0
1972,106897,"Doug King",0,1,1,0
1972,106899,"Douglas Palm",0,1,1,0
1972,106910,"Eddie Cruz",0,1,1,0
1972,106964,"Ernie Mccabe",0,1,1,0
1972,107123,"Graeme Thomson",0,1,1,0
1972,107235,"Ionel Santeiu",0,1,1,0
1972,107258,"Jack Kruger",0,1,1,0
1972,107281,"Jan Zabrodsky",0,1,1,0
1972,107362,"Joel Ross",0,1,1,0
1972,107394,"John Peckskamp",0,2,2,0
1972,107398,"John Trickey",0,1,1,0
1972,107425,"Jose Moreno",0,1,1,0
1972,107453,"Juan Couder",0,1,1,0
1972,107457,"Juan Ignacio Muntanola",0,1,1,0
1972,107488,"Keith Hancock",0,3,3,0
1972,107561,"Leif Johansson",0,1,1,0
1972,107577,"Lorenzo Soriano",0,1,1,0
1972,107599,"Luis Riba",0,1,1,0
1972,107669,"Marian Laudin",0,1,1,0
1972,107704,"Mark Shires",0,1,1,0
1972,107717,"Martin Koek",0,1,1,0
1972,107810,"Mike Kreiss",0,3,3,0
1972,107951,"Paul Scholtz",0,1,1,0
1972,107965,"Pekka Saila",0,1,1,0
1972,107969,"Per Jemsby",0,1,1,0
1972,107993,"Peter Pokorny",0,2,2,0
1972,108012,"Piero Toci",0,1,1,0
1972,108021,"Pietro Marzano",0,1,1,0
1972,108079,"Rich Andrews",0,1,1,0
1972,108085,"Richard Hawkes",0,1,1,0
1972,108124,"Robert Stock",0,1,1,0
1972,108184,"Ruby Hoskowetz",0,1,1,0
1972,108304,"Stephen Myers",0,1,1,0
1972,108306,"Stephen Thompson",0,1,1,0
1972,108310,"Steve Tidball",0,1,1,0
1972,108350,"Takeshi Koura",0,1,1,0
1972,108415,"Tom Kreiss",0,1,1,0
1972,108477,"Vincenzo Franchitti",0,2,2,0
1972,108519,"William Coghlan",0,1,1,0
1972,108525,"William Durham",0,2,2,0
1972,109743,"Paul Hutchins",0,1,1,0
1972,109746,"Michele Leclercq",0,2,2,0
1972,109761,"Eric Drossart",0,2,2,0
1972,109763,"Eduardo Zuleta",0,2,2,0
1972,109781,"Peter Marmureanu",0,2,2,0
1972,109792,"Vittorio Crotta",0,1,1,0
1972,109796,"Tito Vasquez",0,1,1,0
1972,109800,"Mathias Werren",0,1,1,0
1972,109805,"Ian Bidmeade",0,2,2,0
1972,109806,"David Brown",0,1,1,0
1972,109809,"John Mills",0,1,1,0
1972,109814,"Donald Dell",0,1,1,0
1972,109830,"Thomas Lynch",0,1,1,0
1972,109835,"John Gardner",0,1,1,0
1972,109836,"Ken Weatherley",0,2,2,0
1972,109846,"Audley Bell",0,1,1,0
1972,109847,"Fritz Schunck",0,1,1,0
1972,109848,"Danny Obryant",0,1,1,0
1972,109855,"R Blanco",0,1,1,0
1972,109858,"Dick Johnson",0,2,2,0
1972,109859,"Jimmy Parker",0,1,1,0
1972,109862,"Alex Kurucz",0,3,3,0
1972,109878,"Franco Bartoni",0,1,1,0
1972,109881,"Atet Wijono",0,1,1,0
1972,109883,"Kirk Watson",0,1,1,0
1972,109892,"Kenneth Andersson",0,1,1,0
1972,109894,"Pierre Lamarche",0,1,1,0
1972,109896,"Jim Boyce",0,1,1,0
1972,109897,"Ross Walker",0,3,3,0
1972,109898,"Jon Hainline",0,1,1,0
1972,109899,"Jack Darrah",0,1,1,0
1972,109900,"Greg Shephard",0,1,1,0
1972,109901,"Cliff Mayne",0,1,1,0
1972,109902,"John Stefanki",0,1,1,0
1972,109904,"Rich Anderson",0,1,1,0
1972,109905,"Charles Darley",0,1,1,0
1972,109906,"Don Kierbow",0,1,1,0
1972,109908,"Tom Brown",0,1,1,0
1972,109909,"Bobby Siska",0,1,1,0
1972,109910,"Jim Mclennan",0,1,1,0
1972,109911,"Jose Cordon",0,1,1,0
1972,109912,"Ricky Buwalda",0,1,1,0
1972,109913,"Ralph Sender",0,1,1,0
1972,109914,"Jackie Saul",0,1,1,0
1972,109915,"U McDonald",0,2,2,0
1972,109946,"Pedro Rodrigues",0,1,1,0
1972,109947,"Bill Glaves",0,1,1,0
1972,109971,"Bill Monan",0,1,1,0
1972,109989,"Ron Goldman",0,1,1,0
1972,110054,"Paul Thompson",0,1,1,0
1972,110056,"Ray Keenan",0,1,1,0
1972,110057,"Ross Mcghie",0,1,1,0
1972,110081,"Brian Marcus",0,1,1,0
1972,110109,"Giordano Maioli",0,1,1,0
1972,110110,"Andras Szocsik",0,1,1,0
1972,110111,"Antonio Mennella",0,1,1,0
1972,110112,"Francesco Giordano",0,1,1,0
1972,110113,"Andre Van Der Merwe A",0,1,1,0
1972,110116,"O Escribano",0,1,1,0
1972,110175,"Thedy Stalder",0,1,1,0
1972,110196,"Peter Ledbetter",0,1,1,0
1972,110197,"James Mcardle",0,1,1,0
1972,110226,"Tau Luu",0,1,1,0
1972,110241,"Mike Prineas",0,2,2,0
1972,110285,"John Adams",0,1,1,0
1972,110286,"Vicente Zarazua",0,1,1,0
1972,110289,"Geoff Paish",0,2,2,0
1972,110310,"R Garmany",0,1,1,0
1972,110317,"Charles Chang",0,1,1,0
1972,110329,"Robert Puddicombe",0,1,1,0
1972,110343,"Cedric Mason",0,2,2,0
1972,110365,"Alan Haswell",0,1,1,0
1972,110366,"U Walsh",0,1,1,0
1972,110367,"I Brady",0,1,1,0
1972,110368,"Arthur Whitaker",0,1,1,0
1972,110369,"P Martin",0,1,1,0
1972,110370,"Geoffrey Olsson",0,1,1,0
1972,110392,"Toshisuke Sakai",0,1,1,0
1972,110402,"Kevin Mccollum",0,1,1,0
1972,110404,"James Smith",0,1,1,0
1972,110405,"Michael Mitchell",0,1,1,0
1972,110406,"Terry Hassell",0,1,1,0
1972,110412,"Robert Clarke",0,1,1,0
1972,110413,"Norberto Herrero",0,1,1,0
1972,110414,"Carlos Junquet",0,1,1,0
1972,110452,"Kosti Killa",0,1,1,0
1972,110873,"Compton Russell",0,1,1,0
1972,110964,"Periclis Gavrilidis",0,1,1,0
1972,110991,"Jaidip Mukerjea",0,1,1,0
1972,111135,"Greg Perkins",0,2,2,0
1972,111136,"Terry Ryan",0,2,2,0
1972,111137,"K Visscher",0,1,1,0
1972,111139,"M Cano",0,1,1,0
1972,111140,"J Bart",0,1,1,0
1972,114987,"Jack D Neer",0,1,1,0
1972,116770,"Fred Drilling",0,1,1,0
1972,125585,"Louis Hsu",0,1,1,0
1972,125672,"Kenneth Reid",0,1,1,0
1972,125716,"James Buckley",0,1,1,0
1972,202525,"Jose Moreno Tallada",0,1,1,0
1972,202541,"John Andrews",0,1,1,0
1972,202567,"Lenny Schloss",0,1,1,0
1972,202874,"Junzo Kawamori",0,1,1,0
1972,202898,"Quentin Pretorius",0,1,1,0
1972,202909,"Frank McDonald",0,1,1,0
1972,206996,"David Pratt",0,1,1,0
1972,207056,"Jesus Hernandez",0,1,1,0
1972,208965,"Glenn Gerstmar",0,1,1,0
1972,208967,"U Hamilton",0,1,1,0
1972,208968,"Bill Lefgron",0,1,1,0
1972,208969,"John Wright",0,1,1,0
1972,208970,"Andrew Mcgrath",0,1,1,0
1972,208971,"Keith Bardellini",0,1,1,0
1972,208988,"Buddy Gallagher",0,1,1,0
1972,208994,"U Koeck",0,1,1,0
1972,209505,"Francisco Gallardo",0,1,1,0
1972,209529,"Gerry Waldron",0,1,1,0
1972,209533,"Harry Sheridan",0,1,1,0
1972,209589,"Jimmy Casey",0,1,1,0
1972,209590,"Paul Fitz Simmons",0,1,1,0
1972,209668,"Anthony Brennan",0,1,1,0
1972,209672,"D O'Keefe",0,1,1,0
1972,209754,"Des Hill",0,1,1,0
1972,209781,"Barry Smith",0,1,1,0
1972,209782,"Peter Becroft",0,1,1,0
1972,209783,"Don Turner",0,1,1,0
1972,209784,"Ian Baudinet",0,1,1,0
1972,209785,"Andy Moffat",0,1,1,0
1972,209786,"KS Leung",0,1,1,0
1972,209787,"Timothy Phillips",0,1,1,0
1972,209788,"Ling Fong",0,1,1,0
1972,209789,"Wei Leung",0,1,1,0
1972,209790,"Tau Po",0,1,1,0
1972,209791,"Gary Cruth",0,1,1,0
1972,209794,"James Flanagan",0,1,1,0
1972,209795,"L Cousins",0,1,1,0
1972,209796,"Richard Levine",0,1,1,0
1972,209797,"Dennis Davis",0,1,1,0
1972,209798,"Eddie Smatt",0,1,1,0
1972,209799,"Tom Campbell",0,1,1,0
1972,209800,"Paul Palmer",0,1,1,0
1973,100003,"Frank Sedgman",0,2,2,0
1973,100012,"Nicola Pietrangeli",0,3,3,0
1973,100021,"Ashley Cooper",0,1,1,0
1973,100028,"Manuel Santana",0,1,1,0
1973,100031,"Dimitri Sturdza",0,2,2,0
1973,100044,"Sergei Likhachev",0,2,2,0
1973,100048,"Earl Butch Buchholz",0,3,3,0
1973,100052,"Keishiro Yanagi",0,3,3,0
1973,100053,"Colin Stubs",0,1,1,0
1973,100071,"Jean Claude Barclay",0,2,2,0
1973,100077,"Daniel Contet",0,1,1,0
1973,100079,"Bill Bowrey",0,3,3,0
1973,100096,"Peter Burwash",0,2,2,0
1973,100112,"John Clifton",0,2,2,0
1973,100124,"Steve Turner",0,2,2,0
1973,100131,"Guillermo Oropez",0,1,1,0
1973,100132,"Armistead Neely",0,1,1,0
1973,100138,"Dan Bleckinger",0,1,1,0
1973,100155,"Ramiro Benavides",0,1,1,0
1973,100164,"Bill Lofgren",0,1,1,0
1973,100165,"Steve Siegel",0,2,2,0
1973,100168,"Kenneth McMillan",0,6,6,0
1973,100181,"Larry Turville",0,1,1,0
1973,100183,"Jim Ward",0,1,1,0
1973,100184,"Lars Elvstrom",0,1,1,0
1973,100188,"John Fort",0,2,2,0
1973,100191,"Doug Crawford",0,2,2,0
1973,100197,"Alejandro Pierola",0,1,1,0
1973,100211,"Louk Sanders",0,1,1,0
1973,100212,"Franklin Robbins",0,6,6,0
1973,100213,"Fred Hemmes",0,1,1,0
1973,100218,"Butch Palmer",0,1,1,0
1973,100225,"Peter Doerner",0,1,1,0
1973,100236,"John James",0,4,4,0
1973,100237,"Bill Freer",0,1,1,0
1973,100242,"Mike Collins",0,3,3,0
1973,100247,"Rolf Thung",0,1,1,0
1973,100250,"Woody Blocher",0,3,3,0
1973,100260,"Gary Groslimond",0,1,1,0
1973,100263,"John Andrews",0,2,2,0
1973,100267,"Rayno Seegers",0,3,3,0
1973,100268,"Denis Naegelen",0,1,1,0
1973,100281,"Sashi Menon",0,2,2,0
1973,100287,"Robin Drysdale",0,1,1,0
1973,100290,"Timothy Noonan",0,1,1,0
1973,100291,"Ian Harris",0,1,1,0
1973,100293,"John Marks",0,1,1,0
1973,100294,"Rejean Genois",0,1,1,0
1973,100295,"Richard Legendre",0,1,1,0
1973,100302,"Joaquim Rasgado Jr",0,1,1,0
1973,100303,"Henry Bunis",0,2,2,0
1973,100322,"Emilio Montano",0,1,1,0
1973,100351,"Freddie De Jesus",0,5,5,0
1973,100352,"John Lucas",0,2,2,0
1973,100356,"Paul Mcnamee",0,2,2,0
1973,100395,"Victor Pecci",0,1,1,0
1973,100403,"Rolf Gehring",0,1,1,0
1973,100417,"Hans Gildemeister",0,2,2,0
1973,100421,"Jan Norback",0,1,1,0
1973,100428,"Gene Mayer",0,1,1,0
1973,100430,"David Carter",0,1,1,0
1973,100431,"Mansour Bahrami",0,1,1,0
1973,100436,"Nick Saviano",0,1,1,0
1973,100438,"Carlos Gattiker",0,1,1,0
1973,100440,"Eddie Edwards",0,1,1,0
1973,100444,"Werner Zirngibl",0,1,1,0
1973,100456,"Ferdi Taygan",0,1,1,0
1973,100474,"Chris Lewis",0,1,1,0
1973,100488,"Chris Delaney",0,1,1,0
1973,100512,"Robert Reininger",0,1,1,0
1973,100583,"Jeff Robbins",0,1,1,0
1973,100859,"Robert Casey C100",0,1,1,0
1973,101031,"Massimo Cierro",0,1,1,0
1973,101307,"Jeff Brown",0,1,1,0
1973,102508,"Mitch Sprengelmeyer",0,1,1,0
1973,106438,"A Uehara",0,1,1,0
1973,106456,"Akshai Misra",0,1,1,0
1973,106468,"Alberto Martorell",0,1,1,0
1973,106491,"Alexander Marcial",0,1,1,0
1973,106535,"Andres Battad",0,2,2,0
1973,106583,"Armando Cornejo",0,1,1,0
1973,106589,"Arthur Carrington",0,1,1,0
1973,106610,"Beejong Sisson",0,1,1,0
1973,106621,"Bidynt Goswami",0,1,1,0
1973,106627,"Bill Shivar",0,1,1,0
1973,106657,"Brant Bailey",0,1,1,0
1973,106697,"Carlos Feldstedt",0,3,3,0
1973,106791,"Crawford Henry",0,1,1,0
1973,106867,"Derek Schroder",0,1,1,0
1973,106899,"Douglas Palm",0,1,1,0
1973,106901,"Dragan Stojovic",0,1,1,0
1973,106910,"Eddie Cruz",0,5,5,0
1973,106922,"Eduardo Gorostagia",0,1,1,0
1973,106945,"Enrique Caviglia",0,1,1,0
1973,107000,"Fernando Dalla Fontana",0,1,1,0
1973,107026,"Francisco Mastelli",0,1,1,0
1973,107068,"Gavorielle Marcu",0,7,7,0
1973,107072,"Gene Russo",0,1,1,0
1973,107092,"Geza Varga",0,3,3,0
1973,107111,"Glenn Hamilton",0,1,1,0
1973,107132,"Greg Braun",0,2,2,0
1973,107215,"Hugo Varela",0,1,1,0
1973,107235,"Ionel Santeiu",0,1,1,0
1973,107281,"Jan Zabrodsky",0,3,3,0
1973,107302,"Jay Royappa",0,1,1,0
1973,107436,"Jose Guerrero",0,5,5,0
1973,107450,"Juan Rivera",0,1,1,0
1973,107457,"Juan Ignacio Muntanola",0,4,4,0
1973,107473,"Justedjo Tarik",0,1,1,0
1973,107527,"Konstantin Pugayev",0,1,1,0
1973,107577,"Lorenzo Soriano",0,1,1,0
1973,107591,"Luis Bruguera",0,1,1,0
1973,107627,"Manuel Ruiz",0,1,1,0
1973,107669,"Marian Laudin",0,1,1,0
1973,107728,"Massimo Di Domenico",0,3,3,0
1973,107756,"Maurizio Bonaiti",0,1,1,0
1973,107761,"Max Wunschig",0,1,1,0
1973,107796,"Miecyslav Rybarczyk",0,1,1,0
1973,107810,"Mike Kreiss",0,1,1,0
1973,107865,"Noel Callaghan",0,1,1,0
1973,107898,"Osamu Ishiguro",0,2,2,0
1973,107904,"Oswaldo Cruz",0,1,1,0
1973,107965,"Pekka Saila",0,1,1,0
1973,107969,"Per Jemsby",0,1,1,0
1973,107993,"Peter Pokorny",0,4,4,0
1973,107998,"Phil Gunning",0,1,1,0
1973,108017,"Pierre Joly",0,3,3,0
1973,108052,"Rauty Krog",0,2,2,0
1973,108085,"Richard Hawkes",0,1,1,0
1973,108124,"Robert Stock",0,1,1,0
1973,108192,"Sachio Kato",0,2,2,0
1973,108194,"Saeed Meer",0,1,1,0
1973,108254,"Shinya Tanaka",0,2,2,0
1973,108310,"Steve Tidball",0,2,2,0
1973,108362,"Terje Larsen",0,1,1,0
1973,108376,"Thierry Quintin",0,2,2,0
1973,108415,"Tom Kreiss",0,1,1,0
1973,108422,"Tomas Fort",0,1,1,0
1973,108579,"Zlatko Ivancic",0,1,1,0
1973,109743,"Paul Hutchins",0,1,1,0
1973,109745,"Lew Hoad",0,1,1,0
1973,109746,"Michele Leclercq",0,1,1,0
1973,109763,"Eduardo Zuleta",0,2,2,0
1973,109765,"Marco Gilardelli",0,1,1,0
1973,109785,"Oscar Rene Cruz",0,1,1,0
1973,109786,"Jack Gorsuch",0,1,1,0
1973,109788,"Jim Landin",0,1,1,0
1973,109789,"Rich Hillway",0,1,1,0
1973,109790,"Paolo Lazzari",0,1,1,0
1973,109791,"S Saggoni",0,1,1,0
1973,109793,"Mario Caimo",0,1,1,0
1973,109794,"C Burr",0,1,1,0
1973,109795,"Keith Carpenter",0,3,3,0
1973,109797,"Takashi Hoshiki",0,1,1,0
1973,109799,"Geoff Pollard",0,1,1,0
1973,109806,"David Brown",0,2,2,0
1973,109807,"Garry Slater",0,1,1,0
1973,109815,"Stanley Matthews",0,1,1,0
1973,109816,"E Victor Seixas",0,1,1,0
1973,109821,"Jorgen Ulrich",0,1,1,0
1973,109828,"Hector Romani",0,1,1,0
1973,109830,"Thomas Lynch",0,1,1,0
1973,109832,"Ezzat Nemati",0,1,1,0
1973,109842,"Bill Bartlett",0,1,1,0
1973,109844,"John Williams",0,1,1,0
1973,109846,"Audley Bell",0,2,2,0
1973,109850,"Nick Fleury",0,1,1,0
1973,109862,"Alex Kurucz",0,1,1,0
1973,109863,"U Timm",0,1,1,0
1973,109886,"Ted Gorski",0,1,1,0
1973,109893,"Don Mccormick",0,2,2,0
1973,109900,"Greg Shephard",0,1,1,0
1973,109907,"Henry Hank Kamakana",0,1,1,0
1973,109915,"U McDonald",0,2,2,0
1973,109919,"Paul Sullivan",0,1,1,0
1973,109922,"Harald Neuner",0,1,1,0
1973,109945,"Milan Holecek",0,1,1,0
1973,109960,"Harry Fauquier",0,1,1,0
1973,109988,"Dick Knight",0,1,1,0
1973,110002,"Tom Karp",0,1,1,0
1973,110053,"Ian Beverly",0,1,1,0
1973,110057,"Ross Mcghie",0,1,1,0
1973,110081,"Brian Marcus",0,1,1,0
1973,110094,"Bill Bennion",0,1,1,0
1973,110102,"Phil Siviter",0,1,1,0
1973,110110,"Andras Szocsik",0,1,1,0
1973,110138,"Roberto Gratz",0,1,1,0
1973,110139,"Anthony Ryan",0,1,1,0
1973,110140,"Larry Moody",0,1,1,0
1973,110142,"H Brenner",0,1,1,0
1973,110143,"Bryan Borea",0,1,1,0
1973,110144,"K Shimamura",0,1,1,0
1973,110146,"Geoff Griffiths",0,1,1,0
1973,110150,"Raymond Mapp",0,1,1,0
1973,110151,"Praful Ghatage",0,1,1,0
1973,110152,"Graham Thompson",0,1,1,0
1973,110153,"Phil Tovey",0,1,1,0
1973,110155,"Jeremy Bond",0,1,1,0
1973,110157,"Robert Lidgey",0,1,1,0
1973,110160,"Greg Peebles",0,2,2,0
1973,110162,"U Pickthall",0,1,1,0
1973,110185,"Michael Hickey",0,1,1,0
1973,110196,"Peter Ledbetter",0,1,1,0
1973,110197,"James Mcardle",0,1,1,0
1973,110208,"R Spitzer",0,1,1,0
1973,110209,"Jackie Cooper",0,3,3,0
1973,110213,"Marcus Kramer",0,1,1,0
1973,110214,"Samudra Sangitan",0,1,1,0
1973,110216,"Jacky Wullur",0,1,1,0
1973,110219,"Widyo Tetuko",0,1,1,0
1973,110222,"Iman Sutarli",0,1,1,0
1973,110223,"Albert Simangunsong",0,1,1,0
1973,110224,"Robert Bedard",0,1,1,0
1973,110226,"Tau Luu",0,2,2,0
1973,110246,"Joe Mesmer",0,1,1,0
1973,110247,"Colin Mchugo",0,1,1,0
1973,110296,"Felix Morey",0,1,1,0
1973,110297,"K Brebnor",0,1,1,0
1973,110298,"Christer Holm",0,1,1,0
1973,110311,"Ks Leung",0,1,1,0
1973,110312,"Alan Ho",0,1,1,0
1973,110313,"K Tsui",0,1,1,0
1973,110314,"Jeck Chu",0,1,1,0
1973,110315,"Po Tau",0,1,1,0
1973,110316,"William Koo",0,1,1,0
1973,110317,"Charles Chang",0,1,1,0
1973,110337,"David Seigel",0,1,1,0
1973,110338,"Neil Golden",0,1,1,0
1973,110351,"Issa Khodai",0,1,1,0
1973,110352,"Mostafa Saleh",0,1,1,0
1973,110353,"Moharram Ali Khodai",0,1,1,0
1973,110401,"Fritz Gildemeister",0,1,1,0
1973,110420,"E Chavez",0,1,1,0
1973,110873,"Compton Russell",0,1,1,0
1973,112312,"Frank Arthur Sedgman",0,1,1,0
1973,114613,"Shyam Minotra",0,1,1,0
1973,125625,"David Tate",0,1,1,0
1973,125672,"Kenneth Reid",0,1,1,0
1973,125716,"James Buckley",0,1,1,0
1973,201618,"Uli Heyne",0,1,1,0
1973,201644,"Rob Wallace",0,1,1,0
1973,202561,"Steve Stefanki",0,1,1,0
1973,202686,"Balaram Singh",0,1,1,0
1973,202687,"Narendra Singh",0,1,1,0
1973,202761,"Terry Hassall",0,1,1,0
1973,202767,"Richard Finger",0,1,1,0
1973,202915,"Mohammed Arif Elahi",0,1,1,0
1973,202938,"Josef Solc",0,1,1,0
1973,206954,"Budiman Aznar",0,1,1,0
1973,206996,"David Pratt",0,1,1,0
1973,207077,"Desmond Early",0,1,1,0
1973,208972,"Ardyanto Suta Wibawa",0,1,1,0
1973,208973,"U Suwito",0,1,1,0
1973,208974,"D Hardiman",0,1,1,0
1973,208975,"Richard Stott",0,1,1,0
1973,208976,"J Hill",0,1,1,0
1973,208977,"Nick Lee",0,1,1,0
1973,208978,"Richard Hillage",0,1,1,0
1973,208979,"Stephen Jones",0,1,1,0
1973,208980,"U Thomas",0,1,1,0
1973,208981,"M Williams",0,1,1,0
1973,208982,"Mike Rowe",0,1,1,0
1973,208983,"D Robert",0,1,1,0
1973,208984,"W Lung",0,1,1,0
1973,208985,"U Jadcyznski",0,1,1,0
1973,209420,"Helmut Fickentscher",0,1,1,0
1973,209535,"John Mulvey",0,1,1,0
1973,209590,"Paul Fitz Simmons",0,1,1,0
1973,209592,"Ronan Fearon",0,1,1,0
1973,209668,"Anthony Brennan",0,1,1,0
1973,209674,"Frank Mcardle",0,1,1,0
1973,209782,"Peter Becroft",0,1,1,0
1973,209783,"Don Turner",0,1,1,0
1973,209793,"Don O'Connell",0,1,1,0
1973,209802,"Terence Musgrove",0,1,1,0
1973,209803,"John Manderson",0,1,1,0
1973,209804,"Chris Greendale",0,1,1,0
1973,209805,"Ken Kelleher",0,1,1,0
1973,209806,"Michael Probst",0,1,1,0
1973,209807,"Andreas Trenkle",0,1,1,0
1973,209808,"Holger Osinski",0,1,1,0
1973,209809,"Herbert Loerke",0,1,1,0
1973,209810,"Francis Barnett",0,1,1,0
1974,100002,"Pancho Segura",0,1,1,0
1974,100003,"Frank Sedgman",0,1,1,0
1974,100018,"Barry Mackay",0,2,2,0
1974,100020,"Alejandro Olmedo",0,2,2,0
1974,100042,"Ryoichi Mori",0,2,2,0
1974,100046,"Larry Nagler",0,1,1,0
1974,100048,"Earl Butch Buchholz",0,1,1,0
1974,100052,"Keishiro Yanagi",0,4,4,0
1974,100053,"Colin Stubs",0,3,3,0
1974,100065,"Terry Ryan",0,4,4,0
1974,100070,"Jan Kukal",0,4,4,0
1974,100077,"Daniel Contet",0,2,2,0
1974,100095,"Tony Bardsley",0,6,6,0
1974,100096,"Peter Burwash",0,1,1,0
1974,100101,"Mike Belkin",0,1,1,0
1974,100123,"Patrick Hombergen",0,1,1,0
1974,100125,"John Cooper",0,2,2,0
1974,100152,"David Lloyd",0,2,2,0
1974,100153,"Patrice Hagelauer",0,2,2,0
1974,100157,"Stanley Pasarell",0,1,1,0
1974,100159,"Vladimir Korotkov",0,1,1,0
1974,100165,"Steve Siegel",0,4,4,0
1974,100168,"Kenneth McMillan",0,6,6,0
1974,100177,"Pavel Hutka",0,1,1,0
1974,100189,"Dale Power",0,1,1,0
1974,100195,"Nicolas Kelaidis",0,2,2,0
1974,100197,"Alejandro Pierola",0,1,1,0
1974,100198,"Alvaro Betancur",0,1,1,0
1974,100212,"Franklin Robbins",0,1,1,0
1974,100213,"Fred Hemmes",0,1,1,0
1974,100234,"Allan McDonald",0,1,1,0
1974,100237,"Bill Freer",0,1,1,0
1974,100240,"Joao Soares",0,1,1,0
1974,100250,"Woody Blocher",0,2,2,0
1974,100256,"Luis Baraldi",0,1,1,0
1974,100276,"Terry Moor",0,3,3,0
1974,100294,"Rejean Genois",0,2,2,0
1974,100306,"Michael Wayman",0,1,1,0
1974,100316,"Scott Carnahan",0,1,1,0
1974,100318,"Roger Guedes",0,1,1,0
1974,100328,"Rand Evett",0,1,1,0
1974,100333,"Shigeyuki Nishio",0,2,2,0
1974,100336,"Guillermo Aubone",0,1,1,0
1974,100344,"Eric Friedler",0,1,1,0
1974,100355,"Victor Eke",0,1,1,0
1974,100356,"Paul Mcnamee",0,5,5,0
1974,100362,"Peter Fleming",0,2,2,0
1974,100364,"Jonathan Smith",0,2,2,0
1974,100369,"Herve Gauvain",0,1,1,0
1974,100374,"Javier Soler",0,1,1,0
1974,100378,"David Schneider",0,1,1,0
1974,100383,"Peter Mcnamara",0,3,3,0
1974,100390,"Trevor Allan",0,1,1,0
1974,100392,"Richard Meyer",0,2,2,0
1974,100407,"Dale Collings",0,2,2,0
1974,100412,"Bruce Nichols",0,1,1,0
1974,100415,"Michael Grant",0,1,1,0
1974,100416,"Bill Maze",0,1,1,0
1974,100469,"Ashok Amritraj",0,8,8,0
1974,100483,"Christophe Casa",0,1,1,0
1974,100506,"Howard Schoenfield",0,1,1,0
1974,100541,"Jan Kallquist",0,1,1,0
1974,100792,"Adrian Marcu",0,1,1,0
1974,106453,"Akinori Naguro",0,2,2,0
1974,106455,"Akira Motomura",0,2,2,0
1974,106468,"Alberto Martorell",0,1,1,0
1974,106491,"Alexander Marcial",0,1,1,0
1974,106517,"Anatoli Volkov",0,1,1,0
1974,106535,"Andres Battad",0,1,1,0
1974,106561,"Anthony Fawcett",0,1,1,0
1974,106562,"Anthony Hammond",0,1,1,0
1974,106583,"Armando Cornejo",0,2,2,0
1974,106611,"Ben Bishop",0,2,2,0
1974,106613,"Bengt Aberg",0,1,1,0
1974,106621,"Bidynt Goswami",0,1,1,0
1974,106627,"Bill Shivar",0,1,1,0
1974,106631,"Bo Holmstrom",0,1,1,0
1974,106657,"Brant Bailey",0,1,1,0
1974,106682,"Carey Brading",0,1,1,0
1974,106859,"Dean Martin Jr",0,1,1,0
1974,106883,"Dimitru Haradau",0,1,1,0
1974,106900,"Dragan Savic",0,2,2,0
1974,106910,"Eddie Cruz",0,1,1,0
1974,106962,"Ernesto Vazquez",0,1,1,0
1974,106964,"Ernie Mccabe",0,2,2,0
1974,106996,"Felix Ponte",0,5,5,0
1974,107026,"Francisco Mastelli",0,3,3,0
1974,107074,"George Berner",0,1,1,0
1974,107111,"Glenn Hamilton",0,1,1,0
1974,107132,"Greg Braun",0,1,1,0
1974,107177,"Harry Brittain",0,1,1,0
1974,107215,"Hugo Varela",0,1,1,0
1974,107281,"Jan Zabrodsky",0,3,3,0
1974,107385,"John Holladay",0,2,2,0
1974,107436,"Jose Guerrero",0,2,2,0
1974,107455,"Juan Hernandez",0,1,1,0
1974,107457,"Juan Ignacio Muntanola",0,4,4,0
1974,107473,"Justedjo Tarik",0,1,1,0
1974,107549,"Lars Samuelson",0,1,1,0
1974,107591,"Luis Bruguera",0,1,1,0
1974,107654,"Marco Consolini",0,1,1,0
1974,107704,"Mark Shires",0,2,2,0
1974,107744,"Matti Timonen",0,1,1,0
1974,107759,"Max Pettman",0,2,2,0
1974,107760,"Max Senior",0,1,1,0
1974,107768,"Michael Burgener",0,1,1,0
1974,107780,"Michael Phillips",0,1,1,0
1974,107825,"Mohammad Hossein Akbari",0,1,1,0
1974,107830,"Munawar Iqbal",0,1,1,0
1974,107893,"Omar Laimina",0,1,1,0
1974,107895,"Orlando Agudelo",0,1,1,0
1974,107898,"Osamu Ishiguro",0,4,4,0
1974,107965,"Pekka Saila",0,1,1,0
1974,107969,"Per Jemsby",0,1,1,0
1974,107981,"Peter Hampton",0,1,1,0
1974,107985,"Peter Langsford",0,2,2,0
1974,107993,"Peter Pokorny",0,2,2,0
1974,108012,"Piero Toci",0,3,3,0
1974,108017,"Pierre Joly",0,2,2,0
1974,108021,"Pietro Marzano",0,2,2,0
1974,108036,"Rafael Ruiz",0,2,2,0
1974,108052,"Rauty Krog",0,2,2,0
1974,108085,"Richard Hawkes",0,2,2,0
1974,108131,"Roberto Chavez",0,1,1,0
1974,108172,"Romeo Rafon",0,1,1,0
1974,108193,"Sadao Kosugi",0,2,2,0
1974,108253,"Shinichi Sakamoto",0,1,1,0
1974,108275,"Spencer Segura",0,7,7,0
1974,108303,"Stephen Meyers",0,1,1,0
1974,108314,"Steve Messmer",0,1,1,0
1974,108343,"Taghi Akbari",0,1,1,0
1974,108362,"Terje Larsen",0,2,2,0
1974,108379,"Thies Roepcke",0,2,2,0
1974,108407,"Tom Christensen",0,3,3,0
1974,108430,"Tony Dawson",0,1,1,0
1974,108453,"Ulf Eriksson",0,2,2,0
1974,108503,"Wayne Cowley",0,2,2,0
1974,108519,"William Coghlan",0,3,3,0
1974,108533,"Wouter Fok",0,1,1,0
1974,109745,"Lew Hoad",0,1,1,0
1974,109746,"Michele Leclercq",0,1,1,0
1974,109786,"Jack Gorsuch",0,1,1,0
1974,109787,"Cm Robinson",0,1,1,0
1974,109794,"C Burr",0,3,3,0
1974,109795,"Keith Carpenter",0,1,1,0
1974,109807,"Garry Slater",0,1,1,0
1974,109809,"John Mills",0,2,2,0
1974,109811,"Chauncey Steele Iii",0,1,1,0
1974,109814,"Donald Dell",0,1,1,0
1974,109816,"E Victor Seixas",0,1,1,0
1974,109817,"Stefan Koudelka",0,1,1,0
1974,109832,"Ezzat Nemati",0,1,1,0
1974,109834,"Dan Birchmore",0,1,1,0
1974,109842,"Bill Bartlett",0,1,1,0
1974,109843,"Brian Tobin",0,1,1,0
1974,109850,"Nick Fleury",0,1,1,0
1974,109857,"Brian Cheney",0,1,1,0
1974,109859,"Jimmy Parker",0,1,1,0
1974,109861,"P Gorostiaga",0,1,1,0
1974,109862,"Alex Kurucz",0,1,1,0
1974,109863,"U Timm",0,1,1,0
1974,109881,"Atet Wijono",0,1,1,0
1974,109894,"Pierre Lamarche",0,1,1,0
1974,109918,"Bill Wright",0,1,1,0
1974,109919,"Paul Sullivan",0,1,1,0
1974,109920,"Bill Drake",0,1,1,0
1974,109922,"Harald Neuner",0,1,1,0
1974,109923,"Roberto Aubone",0,1,1,0
1974,109924,"Takao Yamamoto",0,2,2,0
1974,109933,"Martin Carlstein",0,1,1,0
1974,109947,"Bill Glaves",0,1,1,0
1974,109948,"Clive Brebnor",0,1,1,0
1974,109949,"G Silberman",0,1,1,0
1974,109952,"Osamu Yanagihara",0,1,1,0
1974,109953,"Yoshimito Miyashita",0,2,2,0
1974,109954,"John Stephens",0,2,2,0
1974,109994,"Dave Harmon",0,1,1,0
1974,110004,"Josef Stabholz",0,1,1,0
1974,110081,"Brian Marcus",0,1,1,0
1974,110107,"David Segal",0,1,1,0
1974,110185,"Michael Hickey",0,1,1,0
1974,110196,"Peter Ledbetter",0,1,1,0
1974,110197,"James Mcardle",0,1,1,0
1974,110198,"H Sheridan",0,1,1,0
1974,110199,"Kevin Menton",0,1,1,0
1974,110200,"Justin Obront",0,1,1,0
1974,110201,"K Reid",0,1,1,0
1974,110214,"Samudra Sangitan",0,1,1,0
1974,110221,"B Dimalanta",0,1,1,0
1974,110226,"Tau Luu",0,1,1,0
1974,110238,"A Whittaker",0,1,1,0
1974,110239,"Nick Boyne",0,2,2,0
1974,110241,"Mike Prineas",0,2,2,0
1974,110249,"Karl Fichtel",0,1,1,0
1974,110256,"Micky Dominguez",0,1,1,0
1974,110265,"Perry Wright",0,1,1,0
1974,110286,"Vicente Zarazua",0,1,1,0
1974,110327,"Jose Maria Gisbert",0,1,1,0
1974,110336,"Kanyab Derafshidjavan",0,1,1,0
1974,110342,"Fred Whitaker",0,1,1,0
1974,110391,"Maurice Claitte",0,1,1,0
1974,110409,"Mark Joffey",0,1,1,0
1974,110410,"Bob Folz",0,1,1,0
1974,110936,"Sergio Cruz",0,1,1,0
1974,112457,"Lennart Bergelin",0,1,1,0
1974,129924,"Robert Lee",0,1,1,0
1974,201293,"Paul Sullivan",0,1,1,0
1974,202513,"John Holladay",0,2,2,0
1974,202547,"Erik Stenninger",0,1,1,0
1974,202616,"Octavio Piva",0,1,1,0
1974,202619,"Chris Burr",0,1,1,0
1974,202621,"G Harris",0,1,1,0
1974,202622,"W Thom",0,1,1,0
1974,202623,"S Menzies",0,1,1,0
1974,202624,"T Mooney",0,1,1,0
1974,202627,"Michael Mooney",0,1,1,0
1974,202628,"D Neilson",0,1,1,0
1974,202646,"Lee Merry",0,1,1,0
1974,202674,"Keith Brebnor",0,1,1,0
1974,202687,"Narendra Singh",0,1,1,0
1974,202699,"Mazizat Sofyan",0,1,1,0
1974,202701,"Eugene Mccabe",0,2,2,0
1974,202760,"Ron Myers",0,1,1,0
1974,202762,"J Adams",0,1,1,0
1974,202776,"Robert Millington",0,1,1,0
1974,202830,"Kazumi Yanagihara",0,1,1,0
1974,202955,"William Tym",0,1,1,0
1974,208986,"U Akhtar",0,1,1,0
1974,208987,"J Zimincer",0,1,1,0
1974,208988,"Buddy Gallagher",0,1,1,0
1974,208990,"Elwyn Mccabe",0,1,1,0
1974,209420,"Helmut Fickentscher",0,1,1,0
1974,209421,"Wayne Bryan",0,1,1,0
1974,209681,"J A Southworth",0,1,1,0
1974,209823,"J Logan",0,1,1,0
1974,209824,"E Topham",0,1,1,0
1974,209826,"Shoukri Moubarek",0,1,1,0
1974,209832,"C Lane",0,1,1,0
1974,209833,"K Stevens",0,1,1,0
1974,209834,"R Beaver",0,1,1,0
1974,209835,"Arlo Elkins",0,1,1,0
1974,209836,"B Wheadley",0,1,1,0
1974,209837,"Mark Wilson",0,1,1,0
1974,209838,"Ian Parkin",0,1,1,0
1974,209839,"N Gillasby",0,1,1,0
1974,209840,"J Frederick",0,1,1,0
1974,209841,"J Fannin",0,1,1,0
1974,209842,"C Whittle",0,1,1,0
1974,209843,"P Finn",0,1,1,0
1974,209844,"Unknown Rodrigues",0,1,1,0
1974,209845,"Kyoichi Sakamoto",0,1,1,0
1975,100003,"Frank Sedgman",0,1,1,0
1975,100011,"Torben Ulrich",0,4,4,0
1975,100013,"Neale Fraser",0,2,2,0
1975,100014,"Trevor Fancutt",0,1,1,0
1975,100017,"Mal Anderson",0,1,1,0
1975,100023,"Ramanathan Krishnan",0,1,1,0
1975,100027,"Gene Scott",0,4,4,0
1975,100031,"Dimitri Sturdza",0,1,1,0
1975,100032,"Patricio Rodriguez Chi",0,1,1,0
1975,100045,"John Paish",0,3,3,0
1975,100046,"Larry Nagler",0,1,1,0
1975,100050,"Martin Mulligan",0,1,1,0
1975,100051,"Premjit Lall",0,1,1,0
1975,100053,"Colin Stubs",0,1,1,0
1975,100066,"Frank Froehling",0,3,3,0
1975,100071,"Jean Claude Barclay",0,1,1,0
1975,100077,"Daniel Contet",0,1,1,0
1975,100094,"Jim Osborne",0,1,1,0
1975,100095,"Tony Bardsley",0,2,2,0
1975,100104,"D Richard Russell",0,1,1,0
1975,100108,"Chris Bovett",0,1,1,0
1975,100110,"Terry Addison",0,2,2,0
1975,100134,"Roy Barth",0,1,1,0
1975,100143,"Peter Fishbach",0,1,1,0
1975,100166,"Gene Stuart Malin",0,1,1,0
1975,100172,"Modesto Tito Vazquez",0,7,7,0
1975,100188,"John Fort",0,3,3,0
1975,100189,"Dale Power",0,2,2,0
1975,100195,"Nicolas Kelaidis",0,1,1,0
1975,100197,"Alejandro Pierola",0,1,1,0
1975,100206,"Kenichi Hirai",0,4,4,0
1975,100211,"Louk Sanders",0,2,2,0
1975,100213,"Fred Hemmes",0,1,1,0
1975,100225,"Peter Doerner",0,2,2,0
1975,100234,"Allan McDonald",0,1,1,0
1975,100237,"Bill Freer",0,4,4,0
1975,100250,"Woody Blocher",0,7,7,0
1975,100259,"Peter Feigl",0,1,1,0
1975,100276,"Terry Moor",0,1,1,0
1975,100283,"Andre Zietsmann",0,1,1,0
1975,100294,"Rejean Genois",0,1,1,0
1975,100302,"Joaquim Rasgado Jr",0,2,2,0
1975,100306,"Michael Wayman",0,1,1,0
1975,100310,"Mike Myburg",0,2,2,0
1975,100315,"Hank Pfister",0,4,4,0
1975,100317,"Stephen Warboys",0,6,6,0
1975,100319,"Rick Fagel",0,1,1,0
1975,100320,"Mark Meyers",0,1,1,0
1975,100331,"Jean Louis Haillet",0,4,4,0
1975,100345,"Pat Dupre",0,2,2,0
1975,100351,"Freddie De Jesus",0,1,1,0
1975,100355,"Victor Eke",0,1,1,0
1975,100357,"Bhanu Nunna",0,2,2,0
1975,100363,"Jiri Granat",0,5,5,0
1975,100369,"Herve Gauvain",0,1,1,0
1975,100374,"Javier Soler",0,1,1,0
1975,100378,"David Schneider",0,2,2,0
1975,100380,"Butch Walts",0,3,3,0
1975,100392,"Richard Meyer",0,1,1,0
1975,100397,"Terry Rocavert",0,1,1,0
1975,100402,"Francisco Gonzalez",0,2,2,0
1975,100406,"Greg Halder",0,1,1,0
1975,100414,"Gunther Gnettner",0,1,1,0
1975,100416,"Bill Maze",0,1,1,0
1975,100417,"Hans Gildemeister",0,1,1,0
1975,100429,"Miguel Mir",0,1,1,0
1975,100440,"Eddie Edwards",0,1,1,0
1975,100442,"Gianni Marchetti",0,2,2,0
1975,100450,"Leo Palin",0,1,1,0
1975,100469,"Ashok Amritraj",0,3,3,0
1975,100474,"Chris Lewis",0,1,1,0
1975,100477,"Gianni Ocleppo",0,1,1,0
1975,100479,"Reinhart Probst",0,1,1,0
1975,100492,"John Austin",0,3,3,0
1975,100506,"Howard Schoenfield",0,2,2,0
1975,100524,"Shozo Shiraishi",0,1,1,0
1975,100541,"Jan Kallquist",0,2,2,0
1975,100545,"Deon Joubert",0,3,3,0
1975,100575,"Andy Andrews",0,1,1,0
1975,100651,"Alejandro Ganzabal",0,1,1,0
1975,100803,"Stefan Svensson",0,1,1,0
1975,102688,"Jason Smith",0,1,1,0
1975,106438,"A Uehara",0,1,1,0
1975,106440,"Abdel Aslam Mahmoudi",0,1,1,0
1975,106561,"Anthony Fawcett",0,3,3,0
1975,106567,"Antonio Domenech",0,1,1,0
1975,106611,"Ben Bishop",0,2,2,0
1975,106614,"Bengt Lundstedt",0,2,2,0
1975,106627,"Bill Shivar",0,1,1,0
1975,106630,"Bjorn Wahlstrom",0,1,1,0
1975,106634,"Bob Brien",0,1,1,0
1975,106697,"Carlos Feldstedt",0,1,1,0
1975,106702,"Carlos Lando",0,2,2,0
1975,106828,"Dave Kanter",0,1,1,0
1975,106867,"Derek Schroder",0,2,2,0
1975,106900,"Dragan Savic",0,3,3,0
1975,106901,"Dragan Stojovic",0,2,2,0
1975,106910,"Eddie Cruz",0,1,1,0
1975,106950,"Enzo Vattuone",0,1,1,0
1975,106971,"Ezio Di Matteo",0,2,2,0
1975,107026,"Francisco Mastelli",0,2,2,0
1975,107038,"Frank Salazar",0,1,1,0
1975,107072,"Gene Russo",0,2,2,0
1975,107078,"George Rudman",0,2,2,0
1975,107092,"Geza Varga",0,1,1,0
1975,107129,"Graydon Garner",0,1,1,0
1975,107132,"Greg Braun",0,2,2,0
1975,107167,"Hans Goransson",0,1,1,0
1975,107235,"Ionel Santeiu",0,1,1,0
1975,107275,"Jan Hordijk",0,1,1,0
1975,107301,"Jay Harvey",0,1,1,0
1975,107353,"Joe Bouquin",0,1,1,0
1975,107374,"John Antonas",0,2,2,0
1975,107381,"John Eagleton",0,1,1,0
1975,107391,"John Muller",0,1,1,0
1975,107394,"John Peckskamp",0,1,1,0
1975,107398,"John Trickey",0,1,1,0
1975,107429,"Jose Castanon",0,4,4,0
1975,107456,"Juan Herrera",0,5,5,0
1975,107488,"Keith Hancock",0,1,1,0
1975,107518,"Kiyoski Tanabe",0,2,2,0
1975,107590,"Luis Borfiga",0,1,1,0
1975,107654,"Marco Consolini",0,1,1,0
1975,107704,"Mark Shires",0,1,1,0
1975,107728,"Massimo Di Domenico",0,1,1,0
1975,107761,"Max Wunschig",0,1,1,0
1975,107768,"Michael Burgener",0,1,1,0
1975,107815,"Mike Styles",0,2,2,0
1975,107898,"Osamu Ishiguro",0,1,1,0
1975,107965,"Pekka Saila",0,1,1,0
1975,107985,"Peter Langsford",0,1,1,0
1975,108047,"Randy Jones",0,1,1,0
1975,108130,"Roberto Carruthers",0,1,1,0
1975,108133,"Roberto Lombardi",0,1,1,0
1975,108154,"Roger Mckee",0,1,1,0
1975,108192,"Sachio Kato",0,3,3,0
1975,108198,"Salvador Cabeza",0,3,3,0
1975,108304,"Stephen Myers",0,1,1,0
1975,108343,"Taghi Akbari",0,1,1,0
1975,108376,"Thierry Quintin",0,1,1,0
1975,108434,"Tony Parun P071",0,2,2,0
1975,108446,"Trevor Little",0,1,1,0
1975,108453,"Ulf Eriksson",0,1,1,0
1975,108466,"Vicente Castano",0,1,1,0
1975,108503,"Wayne Cowley",0,1,1,0
1975,108519,"William Coghlan",0,1,1,0
1975,108525,"William Durham",0,1,1,0
1975,109362,"Helson Barros",0,1,1,0
1975,109786,"Jack Gorsuch",0,1,1,0
1975,109796,"Tito Vasquez",0,2,2,0
1975,109806,"David Brown",0,1,1,0
1975,109807,"Garry Slater",0,1,1,0
1975,109814,"Donald Dell",0,3,3,0
1975,109831,"K Javan",0,1,1,0
1975,109832,"Ezzat Nemati",0,1,1,0
1975,109833,"Richard Russell",0,1,1,0
1975,109893,"Don Mccormick",0,1,1,0
1975,109894,"Pierre Lamarche",0,1,1,0
1975,109896,"Jim Boyce",0,1,1,0
1975,109903,"Whitney Reed",0,1,1,0
1975,109961,"Lester Sack",0,1,1,0
1975,110054,"Paul Thompson",0,1,1,0
1975,110106,"John Eastburn",0,1,1,0
1975,110121,"Robin Ray",0,3,3,0
1975,110132,"Hugh Thomson",0,1,1,0
1975,110166,"Chiradip Mukerjea",0,1,1,0
1975,110209,"Jackie Cooper",0,1,1,0
1975,110241,"Mike Prineas",0,2,2,0
1975,110256,"Micky Dominguez",0,1,1,0
1975,110288,"Abdel Ghani",0,1,1,0
1975,110341,"Jukka Narakka",0,1,1,0
1975,110342,"Fred Whitaker",0,1,1,0
1975,110364,"Fabrizio Matteoli",0,1,1,0
1975,110404,"James Smith",0,1,1,0
1975,110411,"Florian Merkel",0,1,1,0
1975,110423,"Octavio Piva Neto",0,1,1,0
1975,110424,"Joaquin Castellano",0,1,1,0
1975,110425,"Stephen Taylor",0,1,1,0
1975,110426,"Arif Kocak",0,1,1,0
1975,110428,"Bedri Baykam",0,1,1,0
1975,110429,"Mustafa Gencsoy",0,1,1,0
1975,110430,"Ahmet Gencsoy",0,1,1,0
1975,110431,"Nezih Gunal",0,1,1,0
1975,110432,"Selim Var",0,1,1,0
1975,110433,"Cumhur Ongen",0,1,1,0
1975,110434,"Oguz Eroglu",0,1,1,0
1975,110435,"Ziya Isikustun",0,1,1,0
1975,110436,"Ali Yenilmez",0,1,1,0
1975,110437,"Ali Gorec",0,1,1,0
1975,110439,"Beyazit Anbar",0,1,1,0
1975,110440,"Orhan Atas",0,1,1,0
1975,110442,"Vartan Tetikbas",0,1,1,0
1975,110443,"Murat Gurler",0,1,1,0
1975,110444," ",0,1,1,0
1975,110445,"Milos Dimitrijevic",0,2,2,0
1975,110446,"Bertram Knowles",0,1,1,0
1975,110447,"Leo Rolle",0,1,1,0
1975,110448,"Bob Adams",0,1,1,0
1975,110789,"Sebti Bounaib",0,1,1,0
1975,110792,"Hocine Younes",0,1,1,0
1975,110987,"Saeed Meer",0,1,1,0
1975,110991,"Jaidip Mukerjea",0,1,1,0
1975,111033,"Kiyoshi Tanabe",0,1,1,0
1975,111135,"Greg Perkins",0,1,1,0
1975,111136,"Terry Ryan",0,1,1,0
1975,111138,"Dennis Matthews",0,1,1,0
1975,124487,"Ernesto Vazquez Barreira",0,1,1,0
1975,125578,"Tomas Lynch",0,1,1,0
1975,201749,"Graydon Garner",0,1,1,0
1975,202513,"John Holladay",0,2,2,0
1975,202551,"Graeme Notman",0,1,1,0
1975,202616,"Octavio Piva",0,1,1,0
1975,202620,"Jose Villarete",0,1,1,0
1975,202674,"Keith Brebnor",0,1,1,0
1975,202754,"Ken Hiskins",0,1,1,0
1975,208989,"Larry Rolle",0,1,1,0
1975,208990,"Elwyn Mccabe",0,2,2,0
1975,208991,"Don Brosseau",0,1,1,0
1975,208992,"U Lindorff",0,1,1,0
1976,100005,"Richard Pancho Gonzales",0,1,1,0
1976,100022,"Roy Emerson",0,2,2,0
1976,100030,"Fred Stolle",0,1,1,0
1976,100031,"Dimitri Sturdza",0,2,2,0
1976,100032,"Patricio Rodriguez Chi",0,1,1,0
1976,100048,"Earl Butch Buchholz",0,1,1,0
1976,100057,"Pierre Barthes",0,2,2,0
1976,100071,"Jean Claude Barclay",0,1,1,0
1976,100072,"Bailey Brown",0,1,1,0
1976,100075,"Owen Davidson",0,1,1,0
1976,100077,"Daniel Contet",0,1,1,0
1976,100078,"Clark Graebner",0,3,3,0
1976,100089,"Patrice Beust",0,1,1,0
1976,100107,"Robert Rheinberger",0,4,4,0
1976,100136,"Humphrey Hose",0,2,2,0
1976,100143,"Peter Fishbach",0,1,1,0
1976,100145,"Dick Dell",0,1,1,0
1976,100164,"Bill Lofgren",0,2,2,0
1976,100168,"Kenneth McMillan",0,3,3,0
1976,100169,"Ian Fletcher",0,2,2,0
1976,100172,"Modesto Tito Vazquez",0,2,2,0
1976,100175,"Zan Guerry",0,6,6,0
1976,100180,"Bill Lloyd",0,4,4,0
1976,100189,"Dale Power",0,2,2,0
1976,100195,"Nicolas Kelaidis",0,1,1,0
1976,100210,"Steve Docherty",0,3,3,0
1976,100224,"Peter Campbell",0,1,1,0
1976,100241,"Joel Bailey",0,1,1,0
1976,100248,"Max Hurlimann",0,2,2,0
1976,100269,"Joe Garcia",0,1,1,0
1976,100277,"Jacques Thamin",0,6,6,0
1976,100294,"Rejean Genois",0,2,2,0
1976,100323,"Givaldo Barbosa",0,1,1,0
1976,100334,"Ernie Ewert",0,3,3,0
1976,100357,"Bhanu Nunna",0,5,5,0
1976,100358,"Mike Fishbach",0,1,1,0
1976,100383,"Peter Mcnamara",0,2,2,0
1976,100386,"Jose Garcia",0,1,1,0
1976,100388,"Peter Pearson",0,4,4,0
1976,100397,"Terry Rocavert",0,1,1,0
1976,100400,"Hubertus Hoyt",0,2,2,0
1976,100402,"Francisco Gonzalez",0,3,3,0
1976,100403,"Rolf Gehring",0,6,6,0
1976,100408,"Gary Plock",0,1,1,0
1976,100416,"Bill Maze",0,1,1,0
1976,100431,"Mansour Bahrami",0,3,3,0
1976,100435,"Regis Brunet",0,1,1,0
1976,100442,"Gianni Marchetti",0,1,1,0
1976,100446,"John Sadri",0,1,1,0
1976,100468,"Dominique Bedel",0,2,2,0
1976,100475,"Matt Mitchell",0,1,1,0
1976,100486,"Christophe Roger Vasselin",0,1,1,0
1976,100498,"Klaus Eberhard",0,4,4,0
1976,100503,"Lorenzo Fargas",0,1,1,0
1976,100506,"Howard Schoenfield",0,1,1,0
1976,100535,"Tony Giammalva",0,1,1,0
1976,100541,"Jan Kallquist",0,1,1,0
1976,100543,"Peter Elter",0,2,2,0
1976,100575,"Andy Andrews",0,1,1,0
1976,100630,"Gustavo Guerrero",0,1,1,0
1976,100651,"Alejandro Ganzabal",0,1,1,0
1976,100667,"Per Hjertquist",0,1,1,0
1976,100673,"Robbie Venter",0,1,1,0
1976,100752,"Ramesh Krishnan",0,1,1,0
1976,100803,"Stefan Svensson",0,1,1,0
1976,100987,"Tom Fontana",0,1,1,0
1976,101014,"John Ross",0,1,1,0
1976,101228,"Jorg Muller",0,2,2,0
1976,106468,"Alberto Martorell",0,2,2,0
1976,106558,"Aniceto Alvarez",0,1,1,0
1976,106594,"Attila Korpas",0,2,2,0
1976,106615,"Bernard Balleret",0,1,1,0
1976,106631,"Bo Holmstrom",0,1,1,0
1976,106801,"Dale Ogden",0,1,1,0
1976,106802,"Dan Rastland",0,1,1,0
1976,106828,"Dave Kanter",0,1,1,0
1976,106859,"Dean Martin Jr",0,2,2,0
1976,106910,"Eddie Cruz",0,1,1,0
1976,106950,"Enzo Vattuone",0,1,1,0
1976,106962,"Ernesto Vazquez",0,1,1,0
1976,106971,"Ezio Di Matteo",0,1,1,0
1976,107001,"Fernando Gentil",0,1,1,0
1976,107026,"Francisco Mastelli",0,1,1,0
1976,107078,"George Rudman",0,1,1,0
1976,107082,"Gerard Wimmer",0,2,2,0
1976,107109,"Glenn Busby",0,1,1,0
1976,107119,"Gordon Simmonds",0,1,1,0
1976,107132,"Greg Braun",0,1,1,0
1976,107180,"Harvey Spiegel",0,2,2,0
1976,107215,"Hugo Varela",0,1,1,0
1976,107217,"Ian Crookenden",0,2,2,0
1976,107273,"Jan Eric Palm",0,1,1,0
1976,107281,"Jan Zabrodsky",0,2,2,0
1976,107284,"Janos Benyik",0,2,2,0
1976,107298,"Javier Restrepo",0,1,1,0
1976,107302,"Jay Royappa",0,1,1,0
1976,107362,"Joel Ross",0,1,1,0
1976,107385,"John Holladay",0,3,3,0
1976,107394,"John Peckskamp",0,1,1,0
1976,107398,"John Trickey",0,3,3,0
1976,107427,"Jose Schmidt",0,1,1,0
1976,107429,"Jose Castanon",0,6,6,0
1976,107454,"Juan Diaz",0,1,1,0
1976,107488,"Keith Hancock",0,1,1,0
1976,107541,"Larry Collins",0,1,1,0
1976,107549,"Lars Samuelson",0,1,1,0
1976,107561,"Leif Johansson",0,1,1,0
1976,107590,"Luis Borfiga",0,1,1,0
1976,107627,"Manuel Ruiz",0,1,1,0
1976,107711,"Markus Nagel",0,1,1,0
1976,107875,"Octavio Martinez",0,2,2,0
1976,107892,"Olle Palmer",0,1,1,0
1976,107893,"Omar Laimina",0,1,1,0
1976,107954,"Paul Van Min",0,1,1,0
1976,107985,"Peter Langsford",0,1,1,0
1976,108012,"Piero Toci",0,2,2,0
1976,108021,"Pietro Marzano",0,1,1,0
1976,108026,"R Kiesling",0,1,1,0
1976,108036,"Rafael Ruiz",0,1,1,0
1976,108045,"Randall King",0,2,2,0
1976,108053,"Ray Kelly",0,3,3,0
1976,108075,"Ricardo Herrera",0,1,1,0
1976,108118,"Robert Machan",0,2,2,0
1976,108131,"Roberto Chavez",0,1,1,0
1976,108141,"Rocky Vasquez",0,1,1,0
1976,108184,"Ruby Hoskowetz",0,1,1,0
1976,108194,"Saeed Meer",0,1,1,0
1976,108214,"Scott Clark",0,1,1,0
1976,108275,"Spencer Segura",0,2,2,0
1976,108315,"Steve Mott",0,1,1,0
1976,108326,"Steven Wright",0,1,1,0
1976,108368,"Tetsu Kuramitsu",0,2,2,0
1976,108379,"Thies Roepcke",0,1,1,0
1976,108407,"Tom Christensen",0,1,1,0
1976,108415,"Tom Kreiss",0,3,3,0
1976,108421,"Toma Ovici",0,2,2,0
1976,108434,"Tony Parun P071",0,1,1,0
1976,108459,"Vadim Borisov",0,1,1,0
1976,108477,"Vincenzo Franchitti",0,1,1,0
1976,108503,"Wayne Cowley",0,1,1,0
1976,108533,"Wouter Fok",0,1,1,0
1976,108547,"Yair Werthimer",0,1,1,0
1976,108567,"Yuji Tezuka",0,1,1,0
1976,109795,"Keith Carpenter",0,1,1,0
1976,109796,"Tito Vasquez",0,2,2,0
1976,109807,"Garry Slater",0,1,1,0
1976,109814,"Donald Dell",0,2,2,0
1976,109840,"Benjamin Janse Sims",0,1,1,0
1976,109842,"Bill Bartlett",0,1,1,0
1976,109861,"P Gorostiaga",0,2,2,0
1976,109888,"Geoff Brown",0,1,1,0
1976,109896,"Jim Boyce",0,1,1,0
1976,109941,"David Epstein",0,1,1,0
1976,109942,"R Carter",0,1,1,0
1976,109943,"K Casey",0,1,1,0
1976,110013,"B Chaffey",0,1,1,0
1976,110015,"Doug Verdieck",0,1,1,0
1976,110065,"P Hagna",0,1,1,0
1976,110095,"V Popanen",0,1,1,0
1976,110096,"B Yoranssen",0,1,1,0
1976,110097,"D Perensby",0,1,1,0
1976,110099,"J Kirs",0,1,1,0
1976,110100,"B Larsen",0,1,1,0
1976,110101,"J Fairchild",0,1,1,0
1976,110131,"D Gueddes",0,1,1,0
1976,110134,"U Calle",0,1,1,0
1976,110137,"U Fischtel",0,1,1,0
1976,110205,"Lawrence Awopegba",0,1,1,0
1976,110206,"Yenesi Allen",0,1,1,0
1976,110238,"A Whittaker",0,1,1,0
1976,110252,"Terry Suyderhoud",0,1,1,0
1976,110253,"Nicolas Sotiriu",0,1,1,0
1976,110256,"Micky Dominguez",0,1,1,0
1976,110351,"Issa Khodai",0,1,1,0
1976,110353,"Moharram Ali Khodai",0,1,1,0
1976,110394,"A Simmons",0,1,1,0
1976,110395,"J Cabeza",0,1,1,0
1976,110396,"Alberto Capitan",0,1,1,0
1976,110397,"Abdelkader Madani",0,1,1,0
1976,110398,"E Neemati",0,1,1,0
1976,110399,"J Tobin",0,1,1,0
1976,110407,"Bob Helmers",0,1,1,0
1976,110453,"Javier Roch",0,1,1,0
1976,110991,"Jaidip Mukerjea",0,1,1,0
1976,111136,"Terry Ryan",0,1,1,0
1976,124487,"Ernesto Vazquez Barreira",0,1,1,0
1976,199999,"U Unknown",0,1,1,0
1976,202513,"John Holladay",0,1,1,0
1976,202693,"Nimish Desai",0,1,1,0
1976,202713,"Graham Silberman",0,1,1,0
1976,209811,"Peter Adolph",0,1,1,0
1977,100001,"Gardnar Mulloy",0,1,1,0
1977,100028,"Manuel Santana",0,2,2,0
1977,100031,"Dimitri Sturdza",0,1,1,0
1977,100049,"Jim Mcmanus",0,2,2,0
1977,100080,"Szabolcz Baranyi",0,1,1,0
1977,100089,"Patrice Beust",0,1,1,0
1977,100123,"Patrick Hombergen",0,1,1,0
1977,100132,"Armistead Neely",0,1,1,0
1977,100133,"Pat Cramer",0,2,2,0
1977,100136,"Humphrey Hose",0,1,1,0
1977,100142,"Peter Szoke",0,1,1,0
1977,100143,"Peter Fishbach",0,1,1,0
1977,100145,"Dick Dell",0,1,1,0
1977,100153,"Patrice Hagelauer",0,1,1,0
1977,100154,"Peter Kanderal",0,1,1,0
1977,100156,"Jasjit Singh",0,3,3,0
1977,100168,"Kenneth McMillan",0,3,3,0
1977,100172,"Modesto Tito Vazquez",0,1,1,0
1977,100181,"Larry Turville",0,2,2,0
1977,100189,"Dale Power",0,3,3,0
1977,100206,"Kenichi Hirai",0,2,2,0
1977,100209,"George Taylor",0,1,1,0
1977,100216,"Charles Owens",0,1,1,0
1977,100222,"Mike Powers",0,2,2,0
1977,100224,"Peter Campbell",0,4,4,0
1977,100240,"Joao Soares",0,1,1,0
1977,100241,"Joel Bailey",0,2,2,0
1977,100250,"Woody Blocher",0,7,7,0
1977,100256,"Luis Baraldi",0,1,1,0
1977,100263,"John Andrews",0,1,1,0
1977,100277,"Jacques Thamin",0,1,1,0
1977,100290,"Timothy Noonan",0,2,2,0
1977,100310,"Mike Myburg",0,1,1,0
1977,100316,"Scott Carnahan",0,6,6,0
1977,100318,"Roger Guedes",0,1,1,0
1977,100355,"Victor Eke",0,1,1,0
1977,100370,"Helmut Beermann",0,1,1,0
1977,100387,"Jiri Prucha",0,1,1,0
1977,100388,"Peter Pearson",0,2,2,0
1977,100396,"Martin Robinson",0,1,1,0
1977,100401,"Sean Sorensen",0,1,1,0
1977,100408,"Gary Plock",0,1,1,0
1977,100410,"Tim Garcia",0,1,1,0
1977,100411,"Pavel Slozil",0,2,2,0
1977,100412,"Bruce Nichols",0,2,2,0
1977,100414,"Gunther Gnettner",0,1,1,0
1977,100416,"Bill Maze",0,3,3,0
1977,100429,"Miguel Mir",0,2,2,0
1977,100432,"Robert Bettauer",0,1,1,0
1977,100435,"Regis Brunet",0,2,2,0
1977,100440,"Eddie Edwards",0,1,1,0
1977,100442,"Gianni Marchetti",0,1,1,0
1977,100446,"John Sadri",0,1,1,0
1977,100449,"Stanislav Birner",0,1,1,0
1977,100450,"Leo Palin",0,2,2,0
1977,100451,"Tony Graham",0,2,2,0
1977,100455,"Tony Lloyd",0,1,1,0
1977,100456,"Ferdi Taygan",0,3,3,0
1977,100464,"Warren Maher",0,5,5,0
1977,100469,"Ashok Amritraj",0,3,3,0
1977,100485,"Tsuyoshi Fukui",0,1,1,0
1977,100491,"Alan Chandronnait",0,1,1,0
1977,100492,"John Austin",0,1,1,0
1977,100494,"John Picken",0,1,1,0
1977,100499,"Chris Mayotte",0,1,1,0
1977,100503,"Lorenzo Fargas",0,1,1,0
1977,100504,"Jerome Vanier",0,2,2,0
1977,100516,"Andrew Jarrett",0,2,2,0
1977,100541,"Jan Kallquist",0,2,2,0
1977,100557,"Jai Dilouie",0,1,1,0
1977,100577,"Rory Chappell",0,2,2,0
1977,100600,"Pascal Portes",0,1,1,0
1977,100640,"Stefan Simonsson",0,2,2,0
1977,100659,"Helmar Stiegler",0,1,1,0
1977,100667,"Per Hjertquist",0,1,1,0
1977,100676,"Yannick Noah",0,1,1,0
1977,100752,"Ramesh Krishnan",0,1,1,0
1977,101228,"Jorg Muller",0,1,1,0
1977,106447,"Adolfo Gonzalez",0,1,1,0
1977,106491,"Alexander Marcial",0,1,1,0
1977,106537,"Andres Molina",0,1,1,0
1977,106558,"Aniceto Alvarez",0,1,1,0
1977,106568,"Antonio Hartmann",0,1,1,0
1977,106641,"Bobby Webb",0,1,1,0
1977,106651,"Brad Rowe",0,1,1,0
1977,106700,"Carlos Gomez",0,1,1,0
1977,106728,"Chris Ellis",0,1,1,0
1977,106837,"David Hall",0,1,1,0
1977,106859,"Dean Martin Jr",0,2,2,0
1977,106883,"Dimitru Haradau",0,1,1,0
1977,106923,"Eduardo Mandarino",0,1,1,0
1977,106945,"Enrique Caviglia",0,3,3,0
1977,107132,"Greg Braun",0,2,2,0
1977,107167,"Hans Goransson",0,1,1,0
1977,107273,"Jan Eric Palm",0,1,1,0
1977,107279,"Jan Simbera",0,5,5,0
1977,107298,"Javier Restrepo",0,1,1,0
1977,107302,"Jay Royappa",0,1,1,0
1977,107357,"Joe Meyers",0,1,1,0
1977,107374,"John Antonas",0,1,1,0
1977,107379,"John Chris Lewis",0,2,2,0
1977,107381,"John Eagleton",0,1,1,0
1977,107391,"John Muller",0,1,1,0
1977,107394,"John Peckskamp",0,1,1,0
1977,107420,"Jorge Todero",0,1,1,0
1977,107429,"Jose Castanon",0,1,1,0
1977,107437,"Jose Llamas",0,1,1,0
1977,107456,"Juan Herrera",0,1,1,0
1977,107577,"Lorenzo Soriano",0,1,1,0
1977,107728,"Massimo Di Domenico",0,2,2,0
1977,107744,"Matti Timonen",0,1,1,0
1977,107867,"Noel Jensen",0,1,1,0
1977,107893,"Omar Laimina",0,1,1,0
1977,107953,"Paul Smith",0,1,1,0
1977,107968,"Per Hegna",0,1,1,0
1977,108036,"Rafael Ruiz",0,1,1,0
1977,108039,"Raimo Ojala",0,1,1,0
1977,108053,"Ray Kelly",0,2,2,0
1977,108054,"Raymond Pascale",0,1,1,0
1977,108085,"Richard Hawkes",0,1,1,0
1977,108131,"Roberto Chavez",0,2,2,0
1977,108133,"Roberto Lombardi",0,1,1,0
1977,108172,"Romeo Rafon",0,1,1,0
1977,108198,"Salvador Cabeza",0,1,1,0
1977,108214,"Scott Clark",0,1,1,0
1977,108304,"Stephen Myers",0,3,3,0
1977,108315,"Steve Mott",0,1,1,0
1977,108343,"Taghi Akbari",0,1,1,0
1977,108362,"Terje Larsen",0,1,1,0
1977,108418,"Tom Mott",0,1,1,0
1977,108446,"Trevor Little",0,1,1,0
1977,108459,"Vadim Borisov",0,3,3,0
1977,108477,"Vincenzo Franchitti",0,2,2,0
1977,109796,"Tito Vasquez",0,2,2,0
1977,109807,"Garry Slater",0,1,1,0
1977,109808,"Graham Oliver",0,1,1,0
1977,109809,"John Mills",0,1,1,0
1977,109826,"Dave Bohrnstedt",0,3,3,0
1977,109828,"Hector Romani",0,1,1,0
1977,109856,"Edison Mandarino",0,1,1,0
1977,109871,"Harry Fritz",0,1,1,0
1977,109889,"Tim Sturdza",0,1,1,0
1977,109923,"Roberto Aubone",0,1,1,0
1977,109924,"Takao Yamamoto",0,1,1,0
1977,110113,"Andre Van Der Merwe A",0,1,1,0
1977,110138,"Roberto Gratz",0,1,1,0
1977,110207,"L Maeso",0,1,1,0
1977,110208,"R Spitzer",0,1,1,0
1977,110242,"R Mayer",0,1,1,0
1977,110259,"D Savid",0,1,1,0
1977,110261,"R Vasselin",0,1,1,0
1977,110262,"B Renault",0,1,1,0
1977,110264,"H Lerke",0,1,1,0
1977,110265,"Perry Wright",0,1,1,0
1977,110266,"Jose Santiago",0,1,1,0
1977,110336,"Kanyab Derafshidjavan",0,1,1,0
1977,110353,"Moharram Ali Khodai",0,1,1,0
1977,110357,"R Buckley",0,1,1,0
1977,110358,"C Sakolsky",0,1,1,0
1977,110359,"E Vasquez",0,1,1,0
1977,110360,"Scott Shannon",0,1,1,0
1977,110361,"T Carey",0,1,1,0
1977,110388,"J Luna",0,1,1,0
1977,110418,"Gabriel Neascu",0,1,1,0
1977,110419,"John Corse",0,1,1,0
1977,110422,"A El Ghani",0,1,1,0
1977,111006,"William Brown",0,1,1,0
1977,111033,"Kiyoshi Tanabe",0,1,1,0
1977,111136,"Terry Ryan",0,1,1,0
1977,130938,"John Austin",0,1,1,0
1977,200499,"Dean Martin",0,1,1,0
1977,202513,"John Holladay",0,2,2,0
1977,209710,"Roland Russo",0,1,1,0
1978,100006,"Grant Golden",0,1,1,0
1978,100025,"Barry Phillips Moore",0,4,4,0
1978,100030,"Fred Stolle",0,1,1,0
1978,100032,"Patricio Rodriguez Chi",0,1,1,0
1978,100038,"Jaime Pinto Bravo",0,1,1,0
1978,100045,"John Paish",0,2,2,0
1978,100048,"Earl Butch Buchholz",0,1,1,0
1978,100049,"Jim Mcmanus",0,4,4,0
1978,100069,"Dennis Ralston",0,1,1,0
1978,100094,"Jim Osborne",0,1,1,0
1978,100102,"Joaquin Loyo Mayo",0,2,2,0
1978,100123,"Patrick Hombergen",0,1,1,0
1978,100142,"Peter Szoke",0,1,1,0
1978,100145,"Dick Dell",0,1,1,0
1978,100164,"Bill Lofgren",0,1,1,0
1978,100166,"Gene Stuart Malin",0,2,2,0
1978,100169,"Ian Fletcher",0,2,2,0
1978,100180,"Bill Lloyd",0,6,6,0
1978,100183,"Jim Ward",0,1,1,0
1978,100191,"Doug Crawford",0,3,3,0
1978,100195,"Nicolas Kelaidis",0,1,1,0
1978,100202,"George Amaya",0,2,2,0
1978,100206,"Kenichi Hirai",0,3,3,0
1978,100216,"Charles Owens",0,1,1,0
1978,100224,"Peter Campbell",0,2,2,0
1978,100230,"Welry Fritz",0,2,2,0
1978,100241,"Joel Bailey",0,5,5,0
1978,100256,"Luis Baraldi",0,1,1,0
1978,100268,"Denis Naegelen",0,1,1,0
1978,100278,"Frank Gebert",0,4,4,0
1978,100299,"James Chico Hagey",0,2,2,0
1978,100301,"Jim Delaney",0,2,2,0
1978,100303,"Henry Bunis",0,3,3,0
1978,100305,"Mark Farrell",0,1,1,0
1978,100306,"Michael Wayman",0,3,3,0
1978,100310,"Mike Myburg",0,2,2,0
1978,100318,"Roger Guedes",0,2,2,0
1978,100320,"Mark Meyers",0,1,1,0
1978,100323,"Givaldo Barbosa",0,2,2,0
1978,100324,"John Whitlinger",0,1,1,0
1978,100330,"David Imonitie",0,1,1,0
1978,100333,"Shigeyuki Nishio",0,2,2,0
1978,100341,"Gonzalo Nunez",0,1,1,0
1978,100348,"Gerard Toulon",0,1,1,0
1978,100353,"Bruce Kleege",0,3,3,0
1978,100355,"Victor Eke",0,1,1,0
1978,100357,"Bhanu Nunna",0,3,3,0
1978,100368,"Haroon Ismail",0,1,1,0
1978,100369,"Herve Gauvain",0,3,3,0
1978,100373,"Christopher Sylvan",0,2,2,0
1978,100375,"John Hayes",0,1,1,0
1978,100408,"Gary Plock",0,1,1,0
1978,100413,"Ulrich Marten",0,1,1,0
1978,100414,"Gunther Gnettner",0,1,1,0
1978,100416,"Bill Maze",0,1,1,0
1978,100425,"Junie Chatman",0,1,1,0
1978,100432,"Robert Bettauer",0,1,1,0
1978,100433,"Fritz Don",0,1,1,0
1978,100439,"Mike Barr",0,1,1,0
1978,100464,"Warren Maher",0,2,2,0
1978,100475,"Matt Mitchell",0,2,2,0
1978,100479,"Reinhart Probst",0,1,1,0
1978,100481,"Roberto Vizcaino",0,1,1,0
1978,100485,"Tsuyoshi Fukui",0,3,3,0
1978,100491,"Alan Chandronnait",0,1,1,0
1978,100495,"Wayne Hampson",0,2,2,0
1978,100497,"Markus Gunthardt",0,1,1,0
1978,100499,"Chris Mayotte",0,4,4,0
1978,100502,"Vincent Van Patten",0,3,3,0
1978,100503,"Lorenzo Fargas",0,1,1,0
1978,100504,"Jerome Vanier",0,1,1,0
1978,100510,"Franco Merlone",0,1,1,0
1978,100512,"Robert Reininger",0,2,2,0
1978,100518,"Ricardo Acuna",0,1,1,0
1978,100522,"Chris Dunk",0,1,1,0
1978,100527,"Chris Bradnam",0,1,1,0
1978,100535,"Tony Giammalva",0,1,1,0
1978,100541,"Jan Kallquist",0,2,2,0
1978,100544,"Tony Mmoh",0,1,1,0
1978,100550,"Brad Guan",0,1,1,0
1978,100565,"Lloyd Bourne",0,1,1,0
1978,100570,"Marty Davis",0,1,1,0
1978,100597,"Jay Lapidus",0,1,1,0
1978,100603,"Roland Stadler",0,1,1,0
1978,100611,"Mel Purcell",0,2,2,0
1978,100612,"Alvaro Margets",0,1,1,0
1978,100615,"Gianluca Rinaldini",0,1,1,0
1978,100616,"Andy Kohlberg",0,1,1,0
1978,100622,"Patrizio Parrini",0,2,2,0
1978,100634,"Larry Gottfried",0,4,4,0
1978,100649,"David Dowlen",0,1,1,0
1978,100655,"Fritz Buehning",0,1,1,0
1978,100711,"Pedro Rebolledo",0,1,1,0
1978,100738,"Schalk Van Der Merwe",0,1,1,0
1978,100764,"Gabriel Urpi",0,1,1,0
1978,100789,"Ivan Dupasquier",0,1,1,0
1978,100821,"Hans Simonsson",0,3,3,0
1978,103993,"Chris Lewis",0,1,1,0
1978,106452,"Akifumi Machidori",0,2,2,0
1978,106454,"Akira Kawaguchi",0,2,2,0
1978,106455,"Akira Motomura",0,2,2,0
1978,106491,"Alexander Marcial",0,1,1,0
1978,106505,"Ali Madani",0,1,1,0
1978,106550,"Andy Lucchesi",0,1,1,0
1978,106551,"Andy Mccurry",0,1,1,0
1978,106591,"Asher Kahn",0,2,2,0
1978,106611,"Ben Bishop",0,1,1,0
1978,106615,"Bernard Balleret",0,1,1,0
1978,106703,"Carlos Lopez",0,1,1,0
1978,106723,"Chip Tolleson",0,1,1,0
1978,106789,"Craig Venter",0,1,1,0
1978,106848,"David Whyte",0,1,1,0
1978,106859,"Dean Martin Jr",0,2,2,0
1978,106865,"Dennis Gibson",0,1,1,0
1978,106947,"Enrique Haro",0,1,1,0
1978,106966,"Etsuo Uchiyama",0,2,2,0
1978,106971,"Ezio Di Matteo",0,1,1,0
1978,106983,"Fabrizio Fanucci",0,2,2,0
1978,107078,"George Rudman",0,1,1,0
1978,107091,"Gewan Maharaj",0,2,2,0
1978,107132,"Greg Braun",0,1,1,0
1978,107157,"Guy Fritz",0,1,1,0
1978,107252,"J Spinnenweber",0,1,1,0
1978,107297,"Javier Ordaz",0,1,1,0
1978,107298,"Javier Restrepo",0,1,1,0
1978,107326,"Jeff Twist",0,1,1,0
1978,107334,"Jerry Van Linge",0,1,1,0
1978,107353,"Joe Bouquin",0,1,1,0
1978,107425,"Jose Moreno",0,1,1,0
1978,107437,"Jose Llamas",0,1,1,0
1978,107457,"Juan Ignacio Muntanola",0,1,1,0
1978,107463,"Juan Torralbo",0,1,1,0
1978,107518,"Kiyoski Tanabe",0,1,1,0
1978,107557,"Lawrence Hall",0,3,3,0
1978,107654,"Marco Consolini",0,1,1,0
1978,107677,"Mario Piuk",0,1,1,0
1978,107728,"Massimo Di Domenico",0,1,1,0
1978,107761,"Max Wunschig",0,1,1,0
1978,107809,"Mike Harrington",0,1,1,0
1978,107840,"Nandan Bal",0,1,1,0
1978,107864,"Nobuya Tamura",0,2,2,0
1978,107867,"Noel Jensen",0,1,1,0
1978,107875,"Octavio Martinez",0,2,2,0
1978,107880,"Ola Hellgren",0,1,1,0
1978,107903,"Osuma Nakamura",0,2,2,0
1978,107911,"P Gerads",0,1,1,0
1978,107954,"Paul Van Min",0,1,1,0
1978,107970,"Per Larsson",0,2,2,0
1978,107997,"Phil Davies",0,1,1,0
1978,108054,"Raymond Pascale",0,1,1,0
1978,108133,"Roberto Lombardi",0,5,5,0
1978,108192,"Sachio Kato",0,2,2,0
1978,108231,"Segun Balogun",0,1,1,0
1978,108234,"Sergei Leonjuk",0,1,1,0
1978,108250,"Shanker Krishnan",0,1,1,0
1978,108253,"Shinichi Sakamoto",0,2,2,0
1978,108342,"Tadeusz Nowicki",0,3,3,0
1978,108345,"Taisen Kanai",0,2,2,0
1978,108357,"Ted Williams",0,1,1,0
1978,108368,"Tetsu Kuramitsu",0,2,2,0
1978,108377,"Thierry Stevaux",0,1,1,0
1978,108379,"Thies Roepcke",0,1,1,0
1978,108418,"Tom Mott",0,1,1,0
1978,108477,"Vincenzo Franchitti",0,1,1,0
1978,108494,"Walter Redondo",0,2,2,0
1978,108579,"Zlatko Ivancic",0,1,1,0
1978,109753,"Pierre Jauffret",0,1,1,0
1978,109796,"Tito Vasquez",0,1,1,0
1978,109849,"A Hernandez",0,1,1,0
1978,109924,"Takao Yamamoto",0,2,2,0
1978,109941,"David Epstein",0,1,1,0
1978,110093,"Thomas Werner",0,2,2,0
1978,110145,"B Kronruge",0,1,1,0
1978,110205,"Lawrence Awopegba",0,1,1,0
1978,110250,"Stephen Temple",0,1,1,0
1978,110251,"A Trenkle",0,1,1,0
1978,110254,"S Teterion",0,1,1,0
1978,110345,"Drew Meyers",0,1,1,0
1978,110408,"F Briscoe",0,1,1,0
1978,110419,"John Corse",0,1,1,0
1978,111033,"Kiyoshi Tanabe",0,3,3,0
1978,199999,"U Unknown",0,3,3,0
1978,202519,"Mark Turpin",0,1,1,0
1978,208993,"Hal Gorman",0,1,1,0
1979,100017,"Mal Anderson",0,1,1,0
1979,100025,"Barry Phillips Moore",0,1,1,0
1979,100029,"Rod Laver",0,1,1,0
1979,100040,"Bob Hewitt",0,3,3,0
1979,100075,"Owen Davidson",0,1,1,0
1979,100086,"Frantisek Pala",0,2,2,0
1979,100114,"Ray Ruffels",0,4,4,0
1979,100128,"Cliff Richey",0,1,1,0
1979,100133,"Pat Cramer",0,1,1,0
1979,100145,"Dick Dell",0,1,1,0
1979,100147,"Marcello Lara",0,2,2,0
1979,100150,"Lito Alvarez",0,6,6,0
1979,100152,"David Lloyd",0,2,2,0
1979,100169,"Ian Fletcher",0,1,1,0
1979,100172,"Modesto Tito Vazquez",0,1,1,0
1979,100183,"Jim Ward",0,1,1,0
1979,100184,"Lars Elvstrom",0,1,1,0
1979,100189,"Dale Power",0,1,1,0
1979,100204,"Pancho Walthall",0,1,1,0
1979,100208,"Dick R Bohrnstedt",0,2,2,0
1979,100209,"George Taylor",0,1,1,0
1979,100226,"Mike Machette",0,5,5,0
1979,100248,"Max Hurlimann",0,2,2,0
1979,100250,"Woody Blocher",0,1,1,0
1979,100268,"Denis Naegelen",0,2,2,0
1979,100283,"Andre Zietsmann",0,2,2,0
1979,100305,"Mark Farrell",0,1,1,0
1979,100310,"Mike Myburg",0,1,1,0
1979,100316,"Scott Carnahan",0,1,1,0
1979,100323,"Givaldo Barbosa",0,5,5,0
1979,100341,"Gonzalo Nunez",0,1,1,0
1979,100348,"Gerard Toulon",0,1,1,0
1979,100352,"John Lucas",0,1,1,0
1979,100381,"Michael Greenberg",0,2,2,0
1979,100385,"Filip Krajcik",0,1,1,0
1979,100389,"Horace Reid",0,1,1,0
1979,100393,"Marcos Hocevar",0,1,1,0
1979,100399,"Rocky Maguire",0,1,1,0
1979,100401,"Sean Sorensen",0,3,3,0
1979,100405,"Fernando Maynetto",0,3,3,0
1979,100406,"Greg Halder",0,1,1,0
1979,100414,"Gunther Gnettner",0,1,1,0
1979,100432,"Robert Bettauer",0,1,1,0
1979,100435,"Regis Brunet",0,1,1,0
1979,100442,"Gianni Marchetti",0,1,1,0
1979,100459,"Tracy Delatte",0,1,1,0
1979,100483,"Christophe Casa",0,3,3,0
1979,100485,"Tsuyoshi Fukui",0,3,3,0
1979,100491,"Alan Chandronnait",0,1,1,0
1979,100495,"Wayne Hampson",0,2,2,0
1979,100497,"Markus Gunthardt",0,1,1,0
1979,100500,"Rohun Beven",0,1,1,0
1979,100501,"Gregoire Rafaitin",0,2,2,0
1979,100503,"Lorenzo Fargas",0,1,1,0
1979,100505,"Famiano Meneschincheri",0,1,1,0
1979,100507,"Curt Stalder",0,1,1,0
1979,100512,"Robert Reininger",0,5,5,0
1979,100517,"Matt Doyle",0,1,1,0
1979,100524,"Shozo Shiraishi",0,1,1,0
1979,100538,"Alejandro Gattiker",0,2,2,0
1979,100541,"Jan Kallquist",0,2,2,0
1979,100564,"Cary Stansbury",0,5,5,0
1979,100612,"Alvaro Margets",0,1,1,0
1979,100615,"Gianluca Rinaldini",0,1,1,0
1979,100622,"Patrizio Parrini",0,1,1,0
1979,100630,"Gustavo Guerrero",0,1,1,0
1979,100639,"Blaine Willenborg",0,1,1,0
1979,100645,"Huub Van Boeckel",0,1,1,0
1979,100646,"Claudio Panatta",0,1,1,0
1979,100672,"Derek Segal",0,1,1,0
1979,100674,"Jeff Turpin",0,1,1,0
1979,100689,"Tim Mayotte",0,4,4,0
1979,100699,"Chris Johnstone",0,2,2,0
1979,100701,"Marko Ostoja",0,1,1,0
1979,100744,"Peter Doohan",0,1,1,0
1979,100781,"Bernhard Pils",0,1,1,0
1979,100796,"Ahmed El Mehelmy",0,1,1,0
1979,100797,"Ben Testerman",0,1,1,0
1979,100800,"Diego Perez",0,1,1,0
1979,100803,"Stefan Svensson",0,4,4,0
1979,100827,"Jean Luc Cotard",0,1,1,0
1979,100836,"Glenn Michibata",0,1,1,0
1979,100855,"Scott Davis",0,1,1,0
1979,100864,"Martin Wostenholme",0,1,1,0
1979,100922,"Roberto Arguello",0,1,1,0
1979,100942,"Thierry Tulasne",0,1,1,0
1979,101906,"Yasufumi Yamamoto",0,1,1,0
1979,102740,"Francisco Rodriguez",0,1,1,0
1979,106453,"Akinori Naguro",0,1,1,0
1979,106454,"Akira Kawaguchi",0,1,1,0
1979,106455,"Akira Motomura",0,1,1,0
1979,106500,"Alfonso Gonzalez",0,1,1,0
1979,106505,"Ali Madani",0,1,1,0
1979,106542,"Andrew Rae",0,1,1,0
1979,106551,"Andy Mccurry",0,1,1,0
1979,106561,"Anthony Fawcett",0,1,1,0
1979,106567,"Antonio Domenech",0,1,1,0
1979,106603,"B Hochstadter",0,1,1,0
1979,106615,"Bernard Balleret",0,1,1,0
1979,106629,"Birger Andersson",0,6,6,0
1979,106671,"Bruno Capineri",0,1,1,0
1979,106676,"Bullus Hussaini",0,1,1,0
1979,106684,"Carl Axel Hageskog",0,1,1,0
1979,106690,"Carlos Behar",0,2,2,0
1979,106700,"Carlos Gomez",0,1,1,0
1979,106706,"Cary Leeds",0,1,1,0
1979,106716,"Chang Hong Ni",0,1,1,0
1979,106848,"David Whyte",0,2,2,0
1979,106878,"Didier Frantz",0,1,1,0
1979,106899,"Douglas Palm",0,1,1,0
1979,106929,"Eiji Takeuchi",0,1,1,0
1979,106950,"Enzo Vattuone",0,1,1,0
1979,106962,"Ernesto Vazquez",0,1,1,0
1979,106966,"Etsuo Uchiyama",0,1,1,0
1979,106970,"Eylon Sinai",0,1,1,0
1979,106983,"Fabrizio Fanucci",0,1,1,0
1979,107063,"Gaston Escofet",0,1,1,0
1979,107078,"George Rudman",0,1,1,0
1979,107091,"Gewan Maharaj",0,1,1,0
1979,107115,"Goran Bergstrand",0,2,2,0
1979,107130,"Graziano Risi",0,1,1,0
1979,107132,"Greg Braun",0,2,2,0
1979,107158,"H Hsu",0,1,1,0
1979,107171,"Hany Nasser",0,1,1,0
1979,107180,"Harvey Spiegel",0,1,1,0
1979,107204,"Hiroyuki Bamba",0,1,1,0
1979,107216,"Ian Bersin",0,1,1,0
1979,107230,"Ilan Sher",0,1,1,0
1979,107328,"Jeremy Cohen",0,2,2,0
1979,107390,"John Molin",0,1,1,0
1979,107413,"Jorge Cano",0,1,1,0
1979,107429,"Jose Castanon",0,1,1,0
1979,107459,"Juan Manuel Hidalgo",0,1,1,0
1979,107463,"Juan Torralbo",0,1,1,0
1979,107518,"Kiyoski Tanabe",0,1,1,0
1979,107590,"Luis Borfiga",0,1,1,0
1979,107649,"Marco Alciati",0,2,2,0
1979,107654,"Marco Consolini",0,1,1,0
1979,107657,"Marco Gudino",0,1,1,0
1979,107719,"Martin Lorenzoni",0,1,1,0
1979,107840,"Nandan Bal",0,1,1,0
1979,107852,"Nick Badenhorst",0,1,1,0
1979,107903,"Osuma Nakamura",0,1,1,0
1979,107970,"Per Larsson",0,1,1,0
1979,107981,"Peter Hampton",0,1,1,0
1979,107997,"Phil Davies",0,3,3,0
1979,108025,"R Elangovan",0,1,1,0
1979,108133,"Roberto Lombardi",0,1,1,0
1979,108135,"Roberto Meneschincheri",0,3,3,0
1979,108192,"Sachio Kato",0,1,1,0
1979,108214,"Scott Clark",0,1,1,0
1979,108231,"Segun Balogun",0,1,1,0
1979,108248,"Shai Puni",0,1,1,0
1979,108250,"Shanker Krishnan",0,1,1,0
1979,108253,"Shinichi Sakamoto",0,1,1,0
1979,108257,"Shoichi Tatsuno",0,1,1,0
1979,108304,"Stephen Myers",0,1,1,0
1979,108321,"Steven Alger",0,1,1,0
1979,108322,"Steven Harley",0,1,1,0
1979,108331,"Suehiro Ito",0,1,1,0
1979,108345,"Taisen Kanai",0,1,1,0
1979,108349,"Takehiko Nishiwaki",0,1,1,0
1979,108356,"Tarek El Sakka",0,1,1,0
1979,108370,"Theo Gorter",0,1,1,0
1979,108377,"Thierry Stevaux",0,3,3,0
1979,108398,"Tim Clements",0,1,1,0
1979,108401,"Tim Vann",0,1,1,0
1979,108410,"Tom Frisher",0,1,1,0
1979,108416,"Tom Lee",0,1,1,0
1979,108441,"Torquato Rossini",0,1,1,0
1979,108460,"Valerio Baiardo",0,1,1,0
1979,108481,"Vittorio Magnelli",0,2,2,0
1979,108498,"Warren Girle",0,1,1,0
1979,108505,"Wayne Pascoe",0,1,1,0
1979,108522,"William Mcgehee",0,1,1,0
1979,108577,"Zhao Xie",0,1,1,0
1979,108579,"Zlatko Ivancic",0,1,1,0
1979,108580,"Zoltan Ilin",0,1,1,0
1979,109845,"C Munoz",0,1,1,0
1979,109871,"Harry Fritz",0,2,2,0
1979,109874,"Paul Dogherty",0,1,1,0
1979,110455,"Brad Hibbert",0,1,1,0
1979,121397,"Pedro Gonzalez",0,1,1,0
1979,200499,"Dean Martin",0,1,1,0
1979,202519,"Mark Turpin",0,1,1,0
1979,202680,"David Whyte",0,1,1,0
1979,202721,"Roland Stiegler",0,1,1,0
1980,100013,"Neale Fraser",0,1,1,0
1980,100025,"Barry Phillips Moore",0,1,1,0
1980,100040,"Bob Hewitt",0,1,1,0
1980,100045,"John Paish",0,1,1,0
1980,100058,"Roger Taylor",0,3,3,0
1980,100062,"Francois Jauffret",0,1,1,0
1980,100067,"Frew Mcmillan",0,4,4,0
1980,100083,"Nicola Spear",0,2,2,0
1980,100087,"John Newcombe",0,2,2,0
1980,100097,"Nicholas Kalogeropoulos",0,1,1,0
1980,100109,"Jun Kuki",0,1,1,0
1980,100118,"Ivan Molina",0,4,4,0
1980,100130,"Vladimir Zednik",0,1,1,0
1980,100161,"Jurgen Fassbender",0,2,2,0
1980,100169,"Ian Fletcher",0,1,1,0
1980,100172,"Modesto Tito Vazquez",0,1,1,0
1980,100179,"Karl Meiler",0,4,4,0
1980,100223,"Jeff Simpson",0,1,1,0
1980,100246,"Frank Puncec",0,2,2,0
1980,100247,"Rolf Thung",0,1,1,0
1980,100258,"Jorge Andrew",0,3,3,0
1980,100275,"Hartmut Kirchhubel",0,3,3,0
1980,100283,"Andre Zietsmann",0,1,1,0
1980,100296,"Chris Gunning",0,2,2,0
1980,100305,"Mark Farrell",0,1,1,0
1980,100307,"Paul Torre",0,1,1,0
1980,100310,"Mike Myburg",0,1,1,0
1980,100318,"Roger Guedes",0,1,1,0
1980,100323,"Givaldo Barbosa",0,1,1,0
1980,100330,"David Imonitie",0,1,1,0
1980,100335,"David Parker",0,1,1,0
1980,100349,"Glen Holroyd",0,1,1,0
1980,100351,"Freddie De Jesus",0,1,1,0
1980,100369,"Herve Gauvain",0,2,2,0
1980,100371,"Robert Baumgartner",0,1,1,0
1980,100378,"David Schneider",0,10,10,0
1980,100379,"Craig Edwards",0,1,1,0
1980,100386,"Jose Garcia",0,1,1,0
1980,100387,"Jiri Prucha",0,3,3,0
1980,100391,"Larry Davidson",0,2,2,0
1980,100396,"Martin Robinson",0,1,1,0
1980,100418,"Geoff Martinez",0,1,1,0
1980,100425,"Junie Chatman",0,2,2,0
1980,100426,"Hans Peter Kandler",0,1,1,0
1980,100439,"Mike Barr",0,2,2,0
1980,100445,"Steve Denton",0,3,3,0
1980,100458,"Pedro Gonzalez",0,1,1,0
1980,100463,"Ben Mckown",0,2,2,0
1980,100466,"Maurice Hunter",0,1,1,0
1980,100467,"Mark Turpin",0,3,3,0
1980,100471,"Mark Vines",0,1,1,0
1980,100472,"Craig Wittus",0,1,1,0
1980,100473,"Glenn Petrovic",0,7,7,0
1980,100489,"Larry Stefanki",0,4,4,0
1980,100496,"Charles Buzz Strode",0,1,1,0
1980,100503,"Lorenzo Fargas",0,1,1,0
1980,100504,"Jerome Vanier",0,1,1,0
1980,100508,"Peter Spang",0,1,1,0
1980,100512,"Robert Reininger",0,8,8,0
1980,100520,"Juan Farrow",0,1,1,0
1980,100522,"Chris Dunk",0,1,1,0
1980,100527,"Chris Bradnam",0,1,1,0
1980,100538,"Alejandro Gattiker",0,2,2,0
1980,100541,"Jan Kallquist",0,2,2,0
1980,100547,"Rocky Royer",0,1,1,0
1980,100550,"Brad Guan",0,2,2,0
1980,100553,"Nduka Odizor",0,1,1,0
1980,100559,"Mike Gandolfo",0,1,1,0
1980,100573,"Ron Hightower",0,1,1,0
1980,100583,"Jeff Robbins",0,1,1,0
1980,100587,"Steve Guy",0,1,1,0
1980,100607,"Eduardo Bengoechea",0,3,3,0
1980,100609,"Zoltan Kuharszky",0,1,1,0
1980,100614,"Massimo Grassotti",0,1,1,0
1980,100615,"Gianluca Rinaldini",0,1,1,0
1980,100618,"Leif Shiras",0,3,3,0
1980,100622,"Patrizio Parrini",0,2,2,0
1980,100636,"Gustavo Tiberti",0,2,2,0
1980,100638,"David Mustard",0,2,2,0
1980,100649,"David Dowlen",0,1,1,0
1980,100651,"Alejandro Ganzabal",0,1,1,0
1980,100652,"Cassio Motta",0,7,7,0
1980,100657,"Mike Leach",0,1,1,0
1980,100669,"Charles Bud Cox",0,1,1,0
1980,100673,"Robbie Venter",0,1,1,0
1980,100675,"John Mccurdy",0,1,1,0
1980,100680,"Peter Johnston",0,1,1,0
1980,100710,"Phil Lehnhoff",0,1,1,0
1980,100719,"Juan Avendano",0,1,1,0
1980,100727,"Raul Antonio Viver",0,3,3,0
1980,100738,"Schalk Van Der Merwe",0,3,3,0
1980,100749,"Dave Siegler",0,3,3,0
1980,100762,"Freddie Sauer",0,1,1,0
1980,100776,"Tomm Warneke",0,1,1,0
1980,100789,"Ivan Dupasquier",0,5,5,0
1980,100790,"Bruce Derlin",0,1,1,0
1980,100793,"Stephane Bonneau",0,1,1,0
1980,100796,"Ahmed El Mehelmy",0,1,1,0
1980,100799,"Carlos Castellan",0,1,1,0
1980,100800,"Diego Perez",0,1,1,0
1980,100810,"Paul Chamberlin",0,1,1,0
1980,100835,"Hans Dieter Beutel",0,3,3,0
1980,100836,"Glenn Michibata",0,2,2,0
1980,100837,"Jeremy Bates",0,1,1,0
1980,100838,"Steve Wood",0,1,1,0
1980,100840,"Mark Wooldridge",0,2,2,0
1980,100855,"Scott Davis",0,4,4,0
1980,100859,"Robert Casey C100",0,1,1,0
1980,100864,"Martin Wostenholme",0,1,1,0
1980,100884,"Steve Shaw",0,1,1,0
1980,100893,"Joakim Nystrom",0,1,1,0
1980,100903,"Mike Lee",0,1,1,0
1980,100910,"Magnus Tideman",0,1,1,0
1980,100921,"Patrice Kuchna",0,1,1,0
1980,100936,"Henri Leconte",0,4,4,0
1980,101001,"Tim Siegel",0,1,1,0
1980,101046,"Eric Wilborts",0,1,1,0
1980,106458,"Alain Brichant",0,1,1,0
1980,106537,"Andres Molina",0,1,1,0
1980,106551,"Andy Mccurry",0,1,1,0
1980,106610,"Beejong Sisson",0,1,1,0
1980,106642,"Bojidar Pampoulov",0,1,1,0
1980,106648,"Brad Holland",0,1,1,0
1980,106661,"Brett Hibbert",0,1,1,0
1980,106665,"Brian Millar",0,2,2,0
1980,106671,"Bruno Capineri",0,1,1,0
1980,106690,"Carlos Behar",0,1,1,0
1980,106700,"Carlos Gomez",0,1,1,0
1980,106706,"Cary Leeds",0,2,2,0
1980,106710,"Celso Sacomandi",0,1,1,0
1980,106715,"Chaim Arlozorov",0,2,2,0
1980,106758,"Christophe Lesage",0,1,1,0
1980,106768,"Claude England",0,1,1,0
1980,106780,"Cliff Skakle",0,1,1,0
1980,106856,"Davn Santiago",0,1,1,0
1980,106896,"Doug Ditmer",0,1,1,0
1980,106950,"Enzo Vattuone",0,1,1,0
1980,106966,"Etsuo Uchiyama",0,1,1,0
1980,106969,"Evgeni Zhelyazkov",0,1,1,0
1980,106970,"Eylon Sinai",0,1,1,0
1980,106983,"Fabrizio Fanucci",0,2,2,0
1980,107000,"Fernando Dalla Fontana",0,2,2,0
1980,107082,"Gerard Wimmer",0,1,1,0
1980,107091,"Gewan Maharaj",0,1,1,0
1980,107133,"Greg Ewansky",0,1,1,0
1980,107168,"Hans Hansson",0,1,1,0
1980,107179,"Harvey Becker",0,1,1,0
1980,107205,"Hisham Nasser",0,1,1,0
1980,107261,"Jacques Bonnemaison",0,1,1,0
1980,107298,"Javier Restrepo",0,1,1,0
1980,107301,"Jay Harvey",0,1,1,0
1980,107313,"Jean Pierre Richer",0,1,1,0
1980,107315,"Jean Van Rensburg",0,1,1,0
1980,107355,"Joe Globisch",0,1,1,0
1980,107379,"John Chris Lewis",0,2,2,0
1980,107398,"John Trickey",0,2,2,0
1980,107400,"John Whiteford",0,1,1,0
1980,107453,"Juan Couder",0,1,1,0
1980,107486,"Keith Begley",0,1,1,0
1980,107487,"Keith Gilbert",0,1,1,0
1980,107495,"Ken Barton",0,1,1,0
1980,107518,"Kiyoski Tanabe",0,1,1,0
1980,107549,"Lars Samuelson",0,1,1,0
1980,107577,"Lorenzo Soriano",0,1,1,0
1980,107614,"M Harner",0,1,1,0
1980,107621,"Manuel Diaz",0,2,2,0
1980,107630,"Marc Albert",0,2,2,0
1980,107719,"Martin Lorenzoni",0,1,1,0
1980,107840,"Nandan Bal",0,1,1,0
1980,107864,"Nobuya Tamura",0,1,1,0
1980,107866,"Noel Freitas",0,1,1,0
1980,107867,"Noel Jensen",0,1,1,0
1980,107953,"Paul Smith",0,1,1,0
1980,107954,"Paul Van Min",0,2,2,0
1980,107970,"Per Larsson",0,1,1,0
1980,107978,"Peter Dellavedova",0,2,2,0
1980,107985,"Peter Langsford",0,1,1,0
1980,108079,"Rich Andrews",0,1,1,0
1980,108110,"Robert Hubbard",0,2,2,0
1980,108130,"Roberto Carruthers",0,1,1,0
1980,108133,"Roberto Lombardi",0,1,1,0
1980,108154,"Roger Mckee",0,1,1,0
1980,108231,"Segun Balogun",0,1,1,0
1980,108248,"Shai Puni",0,1,1,0
1980,108253,"Shinichi Sakamoto",0,1,1,0
1980,108268,"Sivagnanam Suresh",0,1,1,0
1980,108317,"Steve Rogul",0,2,2,0
1980,108356,"Tarek El Sakka",0,1,1,0
1980,108368,"Tetsu Kuramitsu",0,1,1,0
1980,108370,"Theo Gorter",0,1,1,0
1980,108372,"Thibault Kuentz",0,1,1,0
1980,108377,"Thierry Stevaux",0,3,3,0
1980,108387,"Thomas Furst",0,1,1,0
1980,108405,"Toby Crabel",0,1,1,0
1980,108434,"Tony Parun P071",0,1,1,0
1980,108481,"Vittorio Magnelli",0,1,1,0
1980,108494,"Walter Redondo",0,1,1,0
1980,108579,"Zlatko Ivancic",0,1,1,0
1980,108580,"Zoltan Ilin",0,3,3,0
1980,109845,"C Munoz",0,1,1,0
1980,109864,"P Rickey",0,1,1,0
1980,109865,"J Gordon",0,1,1,0
1980,109866,"A Difrancesco",0,1,1,0
1980,109867,"D Turner",0,1,1,0
1980,109868,"A Luttrell",0,1,1,0
1980,109869,"Ross Olivieri",0,1,1,0
1980,109871,"Harry Fritz",0,2,2,0
1980,109872,"T Hall",0,1,1,0
1980,109873,"John Blizzard",0,1,1,0
1980,109874,"Paul Dogherty",0,1,1,0
1980,110167,"C Mora",0,1,1,0
1980,110168,"Mario Delgado",0,1,1,0
1980,110169,"A Moscoso",0,1,1,0
1980,110170,"M Fallas",0,1,1,0
1980,110171,"Jim Hodges",0,1,1,0
1980,110244,"Liu Shuhua",0,1,1,0
1980,110245,"X Menn",0,1,1,0
1980,110355,"Ernesto Ruiz Bry",0,1,1,0
1980,110356,"F Settelmeyer",0,1,1,0
1980,110381,"Ibrahim Mahmoud",0,1,1,0
1980,110382,"G Halabi",0,1,1,0
1980,110383,"C Floe",0,1,1,0
1980,110384,"Kehinde Ajayi",0,1,1,0
1980,110385,"O Issara",0,1,1,0
1980,110386,"T Tang",0,1,1,0
1980,110387,"Martin Goldberg",0,1,1,0
1980,110987,"Saeed Meer",0,1,1,0
1980,199999,"U Unknown",0,8,8,0
1980,202680,"David Whyte",0,1,1,0
1980,208997,"A Simcox",0,1,1,0
1980,209846,"Francois Synnaeghal",0,1,1,0
1981,100067,"Frew Mcmillan",0,1,1,0
1981,100073,"Mark Cox",0,5,5,0
1981,100087,"John Newcombe",0,1,1,0
1981,100094,"Jim Osborne",0,1,1,0
1981,100099,"Thomaz Koch",0,2,2,0
1981,100117,"Butch Seewagen",0,1,1,0
1981,100150,"Lito Alvarez",0,1,1,0
1981,100160,"Georges Goven",0,4,4,0
1981,100169,"Ian Fletcher",0,1,1,0
1981,100171,"John Yuill",0,3,3,0
1981,100175,"Zan Guerry",0,1,1,0
1981,100195,"Nicolas Kelaidis",0,1,1,0
1981,100206,"Kenichi Hirai",0,1,1,0
1981,100219,"Geoff Masters",0,1,1,0
1981,100224,"Peter Campbell",0,1,1,0
1981,100227,"Alvin Gardiner",0,2,2,0
1981,100235,"Antonio Munoz",0,1,1,0
1981,100238,"Rick Fisher",0,2,2,0
1981,100246,"Frank Puncec",0,3,3,0
1981,100258,"Jorge Andrew",0,2,2,0
1981,100268,"Denis Naegelen",0,2,2,0
1981,100275,"Hartmut Kirchhubel",0,4,4,0
1981,100288,"Tenny Svensson",0,1,1,0
1981,100310,"Mike Myburg",0,1,1,0
1981,100318,"Roger Guedes",0,1,1,0
1981,100322,"Emilio Montano",0,2,2,0
1981,100331,"Jean Louis Haillet",0,8,8,0
1981,100334,"Ernie Ewert",0,1,1,0
1981,100347,"Peter Kronk",0,1,1,0
1981,100348,"Gerard Toulon",0,1,1,0
1981,100374,"Javier Soler",0,1,1,0
1981,100385,"Filip Krajcik",0,1,1,0
1981,100398,"Julio Goes",0,1,1,0
1981,100401,"Sean Sorensen",0,2,2,0
1981,100405,"Fernando Maynetto",0,9,9,0
1981,100412,"Bruce Nichols",0,2,2,0
1981,100413,"Ulrich Marten",0,7,7,0
1981,100414,"Gunther Gnettner",0,1,1,0
1981,100415,"Michael Grant",0,3,3,0
1981,100419,"Todd Lundy",0,3,3,0
1981,100429,"Miguel Mir",0,3,3,0
1981,100438,"Carlos Gattiker",0,3,3,0
1981,100448,"Bruce Foxworth",0,1,1,0
1981,100454,"Mehl Ampon",0,1,1,0
1981,100459,"Tracy Delatte",0,3,3,0
1981,100466,"Maurice Hunter",0,2,2,0
1981,100473,"Glenn Petrovic",0,1,1,0
1981,100476,"Nigel Sears",0,1,1,0
1981,100480,"Josef Brabenec",0,1,1,0
1981,100493,"Eric Sherbeck",0,1,1,0
1981,100497,"Markus Gunthardt",0,3,3,0
1981,100503,"Lorenzo Fargas",0,1,1,0
1981,100505,"Famiano Meneschincheri",0,1,1,0
1981,100506,"Howard Schoenfield",0,2,2,0
1981,100507,"Curt Stalder",0,1,1,0
1981,100508,"Peter Spang",0,2,2,0
1981,100513,"Hugo Roverano",0,1,1,0
1981,100516,"Andrew Jarrett",0,2,2,0
1981,100520,"Juan Farrow",0,3,3,0
1981,100524,"Shozo Shiraishi",0,2,2,0
1981,100539,"Rick Meyers",0,1,1,0
1981,100557,"Jai Dilouie",0,3,3,0
1981,100564,"Cary Stansbury",0,3,3,0
1981,100569,"Toru Yonezawa",0,1,1,0
1981,100572,"Ney Keller",0,1,1,0
1981,100575,"Andy Andrews",0,1,1,0
1981,100578,"Brent Pirow",0,2,2,0
1981,100584,"Peter Lamb",0,1,1,0
1981,100593,"Miloslav Lacek",0,1,1,0
1981,100594,"Kevin Kerns",0,1,1,0
1981,100596,"Bill Cowan",0,2,2,0
1981,100604,"Egan Adams",0,1,1,0
1981,100609,"Zoltan Kuharszky",0,1,1,0
1981,100616,"Andy Kohlberg",0,3,3,0
1981,100622,"Patrizio Parrini",0,2,2,0
1981,100624,"Derek Tarr",0,1,1,0
1981,100638,"David Mustard",0,4,4,0
1981,100641,"Jan Van Langendonck",0,1,1,0
1981,100659,"Helmar Stiegler",0,2,2,0
1981,100672,"Derek Segal",0,1,1,0
1981,100678,"Bill Gilmour",0,1,1,0
1981,100680,"Peter Johnston",0,3,3,0
1981,100704,"Billy Nealon",0,1,1,0
1981,100719,"Juan Avendano",0,2,2,0
1981,100722,"Michael Fancutt",0,1,1,0
1981,100727,"Raul Antonio Viver",0,2,2,0
1981,100729,"Fernando Soler",0,1,1,0
1981,100744,"Peter Doohan",0,2,2,0
1981,100753,"Juan Carlos Ayala",0,3,3,0
1981,100761,"Danny Saltz",0,1,1,0
1981,100768,"Nick Brown",0,1,1,0
1981,100779,"Kevin Moir",0,1,1,0
1981,100780,"Mike De Palmer",0,2,2,0
1981,100790,"Bruce Derlin",0,3,3,0
1981,100793,"Stephane Bonneau",0,1,1,0
1981,100796,"Ahmed El Mehelmy",0,1,1,0
1981,100803,"Stefan Svensson",0,2,2,0
1981,100804,"Henri De Wet",0,1,1,0
1981,100815,"David Pate",0,1,1,0
1981,100836,"Glenn Michibata",0,1,1,0
1981,100866,"Shahar Perkiss",0,1,1,0
1981,100883,"Christophe Bernelle",0,1,1,0
1981,100899,"Jorgen Windahl",0,2,2,0
1981,100907,"Luca Bottazzi",0,1,1,0
1981,100924,"Jorge Lozano",0,3,3,0
1981,100934,"Matt Anger",0,3,3,0
1981,100946,"Slobodan Zivojinovic",0,1,1,0
1981,100972,"Todd Witsken",0,1,1,0
1981,101000,"Carl Limberger",0,1,1,0
1981,101013,"Henrik Sundstrom",0,5,5,0
1981,101020,"Hans Schwaier",0,2,2,0
1981,101195,"Amos Mansdorf",0,1,1,0
1981,101832,"Jose Ayala",0,1,1,0
1981,101906,"Yasufumi Yamamoto",0,1,1,0
1981,103993,"Chris Lewis",0,1,1,0
1981,106453,"Akinori Naguro",0,1,1,0
1981,106458,"Alain Brichant",0,1,1,0
1981,106510,"Aly El Dawoudi",0,2,2,0
1981,106561,"Anthony Fawcett",0,1,1,0
1981,106627,"Bill Shivar",0,1,1,0
1981,106702,"Carlos Lando",0,1,1,0
1981,106706,"Cary Leeds",0,1,1,0
1981,106715,"Chaim Arlozorov",0,2,2,0
1981,106950,"Enzo Vattuone",0,1,1,0
1981,106966,"Etsuo Uchiyama",0,1,1,0
1981,107082,"Gerard Wimmer",0,1,1,0
1981,107109,"Glenn Busby",0,1,1,0
1981,107205,"Hisham Nasser",0,1,1,0
1981,107233,"Ingo Wimmer",0,2,2,0
1981,107238,"Ivan Camus",0,1,1,0
1981,107297,"Javier Ordaz",0,1,1,0
1981,107326,"Jeff Twist",0,1,1,0
1981,107434,"Jose Fernandez",0,1,1,0
1981,107468,"Julian Stamatov",0,1,1,0
1981,107511,"Khaled Baligh",0,1,1,0
1981,107518,"Kiyoski Tanabe",0,1,1,0
1981,107630,"Marc Albert",0,2,2,0
1981,107651,"Marco Bellini",0,1,1,0
1981,107672,"Mario Calautti",0,1,1,0
1981,107841,"Naomi Uemura",0,1,1,0
1981,107850,"Nial Brash",0,1,1,0
1981,107862,"Nigel Orourke",0,1,1,0
1981,107864,"Nobuya Tamura",0,1,1,0
1981,107892,"Olle Palmer",0,1,1,0
1981,107895,"Orlando Agudelo",0,1,1,0
1981,107918,"Panomkorn Pladchunil",0,1,1,0
1981,107928,"Pat Serret",0,1,1,0
1981,108172,"Romeo Rafon",0,1,1,0
1981,108190,"S Eummongkol",0,1,1,0
1981,108192,"Sachio Kato",0,1,1,0
1981,108252,"Shinichi Nishino",0,1,1,0
1981,108346,"Takanobu Fujii",0,1,1,0
1981,108349,"Takehiko Nishiwaki",0,1,1,0
1981,108361,"Teodor Batchev",0,1,1,0
1981,108368,"Tetsu Kuramitsu",0,1,1,0
1981,108481,"Vittorio Magnelli",0,1,1,0
1981,108518,"William Blaze",0,1,1,0
1981,109839,"Ricky Diaz",0,1,1,0
1981,109882,"U Naharaj",0,1,1,0
1981,109925,"Yoshito Nakamura",0,1,1,0
1981,109955,"Antonio Capella",0,1,1,0
1981,110010,"Manuel Valleramos",0,1,1,0
1981,110011,"Peter Macdonald",0,1,1,0
1981,110012,"Assen Dishkov",0,1,1,0
1981,110141,"Chang Rung Wu",0,1,1,0
1981,110228,"Toshio Iwazawa",0,1,1,0
1981,110229,"Haruhiko Matsunaga",0,1,1,0
1981,110230,"Yoshiya Hamano",0,1,1,0
1981,110232,"Yukihiko Murata",0,1,1,0
1981,110234,"Noriyuki Washida",0,1,1,0
1981,110235,"Weller Evans",0,1,1,0
1981,110236,"Toyokazu Tomogane",0,1,1,0
1981,110237,"Kiyoshi Miyanami",0,1,1,0
1982,100010,"Luis Ayala",0,1,1,0
1982,100030,"Fred Stolle",0,1,1,0
1982,100094,"Jim Osborne",0,1,1,0
1982,100113,"Jan Kodes",0,5,5,0
1982,100135,"Onny Parun",0,1,1,0
1982,100176,"Hans Kary",0,6,6,0
1982,100211,"Louk Sanders",0,1,1,0
1982,100231,"Erik Van Dillen",0,2,2,0
1982,100241,"Joel Bailey",0,1,1,0
1982,100258,"Jorge Andrew",0,1,1,0
1982,100266,"John Feaver",0,3,3,0
1982,100268,"Denis Naegelen",0,1,1,0
1982,100274,"Eric Deblicker",0,1,1,0
1982,100275,"Hartmut Kirchhubel",0,1,1,0
1982,100292,"Alvaro Fillol",0,1,1,0
1982,100294,"Rejean Genois",0,1,1,0
1982,100319,"Rick Fagel",0,9,9,0
1982,100333,"Shigeyuki Nishio",0,2,2,0
1982,100341,"Gonzalo Nunez",0,1,1,0
1982,100358,"Mike Fishbach",0,1,1,0
1982,100370,"Helmut Beermann",0,1,1,0
1982,100379,"Craig Edwards",0,3,3,0
1982,100401,"Sean Sorensen",0,2,2,0
1982,100405,"Fernando Maynetto",0,2,2,0
1982,100412,"Bruce Nichols",0,2,2,0
1982,100416,"Bill Maze",0,1,1,0
1982,100427,"Ferrante Rocchi",0,1,1,0
1982,100431,"Mansour Bahrami",0,2,2,0
1982,100439,"Mike Barr",0,1,1,0
1982,100441,"Mark Darby",0,1,1,0
1982,100443,"Christophe Freyss",0,3,3,0
1982,100448,"Bruce Foxworth",0,1,1,0
1982,100451,"Tony Graham",0,6,6,0
1982,100459,"Tracy Delatte",0,3,3,0
1982,100466,"Maurice Hunter",0,2,2,0
1982,100481,"Roberto Vizcaino",0,2,2,0
1982,100490,"Jaroslav Navratil",0,3,3,0
1982,100492,"John Austin",0,5,5,0
1982,100494,"John Picken",0,1,1,0
1982,100503,"Lorenzo Fargas",0,1,1,0
1982,100504,"Jerome Vanier",0,2,2,0
1982,100505,"Famiano Meneschincheri",0,1,1,0
1982,100516,"Andrew Jarrett",0,3,3,0
1982,100520,"Juan Farrow",0,2,2,0
1982,100528,"Randy Druz",0,1,1,0
1982,100541,"Jan Kallquist",0,1,1,0
1982,100545,"Deon Joubert",0,1,1,0
1982,100548,"Ivan Kley",0,1,1,0
1982,100554,"Matthew McDonald",0,1,1,0
1982,100557,"Jai Dilouie",0,3,3,0
1982,100563,"Joel Hoffman",0,1,1,0
1982,100566,"Hitoshi Shirato",0,1,1,0
1982,100568,"John Mattke",0,1,1,0
1982,100571,"Mark Freedman",0,1,1,0
1982,100572,"Ney Keller",0,2,2,0
1982,100578,"Brent Pirow",0,5,5,0
1982,100593,"Miloslav Lacek",0,2,2,0
1982,100596,"Bill Cowan",0,2,2,0
1982,100607,"Eduardo Bengoechea",0,3,3,0
1982,100618,"Leif Shiras",0,1,1,0
1982,100620,"Eduardo Osta",0,5,5,0
1982,100622,"Patrizio Parrini",0,1,1,0
1982,100625,"Scott Lipton",0,3,3,0
1982,100642,"Juan Carlos Yunis",0,1,1,0
1982,100663,"Marcel Freeman",0,4,4,0
1982,100671,"Guillermo Stevens",0,1,1,0
1982,100673,"Robbie Venter",0,1,1,0
1982,100702,"Sean Brawley",0,1,1,0
1982,100703,"Randy Nixon",0,1,1,0
1982,100707,"Mark Witsken",0,1,1,0
1982,100722,"Michael Fancutt",0,1,1,0
1982,100727,"Raul Antonio Viver",0,1,1,0
1982,100732,"Ricardo Rivera",0,1,1,0
1982,100736,"Hugo Nunez",0,1,1,0
1982,100753,"Juan Carlos Ayala",0,1,1,0
1982,100768,"Nick Brown",0,1,1,0
1982,100775,"Tian C Viljoen",0,1,1,0
1982,100796,"Ahmed El Mehelmy",0,1,1,0
1982,100803,"Stefan Svensson",0,1,1,0
1982,100812,"Gerald Mild",0,1,1,0
1982,100826,"Juan Antonio Rodriguez",0,1,1,0
1982,100828,"John Davis",0,1,1,0
1982,100837,"Jeremy Bates",0,2,2,0
1982,100849,"David Graham",0,1,1,0
1982,100871,"Laurie Warder",0,1,1,0
1982,100883,"Christophe Bernelle",0,3,3,0
1982,100899,"Jorgen Windahl",0,1,1,0
1982,100901,"Paul Annacone",0,1,1,0
1982,100907,"Luca Bottazzi",0,2,2,0
1982,100913,"Peter Carlsson",0,1,1,0
1982,100921,"Patrice Kuchna",0,2,2,0
1982,100922,"Roberto Arguello",0,1,1,0
1982,100926,"Ken Flach",0,1,1,0
1982,100932,"Denys Maasdorp",0,1,1,0
1982,100935,"Michael Robertson",0,1,1,0
1982,100946,"Slobodan Zivojinovic",0,3,3,0
1982,100957,"Greg Holmes",0,1,1,0
1982,100964,"Jon Levine",0,1,1,0
1982,100972,"Todd Witsken",0,1,1,0
1982,100980,"Edvaldo Oliveira",0,1,1,0
1982,101014,"John Ross",0,1,1,0
1982,101018,"Edoardo Mazza",0,1,1,0
1982,101020,"Hans Schwaier",0,2,2,0
1982,101024,"Christian Geyer",0,1,1,0
1982,101033,"John Letts",0,1,1,0
1982,101046,"Eric Wilborts",0,2,2,0
1982,101064,"David Lewis",0,1,1,0
1982,101076,"Cesar Kist",0,2,2,0
1982,101094,"Eduardo Oncins",0,1,1,0
1982,101105,"Jose Antonio Fernandez",0,1,1,0
1982,101109,"Tarik Benhabiles",0,1,1,0
1982,101222,"Stefan Edberg",0,3,3,0
1982,101256,"Mark Kratzmann",0,3,3,0
1982,102724,"Jose Antonio Garcia",0,1,1,0
1982,106466,"Alberto Franco",0,1,1,0
1982,106512,"Amani Jumatano",0,1,1,0
1982,106623,"Bill Csipkay",0,2,2,0
1982,106694,"Carlos Chabalgoity",0,1,1,0
1982,106768,"Claude England",0,1,1,0
1982,106876,"Dick Metz",0,1,1,0
1982,106905,"Dusan Kulhaj",0,1,1,0
1982,106916,"Edoardo Artaldi",0,1,1,0
1982,106930,"Eleuterio Martins",0,1,1,0
1982,106980,"Fabio Moscino",0,1,1,0
1982,107024,"Francisco Ferrer",0,1,1,0
1982,107035,"Frank Hamonet",0,1,1,0
1982,107056,"Garth Haynes",0,1,1,0
1982,107091,"Gewan Maharaj",0,1,1,0
1982,107145,"Guido Possamai",0,1,1,0
1982,107168,"Hans Hansson",0,3,3,0
1982,107233,"Ingo Wimmer",0,1,1,0
1982,107258,"Jack Kruger",0,1,1,0
1982,107271,"Jamie Harty",0,1,1,0
1982,107278,"Jan Sandberg",0,1,1,0
1982,107478,"Kaoru Maruyama",0,1,1,0
1982,107527,"Konstantin Pugayev",0,1,1,0
1982,107529,"Kouichi Sayama",0,1,1,0
1982,107557,"Lawrence Hall",0,1,1,0
1982,107577,"Lorenzo Soriano",0,1,1,0
1982,107651,"Marco Bellini",0,1,1,0
1982,107724,"Masaru Suishu",0,1,1,0
1982,107829,"Morten Ronneberg",0,1,1,0
1982,107850,"Nial Brash",0,2,2,0
1982,107855,"Nick Mohtadi",0,1,1,0
1982,107895,"Orlando Agudelo",0,1,1,0
1982,108063,"Renato Joaquim",0,1,1,0
1982,108190,"S Eummongkol",0,1,1,0
1982,108377,"Thierry Stevaux",0,2,2,0
1982,108455,"Ulf Pettersson",0,1,1,0
1982,108460,"Valerio Baiardo",0,1,1,0
1982,108494,"Walter Redondo",0,1,1,0
1982,108505,"Wayne Pascoe",0,1,1,0
1982,108512,"Wes Horskins",0,1,1,0
1982,109925,"Yoshito Nakamura",0,1,1,0
1982,110141,"Chang Rung Wu",0,1,1,0
1982,111033,"Kiyoshi Tanabe",0,1,1,0
1982,130938,"John Austin",0,2,2,0
1982,203037,"Mark Harner",0,1,1,0
1983,100022,"Roy Emerson",0,1,1,0
1983,100038,"Jaime Pinto Bravo",0,1,1,0
1983,100113,"Jan Kodes",0,1,1,0
1983,100141,"Zeljko Franulovic",0,3,3,0
1983,100173,"Andrew Pattison",0,1,1,0
1983,100189,"Dale Power",0,1,1,0
1983,100197,"Alejandro Pierola",0,2,2,0
1983,100200,"Antonio Zugarelli",0,1,1,0
1983,100203,"Phil Dent",0,5,5,0
1983,100241,"Joel Bailey",0,1,1,0
1983,100243,"Steve Krulevitz",0,2,2,0
1983,100246,"Frank Puncec",0,4,4,0
1983,100266,"John Feaver",0,1,1,0
1983,100279,"Mike Cahill",0,2,2,0
1983,100319,"Rick Fagel",0,1,1,0
1983,100331,"Jean Louis Haillet",0,2,2,0
1983,100333,"Shigeyuki Nishio",0,1,1,0
1983,100359,"Richard Lewis",0,1,1,0
1983,100368,"Haroon Ismail",0,1,1,0
1983,100374,"Javier Soler",0,1,1,0
1983,100384,"Alejandro Cortes",0,1,1,0
1983,100386,"Jose Garcia",0,2,2,0
1983,100401,"Sean Sorensen",0,1,1,0
1983,100416,"Bill Maze",0,1,1,0
1983,100438,"Carlos Gattiker",0,2,2,0
1983,100443,"Christophe Freyss",0,1,1,0
1983,100456,"Ferdi Taygan",0,1,1,0
1983,100460,"Jose Lopez Maeso",0,5,5,0
1983,100471,"Mark Vines",0,2,2,0
1983,100485,"Tsuyoshi Fukui",0,2,2,0
1983,100492,"John Austin",0,1,1,0
1983,100493,"Eric Sherbeck",0,1,1,0
1983,100494,"John Picken",0,1,1,0
1983,100497,"Markus Gunthardt",0,1,1,0
1983,100498,"Klaus Eberhard",0,1,1,0
1983,100501,"Gregoire Rafaitin",0,1,1,0
1983,100512,"Robert Reininger",0,1,1,0
1983,100526,"Ricardo Ycaza",0,2,2,0
1983,100528,"Randy Druz",0,2,2,0
1983,100547,"Rocky Royer",0,5,5,0
1983,100554,"Matthew McDonald",0,1,1,0
1983,100556,"Brian Levine",0,1,1,0
1983,100558,"Rodney Crowley",0,1,1,0
1983,100560,"Jacques Manset",0,1,1,0
1983,100566,"Hitoshi Shirato",0,2,2,0
1983,100569,"Toru Yonezawa",0,2,2,0
1983,100572,"Ney Keller",0,2,2,0
1983,100573,"Ron Hightower",0,2,2,0
1983,100597,"Jay Lapidus",0,7,7,0
1983,100616,"Andy Kohlberg",0,1,1,0
1983,100617,"Bud Schultz",0,2,2,0
1983,100620,"Eduardo Osta",0,2,2,0
1983,100630,"Gustavo Guerrero",0,1,1,0
1983,100645,"Huub Van Boeckel",0,4,4,0
1983,100659,"Helmar Stiegler",0,1,1,0
1983,100672,"Derek Segal",0,1,1,0
1983,100674,"Jeff Turpin",0,2,2,0
1983,100683,"Robert Crames",0,1,1,0
1983,100691,"Ivo Werner",0,1,1,0
1983,100696,"Mark Buckley",0,1,1,0
1983,100700,"Heinz Gildemeister",0,2,2,0
1983,100710,"Phil Lehnhoff",0,2,2,0
1983,100723,"Jacques Hervet",0,1,1,0
1983,100727,"Raul Antonio Viver",0,1,1,0
1983,100751,"Roberto Saad",0,1,1,0
1983,100772,"Kelly Evernden",0,1,1,0
1983,100775,"Tian C Viljoen",0,1,1,0
1983,100789,"Ivan Dupasquier",0,1,1,0
1983,100804,"Henri De Wet",0,1,1,0
1983,100819,"Daniel Montes De Oca",0,1,1,0
1983,100833,"Marc Flur",0,1,1,0
1983,100840,"Mark Wooldridge",0,1,1,0
1983,100842,"Randolf Scheller",0,1,1,0
1983,100864,"Martin Wostenholme",0,1,1,0
1983,100870,"Christo Van Rensburg",0,1,1,0
1983,100871,"Laurie Warder",0,1,1,0
1983,100907,"Luca Bottazzi",0,1,1,0
1983,100913,"Peter Carlsson",0,1,1,0
1983,100914,"Jean Marc Piacentile",0,1,1,0
1983,100924,"Jorge Lozano",0,1,1,0
1983,100956,"Simone Colombo",0,1,1,0
1983,100967,"Dan Goldie",0,1,1,0
1983,100980,"Edvaldo Oliveira",0,2,2,0
1983,101006,"Bruno Dadillon",0,1,1,0
1983,101014,"John Ross",0,2,2,0
1983,101018,"Edoardo Mazza",0,1,1,0
1983,101063,"Jordi Arrese",0,1,1,0
1983,101072,"Brett Greenwood",0,1,1,0
1983,101076,"Cesar Kist",0,1,1,0
1983,101093,"Steve Devries",0,1,1,0
1983,101094,"Eduardo Oncins",0,2,2,0
1983,101112,"Michele Fioroni",0,1,1,0
1983,101115,"Jorge Bardou",0,1,1,0
1983,101125,"Ville Jansson",0,1,1,0
1983,101144,"Anthony Lane",0,1,1,0
1983,101186,"Desmond Tyson",0,1,1,0
1983,101196,"Derrick Rostagno",0,1,1,0
1983,101250,"Jose Daher",0,1,1,0
1983,101312,"Robbie Weiss",0,1,1,0
1983,101340,"Ricky Brown",0,1,1,0
1983,101366,"David Macpherson",0,2,2,0
1983,101394,"Francois Errard",0,1,1,0
1983,101414,"Boris Becker",0,1,1,0
1983,101426,"Kent Carlsson",0,1,1,0
1983,106447,"Adolfo Gonzalez",0,1,1,0
1983,106518,"Anders Henricsson",0,1,1,0
1983,106615,"Bernard Balleret",0,1,1,0
1983,106623,"Bill Csipkay",0,2,2,0
1983,106674,"Bruno Renoult",0,1,1,0
1983,106706,"Cary Leeds",0,1,1,0
1983,106758,"Christophe Lesage",0,1,1,0
1983,106788,"Craig Tregonning",0,1,1,0
1983,106930,"Eleuterio Martins",0,1,1,0
1983,107031,"Francois Servelle",0,1,1,0
1983,107051,"Gabriel Mattos",0,2,2,0
1983,107230,"Ilan Sher",0,1,1,0
1983,107262,"Jacques Grandjean",0,1,1,0
1983,107298,"Javier Restrepo",0,2,2,0
1983,107612,"M Arenzon",0,1,1,0
1983,107626,"Manuel Rodriguez",0,1,1,0
1983,107645,"Marcelo Grassi",0,1,1,0
1983,107660,"Marco Morales",0,1,1,0
1983,107699,"Mark Lewis",0,1,1,0
1983,107829,"Morten Ronneberg",0,2,2,0
1983,107850,"Nial Brash",0,1,1,0
1983,107851,"Nicholas Sido",0,1,1,0
1983,107905,"Otto Oberparleiter",0,1,1,0
1983,107944,"Paul Groth",0,1,1,0
1983,107960,"Pedro Cordeiro",0,1,1,0
1983,108063,"Renato Joaquim",0,1,1,0
1983,108173,"Ron Dutton",0,1,1,0
1983,108245,"Sergio Speciale",0,1,1,0
1983,108253,"Shinichi Sakamoto",0,1,1,0
1983,108266,"Simone Ercoli",0,2,2,0
1983,108341,"Tadeu Luiz",0,1,1,0
1983,108368,"Tetsu Kuramitsu",0,1,1,0
1983,108394,"Tim Anderson",0,1,1,0
1983,110141,"Chang Rung Wu",0,1,1,0
1983,130938,"John Austin",0,4,4,0
1984,100116,"Sherwood Stewart",0,1,1,0
1984,100126,"Stan Smith",0,1,1,0
1984,100146,"Jun Kamiwazumi",0,1,1,0
1984,100160,"Georges Goven",0,2,2,0
1984,100174,"Manuel Orantes",0,5,5,0
1984,100186,"Jeff Borowiak",0,4,4,0
1984,100221,"Carlos Kirmayr",0,2,2,0
1984,100229,"Dick Stockton",0,3,3,0
1984,100241,"Joel Bailey",0,1,1,0
1984,100266,"John Feaver",0,1,1,0
1984,100281,"Sashi Menon",0,1,1,0
1984,100292,"Alvaro Fillol",0,8,8,0
1984,100302,"Joaquim Rasgado Jr",0,1,1,0
1984,100314,"Bernard Fritz",0,1,1,0
1984,100328,"Rand Evett",0,2,2,0
1984,100333,"Shigeyuki Nishio",0,1,1,0
1984,100346,"Paul Kronk",0,1,1,0
1984,100353,"Bruce Kleege",0,1,1,0
1984,100359,"Richard Lewis",0,1,1,0
1984,100375,"John Hayes",0,1,1,0
1984,100383,"Peter Mcnamara",0,1,1,0
1984,100392,"Richard Meyer",0,4,4,0
1984,100394,"Angel Gimenez",0,1,1,0
1984,100398,"Julio Goes",0,3,3,0
1984,100427,"Ferrante Rocchi",0,2,2,0
1984,100430,"David Carter",0,1,1,0
1984,100431,"Mansour Bahrami",0,3,3,0
1984,100436,"Nick Saviano",0,1,1,0
1984,100437,"Bjorn Borg",0,1,1,0
1984,100443,"Christophe Freyss",0,2,2,0
1984,100462,"Jeff Etterbeek",0,1,1,0
1984,100481,"Roberto Vizcaino",0,3,3,0
1984,100485,"Tsuyoshi Fukui",0,2,2,0
1984,100492,"John Austin",0,1,1,0
1984,100496,"Charles Buzz Strode",0,1,1,0
1984,100498,"Klaus Eberhard",0,1,1,0
1984,100503,"Lorenzo Fargas",0,2,2,0
1984,100504,"Jerome Vanier",0,3,3,0
1984,100524,"Shozo Shiraishi",0,2,2,0
1984,100537,"Mike Brunnberg",0,1,1,0
1984,100538,"Alejandro Gattiker",0,2,2,0
1984,100545,"Deon Joubert",0,1,1,0
1984,100547,"Rocky Royer",0,1,1,0
1984,100574,"Peter Rennert",0,2,2,0
1984,100593,"Miloslav Lacek",0,1,1,0
1984,100595,"Ronnie Bathman",0,1,1,0
1984,100615,"Gianluca Rinaldini",0,1,1,0
1984,100619,"George Kalovelonis",0,1,1,0
1984,100622,"Patrizio Parrini",0,1,1,0
1984,100623,"Roger Knapp",0,3,3,0
1984,100630,"Gustavo Guerrero",0,1,1,0
1984,100641,"Jan Van Langendonck",0,3,3,0
1984,100647,"Kiyotaka Tachibana",0,1,1,0
1984,100667,"Per Hjertquist",0,3,3,0
1984,100669,"Charles Bud Cox",0,1,1,0
1984,100672,"Derek Segal",0,1,1,0
1984,100673,"Robbie Venter",0,2,2,0
1984,100675,"John Mccurdy",0,2,2,0
1984,100686,"Karl Richter",0,1,1,0
1984,100699,"Chris Johnstone",0,4,4,0
1984,100704,"Billy Nealon",0,5,5,0
1984,100714,"Broderick Dyke",0,6,6,0
1984,100722,"Michael Fancutt",0,2,2,0
1984,100726,"Greg Whitecross",0,2,2,0
1984,100736,"Hugo Nunez",0,1,1,0
1984,100758,"John Van Nostrand",0,1,1,0
1984,100791,"Bruce Brescia",0,1,1,0
1984,100793,"Stephane Bonneau",0,1,1,0
1984,100820,"Thierry Pham",0,1,1,0
1984,100837,"Jeremy Bates",0,6,6,0
1984,100846,"Ted Farnsworth",0,1,1,0
1984,100873,"Oliver Freund",0,1,1,0
1984,100878,"Christoph Zipf",0,3,3,0
1984,100880,"Russell Barlow",0,1,1,0
1984,100899,"Jorgen Windahl",0,2,2,0
1984,100902,"Christian Jessel",0,1,1,0
1984,100924,"Jorge Lozano",0,1,1,0
1984,100928,"Barry Moir",0,1,1,0
1984,100941,"Alex Stepanek",0,1,1,0
1984,100944,"Mikael Pernfors",0,3,3,0
1984,100966,"Nick Fulwood",0,1,1,0
1984,100972,"Todd Witsken",0,2,2,0
1984,100994,"Joe Heldmann",0,1,1,0
1984,101000,"Carl Limberger",0,3,3,0
1984,101017,"Gap Taik Ro",0,1,1,0
1984,101031,"Massimo Cierro",0,1,1,0
1984,101035,"Menno Oosting",0,1,1,0
1984,101057,"Peter Carter",0,1,1,0
1984,101064,"David Lewis",0,1,1,0
1984,101086,"Ronald Agenor",0,3,3,0
1984,101094,"Eduardo Oncins",0,1,1,0
1984,101111,"Rudiger Benz",0,1,1,0
1984,101112,"Michele Fioroni",0,1,1,0
1984,101140,"Eric Rosenfeld",0,1,1,0
1984,101145,"Jonathan Canter",0,5,5,0
1984,101205,"Grant Connell",0,1,1,0
1984,101226,"Johan Carlsson",0,5,5,0
1984,101265,"Patrick McEnroe",0,2,2,0
1984,101285,"Thierry Champion",0,1,1,0
1984,101336,"Dan Nahirny",0,1,1,0
1984,101394,"Francois Errard",0,1,1,0
1984,101409,"Jaime Yzaga",0,1,1,0
1984,101448,"Tasos Bavelas",0,1,1,0
1984,103993,"Chris Lewis",0,1,1,0
1984,106783,"Corey Wittenberg",0,1,1,0
1984,106929,"Eiji Takeuchi",0,1,1,0
1984,106970,"Eylon Sinai",0,1,1,0
1984,107183,"Hatem Mcdadi",0,1,1,0
1984,107223,"Ichiro Nakanishi",0,1,1,0
1984,107397,"John Stoddart",0,1,1,0
1984,107478,"Kaoru Maruyama",0,1,1,0
1984,107480,"Karel Demuynck",0,1,1,0
1984,107626,"Manuel Rodriguez",0,1,1,0
1984,107629,"Manuel Tolentino",0,1,1,0
1984,107633,"Marc Krippendorf",0,1,1,0
1984,107639,"Marcel Van Der Merwe",0,1,1,0
1984,107699,"Mark Lewis",0,1,1,0
1984,107803,"Miguel Soares",0,1,1,0
1984,107807,"Mike Fedderly",0,2,2,0
1984,107841,"Naomi Uemura",0,1,1,0
1984,107877,"Oded Yaacov",0,1,1,0
1984,107897,"Orlando Lourenco",0,1,1,0
1984,108248,"Shai Puni",0,1,1,0
1984,108253,"Shinichi Sakamoto",0,2,2,0
1984,108256,"Shoichi Horiuchi",0,1,1,0
1984,108259,"Shu Wah Liu",0,1,1,0
1984,108332,"Suharyadi Suharyadi",0,1,1,0
1984,108348,"Takayoshi Shibuya",0,1,1,0
1984,108368,"Tetsu Kuramitsu",0,1,1,0
1984,108428,"Tomer Zimmerman",0,1,1,0
1984,108548,"Yakubu Suleiman",0,1,1,0
1984,110334,"Madhusudhan Nair",0,1,1,0
1984,110335,"Depeng Li",0,1,1,0
1984,110363,"G Irshai",0,1,1,0
1984,123200,"Kenzo Ukon",0,1,1,0
1985,100116,"Sherwood Stewart",0,1,1,0
1985,100126,"Stan Smith",0,1,1,0
1985,100149,"Toshiro Sakai",0,1,1,0
1985,100241,"Joel Bailey",0,1,1,0
1985,100244,"John Alexander",0,6,6,0
1985,100255,"Roscoe Tanner",0,1,1,0
1985,100259,"Peter Feigl",0,2,2,0
1985,100281,"Sashi Menon",0,1,1,0
1985,100333,"Shigeyuki Nishio",0,1,1,0
1985,100364,"Jonathan Smith",0,2,2,0
1985,100422,"Bruce Manson",0,1,1,0
1985,100450,"Leo Palin",0,2,2,0
1985,100486,"Christophe Roger Vasselin",0,2,2,0
1985,100496,"Charles Buzz Strode",0,1,1,0
1985,100503,"Lorenzo Fargas",0,1,1,0
1985,100520,"Juan Farrow",0,1,1,0
1985,100523,"Erick Iskersky",0,1,1,0
1985,100524,"Shozo Shiraishi",0,3,3,0
1985,100526,"Ricardo Ycaza",0,1,1,0
1985,100535,"Tony Giammalva",0,2,2,0
1985,100540,"Drew Gitlin",0,1,1,0
1985,100556,"Brian Levine",0,1,1,0
1985,100566,"Hitoshi Shirato",0,1,1,0
1985,100568,"John Mattke",0,1,1,0
1985,100569,"Toru Yonezawa",0,1,1,0
1985,100575,"Andy Andrews",0,1,1,0
1985,100585,"Van Winitsky",0,1,1,0
1985,100587,"Steve Guy",0,2,2,0
1985,100604,"Egan Adams",0,6,6,0
1985,100647,"Kiyotaka Tachibana",0,1,1,0
1985,100649,"David Dowlen",0,1,1,0
1985,100669,"Charles Bud Cox",0,1,1,0
1985,100672,"Derek Segal",0,1,1,0
1985,100677,"Bob Blazekovic",0,1,1,0
1985,100680,"Peter Johnston",0,2,2,0
1985,100691,"Ivo Werner",0,1,1,0
1985,100703,"Randy Nixon",0,2,2,0
1985,100704,"Billy Nealon",0,1,1,0
1985,100705,"Erik Vant Hof",0,2,2,0
1985,100722,"Michael Fancutt",0,1,1,0
1985,100769,"Mario Martinez",0,1,1,0
1985,100770,"Peter Moraing",0,1,1,0
1985,100771,"Kelvin Belcher",0,3,3,0
1985,100779,"Kevin Moir",0,2,2,0
1985,100785,"Jesus Colas",0,1,1,0
1985,100799,"Carlos Castellan",0,1,1,0
1985,100801,"Richard Akel",0,1,1,0
1985,100802,"Charles Honey",0,2,2,0
1985,100804,"Henri De Wet",0,1,1,0
1985,100820,"Thierry Pham",0,1,1,0
1985,100835,"Hans Dieter Beutel",0,1,1,0
1985,100839,"Laird Dunlop",0,1,1,0
1985,100854,"Leighton Alfred",0,1,1,0
1985,100860,"William Notar",0,1,1,0
1985,100863,"Gustavo Luza",0,1,1,0
1985,100872,"Rill Baxter",0,1,1,0
1985,100900,"Josef Cihak",0,2,2,0
1985,100906,"Antony Emerson",0,2,2,0
1985,100911,"Dominik Guido Utzinger",0,1,1,0
1985,100921,"Patrice Kuchna",0,1,1,0
1985,100930,"Paul Vojtischek",0,1,1,0
1985,100939,"Joey Rive",0,1,1,0
1985,100947,"Doug Burke",0,1,1,0
1985,100964,"Jon Levine",0,2,2,0
1985,100966,"Nick Fulwood",0,4,4,0
1985,100972,"Todd Witsken",0,2,2,0
1985,100974,"Jeff Klaparda",0,1,1,0
1985,100988,"Peter Thrupp",0,1,1,0
1985,100990,"Milan Srejber",0,1,1,0
1985,101018,"Edoardo Mazza",0,1,1,0
1985,101040,"Peter Lindgren",0,1,1,0
1985,101056,"Chuck Willenborg",0,1,1,0
1985,101058,"Francisco Yunis",0,1,1,0
1985,101064,"David Lewis",0,1,1,0
1985,101076,"Cesar Kist",0,1,1,0
1985,101085,"Corrado Aprili",0,1,1,0
1985,101096,"Gary Muller",0,4,4,0
1985,101126,"Chris Pridham",0,1,1,0
1985,101132,"Fredrik Rosenquist",0,1,1,0
1985,101166,"Gustavo Garetto",0,1,1,0
1985,101174,"Fernando Roese",0,4,4,0
1985,101179,"Jean Philippe Fleurian",0,2,2,0
1985,101205,"Grant Connell",0,1,1,0
1985,101238,"Andres Vysand",0,1,1,0
1985,101251,"Eric Winogradsky",0,2,2,0
1985,101265,"Patrick McEnroe",0,5,5,0
1985,101267,"Michael Oberleitner",0,1,1,0
1985,101325,"Jason Goodall",0,1,1,0
1985,101336,"Dan Nahirny",0,1,1,0
1985,101350,"Christian Feenstra",0,1,1,0
1985,101366,"David Macpherson",0,3,3,0
1985,101389,"Oren Motevassel",0,1,1,0
1985,101402,"Stephen Furlong",0,1,1,0
1985,101407,"David Engel",0,1,1,0
1985,101412,"Shuzo Matsuoka",0,1,1,0
1985,101434,"Petr Korda",0,1,1,0
1985,101439,"Javier Sanchez",0,1,1,0
1985,101500,"Christian Saceanu",0,1,1,0
1985,101509,"Patrick Flynn",0,1,1,0
1985,101580,"Roger Rasheed",0,1,1,0
1985,101599,"Thierry Grin",0,1,1,0
1985,106615,"Bernard Balleret",0,1,1,0
1985,106751,"Christoph Meyer",0,1,1,0
1985,106929,"Eiji Takeuchi",0,1,1,0
1985,106930,"Eleuterio Martins",0,1,1,0
1985,106962,"Ernesto Vazquez",0,1,1,0
1985,107147,"Guillermo Minutella",0,1,1,0
1985,107178,"Haruo Nakano",0,1,1,0
1985,107183,"Hatem Mcdadi",0,1,1,0
1985,107262,"Jacques Grandjean",0,1,1,0
1985,107480,"Karel Demuynck",0,1,1,0
1985,107484,"Kazuya Morita",0,1,1,0
1985,107502,"Kenzo Ukon U004",0,1,1,0
1985,107582,"Luca Gasparini",0,1,1,0
1985,107590,"Luis Borfiga",0,1,1,0
1985,107639,"Marcel Van Der Merwe",0,1,1,0
1985,107688,"Mark Greenan",0,1,1,0
1985,107696,"Mark Jeffrey",0,1,1,0
1985,107700,"Mark Long",0,1,1,0
1985,107721,"Martin Valenti",0,1,1,0
1985,107819,"Minoru Ueda",0,1,1,0
1985,108256,"Shoichi Horiuchi",0,1,1,0
1985,108257,"Shoichi Tatsuno",0,1,1,0
1985,108295,"Stephan Bienz",0,1,1,0
1985,108351,"Takeshi Murakami",0,1,1,0
1986,100241,"Joel Bailey",0,1,1,0
1986,100276,"Terry Moor",0,5,5,0
1986,100307,"Paul Torre",0,1,1,0
1986,100342,"Vitas Gerulaitis",0,2,2,0
1986,100367,"Belus Prajoux",0,1,1,0
1986,100390,"Trevor Allan",0,2,2,0
1986,100402,"Francisco Gonzalez",0,6,6,0
1986,100426,"Hans Peter Kandler",0,1,1,0
1986,100428,"Gene Mayer",0,1,1,0
1986,100470,"Juan Carlos Andrade",0,1,1,0
1986,100475,"Matt Mitchell",0,1,1,0
1986,100492,"John Austin",0,1,1,0
1986,100503,"Lorenzo Fargas",0,1,1,0
1986,100544,"Tony Mmoh",0,6,6,0
1986,100546,"Eric Fromm",0,1,1,0
1986,100562,"Tom Cain",0,1,1,0
1986,100565,"Lloyd Bourne",0,1,1,0
1986,100596,"Bill Cowan",0,2,2,0
1986,100620,"Eduardo Osta",0,2,2,0
1986,100630,"Gustavo Guerrero",0,1,1,0
1986,100636,"Gustavo Tiberti",0,4,4,0
1986,100640,"Stefan Simonsson",0,4,4,0
1986,100664,"Stephan Medem",0,2,2,0
1986,100680,"Peter Johnston",0,1,1,0
1986,100686,"Karl Richter",0,2,2,0
1986,100703,"Randy Nixon",0,2,2,0
1986,100716,"Norm Schellenger",0,2,2,0
1986,100727,"Raul Antonio Viver",0,3,3,0
1986,100736,"Hugo Nunez",0,1,1,0
1986,100744,"Peter Doohan",0,7,7,0
1986,100751,"Roberto Saad",0,6,6,0
1986,100761,"Danny Saltz",0,2,2,0
1986,100779,"Kevin Moir",0,2,2,0
1986,100781,"Bernhard Pils",0,1,1,0
1986,100785,"Jesus Colas",0,2,2,0
1986,100793,"Stephane Bonneau",0,4,4,0
1986,100796,"Ahmed El Mehelmy",0,2,2,0
1986,100835,"Hans Dieter Beutel",0,1,1,0
1986,100858,"Hans Fredborg",0,1,1,0
1986,100869,"Jon Sorbo",0,1,1,0
1986,100871,"Laurie Warder",0,2,2,0
1986,100878,"Christoph Zipf",0,1,1,0
1986,100884,"Steve Shaw",0,3,3,0
1986,100892,"Alexandre Hocevar",0,1,1,0
1986,100904,"George Bezecny",0,1,1,0
1986,100914,"Jean Marc Piacentile",0,1,1,0
1986,100918,"Harald Rittersbacher",0,3,3,0
1986,100924,"Jorge Lozano",0,1,1,0
1986,100930,"Paul Vojtischek",0,2,2,0
1986,100932,"Denys Maasdorp",0,2,2,0
1986,100938,"Jaromir Becka",0,1,1,0
1986,100939,"Joey Rive",0,1,1,0
1986,100945,"Craig Campbell",0,5,5,0
1986,100951,"Alessandro De Minicis",0,1,1,0
1986,100974,"Jeff Klaparda",0,1,1,0
1986,100986,"Dacio Campos",0,1,1,0
1986,100995,"Eduardo Masso",0,4,4,0
1986,100998,"Stuart Bale",0,2,2,0
1986,101000,"Carl Limberger",0,1,1,0
1986,101003,"Ricardo Acioly",0,2,2,0
1986,101004,"Jim Pugh",0,4,4,0
1986,101007,"Guillermo Rivas",0,3,3,0
1986,101014,"John Ross",0,2,2,0
1986,101030,"Goran Prpic",0,1,1,0
1986,101031,"Massimo Cierro",0,4,4,0
1986,101059,"Richard Vogel",0,1,1,0
1986,101071,"Tom Nijssen",0,3,3,0
1986,101077,"Bobby Blair",0,2,2,0
1986,101088,"Larry Scott",0,1,1,0
1986,101093,"Steve Devries",0,1,1,0
1986,101097,"Rick Leach",0,4,4,0
1986,101111,"Rudiger Benz",0,1,1,0
1986,101112,"Michele Fioroni",0,2,2,0
1986,101126,"Chris Pridham",0,1,1,0
1986,101128,"Michael Walker",0,1,1,0
1986,101134,"Fredrik Waern",0,1,1,0
1986,101144,"Anthony Lane",0,1,1,0
1986,101150,"Gianluca Pozzi",0,2,2,0
1986,101232,"Nicklas Kroon",0,1,1,0
1986,101237,"Danilo Marcelino",0,1,1,0
1986,101265,"Patrick McEnroe",0,4,4,0
1986,101284,"Lars Anders Wahlgren",0,1,1,0
1986,101320,"Magnus Gustafsson",0,2,2,0
1986,101321,"Juan Carlos Baguena",0,2,2,0
1986,101323,"Tim Trigueiro",0,1,1,0
1986,101325,"Jason Goodall",0,1,1,0
1986,101334,"Alexander Volkov",0,1,1,0
1986,101336,"Dan Nahirny",0,1,1,0
1986,101350,"Christian Feenstra",0,1,1,0
1986,101380,"Amit Naor",0,1,1,0
1986,101398,"Neil Borwick",0,1,1,0
1986,101405,"Ugo Colombini",0,1,1,0
1986,101448,"Tasos Bavelas",0,1,1,0
1986,101461,"Brett Custer",0,3,3,0
1986,101476,"Rolf Hertzog",0,3,3,0
1986,101481,"Omar Camporese",0,2,2,0
1986,101500,"Christian Saceanu",0,3,3,0
1986,101502,"Torben Theine",0,1,1,0
1986,101550,"Al Parker",0,1,1,0
1986,101582,"Gilbert Schaller",0,1,1,0
1986,101601,"Brett Steven",0,1,1,0
1986,101609,"David Wheaton",0,1,1,0
1986,101632,"Per Henricsson",0,1,1,0
1986,101650,"Shane Barr",0,1,1,0
1986,101663,"Eugenio Rossi",0,2,2,0
1986,106962,"Ernesto Vazquez",0,1,1,0
1986,106978,"Fabio Di Mauro",0,1,1,0
1986,107183,"Hatem Mcdadi",0,3,3,0
1986,107200,"Herve Bardot",0,1,1,0
1986,107228,"Igor Flego",0,1,1,0
1986,107484,"Kazuya Morita",0,1,1,0
1986,107618,"Malcolm Elley",0,1,1,0
1986,107725,"Masayoshi Takeyari",0,1,1,0
1986,107884,"Oliver Ploner",0,1,1,0
1986,108257,"Shoichi Tatsuno",0,1,1,0
1986,108265,"Simon Robinson",0,1,1,0
1986,108368,"Tetsu Kuramitsu",0,1,1,0
1986,200630,"Alexander Zverev Sr",0,1,1,0
1987,100221,"Carlos Kirmayr",0,2,2,0
1987,100240,"Joao Soares",0,3,3,0
1987,100241,"Joel Bailey",0,1,1,0
1987,100253,"Tom Gullikson",0,1,1,0
1987,100280,"Wojtek Fibak",0,5,5,0
1987,100315,"Hank Pfister",0,4,4,0
1987,100383,"Peter Mcnamara",0,1,1,0
1987,100417,"Hans Gildemeister",0,1,1,0
1987,100426,"Hans Peter Kandler",0,1,1,0
1987,100445,"Steve Denton",0,1,1,0
1987,100477,"Gianni Ocleppo",0,1,1,0
1987,100515,"Shlomo Glickstein",0,2,2,0
1987,100524,"Shozo Shiraishi",0,1,1,0
1987,100556,"Brian Levine",0,1,1,0
1987,100566,"Hitoshi Shirato",0,1,1,0
1987,100569,"Toru Yonezawa",0,1,1,0
1987,100579,"Heinz Gunthardt",0,1,1,0
1987,100587,"Steve Guy",0,5,5,0
1987,100592,"Robert Vant Hof",0,2,2,0
1987,100596,"Bill Cowan",0,1,1,0
1987,100619,"George Kalovelonis",0,1,1,0
1987,100641,"Jan Van Langendonck",0,1,1,0
1987,100649,"David Dowlen",0,1,1,0
1987,100651,"Alejandro Ganzabal",0,1,1,0
1987,100690,"Marco Armellini",0,1,1,0
1987,100701,"Marko Ostoja",0,5,5,0
1987,100727,"Raul Antonio Viver",0,1,1,0
1987,100731,"Hector Ortiz",0,1,1,0
1987,100733,"Woo Ryong Lee",0,1,1,0
1987,100781,"Bernhard Pils",0,1,1,0
1987,100785,"Jesus Colas",0,1,1,0
1987,100792,"Adrian Marcu",0,1,1,0
1987,100812,"Gerald Mild",0,1,1,0
1987,100824,"Peter Bastiansen",0,1,1,0
1987,100835,"Hans Dieter Beutel",0,3,3,0
1987,100838,"Steve Wood",0,1,1,0
1987,100841,"Jin Sun Yoo",0,1,1,0
1987,100877,"Brett Dickinson",0,3,3,0
1987,100887,"Eric Korita",0,1,1,0
1987,100903,"Mike Lee",0,1,1,0
1987,100906,"Antony Emerson",0,1,1,0
1987,100907,"Luca Bottazzi",0,1,1,0
1987,100908,"Tobias Svantesson",0,1,1,0
1987,100917,"Nelson Aerts",0,2,2,0
1987,100918,"Harald Rittersbacher",0,1,1,0
1987,100931,"Andrew Burrow",0,3,3,0
1987,100974,"Jeff Klaparda",0,2,2,0
1987,100984,"Peter Wright",0,1,1,0
1987,100998,"Stuart Bale",0,2,2,0
1987,101008,"Peter Palandjian",0,1,1,0
1987,101017,"Gap Taik Ro",0,1,1,0
1987,101018,"Edoardo Mazza",0,1,1,0
1987,101032,"Henry Somerville",0,1,1,0
1987,101043,"Johan Vekemans",0,1,1,0
1987,101057,"Peter Carter",0,4,4,0
1987,101067,"Philip Johnson",0,1,1,0
1987,101075,"Dexter Macbride",0,1,1,0
1987,101076,"Cesar Kist",0,2,2,0
1987,101093,"Steve Devries",0,2,2,0
1987,101108,"Richard Schmidt",0,3,3,0
1987,101112,"Michele Fioroni",0,1,1,0
1987,101122,"Alberto Paris",0,1,1,0
1987,101123,"Alexander Mronz",0,1,1,0
1987,101133,"Patrick Baur",0,2,2,0
1987,101149,"Morten Christensen",0,1,1,0
1987,101155,"James Turner",0,1,1,0
1987,101174,"Fernando Roese",0,2,2,0
1987,101186,"Desmond Tyson",0,3,3,0
1987,101198,"Steve Kennedy",0,1,1,0
1987,101205,"Grant Connell",0,1,1,0
1987,101216,"Olli Rahnasto",0,1,1,0
1987,101243,"Roberto Azar",0,2,2,0
1987,101247,"Stephen Botfield",0,1,1,0
1987,101249,"Andrei Olhovskiy",0,2,2,0
1987,101252,"Brian Page",0,1,1,0
1987,101259,"Mike Baroch",0,1,1,0
1987,101263,"Luke Jensen",0,2,2,0
1987,101264,"Michael Tauson",0,2,2,0
1987,101265,"Patrick McEnroe",0,3,3,0
1987,101295,"Toshihisa Tsuchihashi",0,2,2,0
1987,101308,"Neil Broad",0,1,1,0
1987,101315,"Enrico Cocchi",0,1,1,0
1987,101321,"Juan Carlos Baguena",0,1,1,0
1987,101327,"Cyril Suk",0,1,1,0
1987,101328,"Mihnea Ion Nastase",0,1,1,0
1987,101339,"Agustin Moreno",0,1,1,0
1987,101358,"Olivier Delaitre",0,4,4,0
1987,101366,"David Macpherson",0,3,3,0
1987,101380,"Amit Naor",0,2,2,0
1987,101392,"Dan Goldberg",0,1,1,0
1987,101405,"Ugo Colombini",0,1,1,0
1987,101407,"David Engel",0,2,2,0
1987,101429,"Stephane Grenier",0,1,1,0
1987,101435,"Brian Gyetko",0,1,1,0
1987,101445,"Alessandro Baldoni",0,3,3,0
1987,101447,"Santiago Mora",0,1,1,0
1987,101448,"Tasos Bavelas",0,1,1,0
1987,101451,"Gustavo Giussani",0,2,2,0
1987,101452,"Greg Failla",0,1,1,0
1987,101459,"Tomas Nydahl",0,1,1,0
1987,101462,"Francisco Roig",0,1,1,0
1987,101493,"Christian Weis",0,1,1,0
1987,101549,"Rodolphe Gilbert",0,1,1,0
1987,101565,"Marius Barnard",0,1,1,0
1987,101619,"David Wells Roth",0,1,1,0
1987,101765,"Tomas Anzari",0,1,1,0
1987,101767,"Lars Jonsson",0,1,1,0
1987,101783,"Mark Petchey",0,1,1,0
1987,101793,"Jim Courier",0,2,2,0
1987,101812,"Raviv Weidenfeld",0,1,1,0
1987,101963,"Emmanuel Marmillod",0,1,1,0
1987,106749,"Christoph Geukens",0,1,1,0
1987,106829,"David Betous",0,1,1,0
1987,106962,"Ernesto Vazquez",0,1,1,0
1987,107183,"Hatem Mcdadi",0,1,1,0
1987,107480,"Karel Demuynck",0,1,1,0
1987,107640,"Marcello Bassanelli",0,1,1,0
1987,107828,"Morees Dubruyn",0,1,1,0
1987,107884,"Oliver Ploner",0,1,1,0
1987,107940,"Paul Chaput",0,1,1,0
1987,108002,"Philippe Lacombrade",0,1,1,0
1987,108008,"Phillip Williamson",0,1,1,0
1987,108018,"Pierre Lemoine",0,1,1,0
1987,108227,"Sebastian Soresini",0,1,1,0
1987,108293,"Stefano Mezzadri",0,1,1,0
1987,108352,"Takeshi Omono",0,1,1,0
1987,108378,"Thierry Van Den Daele",0,1,1,0
1987,199999,"U Unknown",0,1,1,0
1988,100241,"Joel Bailey",0,1,1,0
1988,100315,"Hank Pfister",0,1,1,0
1988,100398,"Julio Goes",0,1,1,0
1988,100449,"Stanislav Birner",0,1,1,0
1988,100548,"Ivan Kley",0,5,5,0
1988,100567,"Chip Hooper",0,3,3,0
1988,100609,"Zoltan Kuharszky",0,2,2,0
1988,100616,"Andy Kohlberg",0,1,1,0
1988,100639,"Blaine Willenborg",0,3,3,0
1988,100645,"Huub Van Boeckel",0,5,5,0
1988,100648,"Sadiq Abdullahi",0,1,1,0
1988,100660,"Bob Green",0,1,1,0
1988,100691,"Ivo Werner",0,1,1,0
1988,100730,"Florin Segarceanu",0,5,5,0
1988,100742,"Christo Steyn",0,1,1,0
1988,100770,"Peter Moraing",0,1,1,0
1988,100779,"Kevin Moir",0,1,1,0
1988,100802,"Charles Honey",0,2,2,0
1988,100817,"Mark Basham",0,3,3,0
1988,100819,"Daniel Montes De Oca",0,2,2,0
1988,100825,"Hugo Chapacu",0,1,1,0
1988,100826,"Juan Antonio Rodriguez",0,1,1,0
1988,100835,"Hans Dieter Beutel",0,1,1,0
1988,100868,"Craig A Miller",0,1,1,0
1988,100889,"Joe De Foor",0,1,1,0
1988,100892,"Alexandre Hocevar",0,2,2,0
1988,100896,"Miguel Nido",0,2,2,0
1988,100904,"George Bezecny",0,2,2,0
1988,100909,"Stefan Heckmanns",0,1,1,0
1988,100917,"Nelson Aerts",0,1,1,0
1988,100921,"Patrice Kuchna",0,1,1,0
1988,100951,"Alessandro De Minicis",0,1,1,0
1988,100959,"Chris Kennedy",0,1,1,0
1988,100964,"Jon Levine",0,6,6,0
1988,100982,"Charlton Eagle",0,2,2,0
1988,100986,"Dacio Campos",0,1,1,0
1988,100993,"Loic Courteau",0,2,2,0
1988,101007,"Guillermo Rivas",0,3,3,0
1988,101009,"John Sobel",0,2,2,0
1988,101013,"Henrik Sundstrom",0,2,2,0
1988,101024,"Christian Geyer",0,2,2,0
1988,101027,"Jaroslav Bulant",0,1,1,0
1988,101030,"Goran Prpic",0,2,2,0
1988,101041,"Geoff Roper",0,1,1,0
1988,101043,"Johan Vekemans",0,1,1,0
1988,101045,"Craig Boynton",0,1,1,0
1988,101059,"Richard Vogel",0,1,1,0
1988,101065,"Joel Figueras",0,1,1,0
1988,101085,"Corrado Aprili",0,2,2,0
1988,101088,"Larry Scott",0,9,9,0
1988,101108,"Richard Schmidt",0,3,3,0
1988,101112,"Michele Fioroni",0,2,2,0
1988,101115,"Jorge Bardou",0,3,3,0
1988,101134,"Fredrik Waern",0,3,3,0
1988,101144,"Anthony Lane",0,1,1,0
1988,101149,"Morten Christensen",0,1,1,0
1988,101159,"Gustav Fichardt",0,1,1,0
1988,101165,"Mario Tabares",0,1,1,0
1988,101166,"Gustavo Garetto",0,3,3,0
1988,101174,"Fernando Roese",0,4,4,0
1988,101184,"Damir Buljevic",0,1,1,0
1988,101186,"Desmond Tyson",0,1,1,0
1988,101207,"Michael Daniel",0,1,1,0
1988,101211,"Otis Smith",0,1,1,0
1988,101235,"Paul Haarhuis",0,1,1,0
1988,101242,"Brad Pearce",0,2,2,0
1988,101262,"Rikard Bergh",0,4,4,0
1988,101264,"Michael Tauson",0,1,1,0
1988,101267,"Michael Oberleitner",0,1,1,0
1988,101282,"Martin Barba",0,1,1,0
1988,101284,"Lars Anders Wahlgren",0,2,2,0
1988,101295,"Toshihisa Tsuchihashi",0,3,3,0
1988,101308,"Neil Broad",0,1,1,0
1988,101310,"Conny Falk",0,1,1,0
1988,101311,"Kent Kinnear",0,1,1,0
1988,101312,"Robbie Weiss",0,4,4,0
1988,101319,"Antonio Padovani",0,1,1,0
1988,101321,"Juan Carlos Baguena",0,3,3,0
1988,101322,"Shigeru Ota",0,1,1,0
1988,101325,"Jason Goodall",0,1,1,0
1988,101355,"Richard Whichello",0,1,1,0
1988,101356,"Buff Farrow",0,1,1,0
1988,101360,"Mark Keil",0,1,1,0
1988,101366,"David Macpherson",0,1,1,0
1988,101380,"Amit Naor",0,1,1,0
1988,101384,"Marco Filippeschi",0,2,2,0
1988,101389,"Oren Motevassel",0,1,1,0
1988,101390,"Ugo Biagianti",0,1,1,0
1988,101416,"Joao Cunha Silva",0,1,1,0
1988,101419,"Frank Dennhardt",0,1,1,0
1988,101421,"Veli Paloheimo",0,1,1,0
1988,101422,"Mark Kaplan",0,1,1,0
1988,101427,"Ruben Gajardo",0,2,2,0
1988,101429,"Stephane Grenier",0,2,2,0
1988,101440,"Mark Koevermans",0,1,1,0
1988,101445,"Alessandro Baldoni",0,3,3,0
1988,101447,"Santiago Mora",0,1,1,0
1988,101448,"Tasos Bavelas",0,1,1,0
1988,101469,"Brian Garrow",0,2,2,0
1988,101502,"Torben Theine",0,1,1,0
1988,101505,"Darren Kirk",0,1,1,0
1988,101550,"Al Parker",0,2,2,0
1988,101552,"Xavier Daufresne",0,1,1,0
1988,101556,"Carl Turich",0,2,2,0
1988,101561,"Nicklas Utgren",0,2,2,0
1988,101570,"Vicente Solves",0,1,1,0
1988,101579,"Patrik Wennberg",0,1,1,0
1988,101593,"Chris Garner",0,1,1,0
1988,101598,"Eduardo Velez",0,1,1,0
1988,101601,"Brett Steven",0,2,2,0
1988,101609,"David Wheaton",0,3,3,0
1988,101630,"Clement Ngoran",0,1,1,0
1988,101637,"Brian Roe",0,3,3,0
1988,101642,"Bart Wuyts",0,1,1,0
1988,101663,"Eugenio Rossi",0,1,1,0
1988,101674,"Rudiger Haas",0,1,1,0
1988,101676,"Adam Anderson",0,1,1,0
1988,101694,"David Franco",0,1,1,0
1988,101703,"Guillaume Raoux",0,1,1,0
1988,101720,"Agustin Garizzio",0,1,1,0
1988,101725,"Gabriel Markus",0,1,1,0
1988,101726,"Boaz Merenstein",0,1,1,0
1988,101742,"Johan Sandberg",0,2,2,0
1988,101745,"Roberto Jabali",0,1,1,0
1988,101760,"David Kass",0,1,1,0
1988,101765,"Tomas Anzari",0,1,1,0
1988,101779,"Pavel Vizner",0,1,1,0
1988,101783,"Mark Petchey",0,1,1,0
1988,101812,"Raviv Weidenfeld",0,1,1,0
1988,101820,"Marc Rosset",0,1,1,0
1988,101835,"Arne Thoms",0,1,1,0
1988,101843,"Sergi Bruguera",0,1,1,0
1988,101861,"Thomas Buchmayer",0,1,1,0
1988,101881,"Oliver Fuchs",0,1,1,0
1988,101890,"Jonathan Stark",0,1,1,0
1988,101920,"Jamie Morgan",0,1,1,0
1988,101924,"Stefano Pescosolido",0,1,1,0
1988,101925,"Massimo Boscatto",0,1,1,0
1988,101956,"Mark Knowles",0,1,1,0
1988,102008,"Johan Alven",0,1,1,0
1988,102019,"Dirk Dier",0,1,1,0
1988,106650,"Brad Properjohn",0,1,1,0
1988,106733,"Chris Louw",0,1,1,0
1988,106978,"Fabio Di Mauro",0,1,1,0
1988,107102,"Giovanni Lelli Mami",0,1,1,0
1988,107128,"Grant Saacks",0,1,1,0
1988,107149,"Gunther Vanderveeren",0,1,1,0
1988,107170,"Hans Priller",0,1,1,0
1988,107245,"Ivano Cappelloni",0,1,1,0
1988,107388,"John Marinov",0,1,1,0
1988,107497,"Kenichi Kiyomiya",0,1,1,0
1988,107678,"Marius Masencamp",0,1,1,0
1988,107689,"Mark Gurr",0,1,1,0
1988,107894,"Omar Urbinati",0,2,2,0
1988,108060,"Remi Gilberton",0,1,1,0
1988,108228,"Sebastien Gerard",0,1,1,0
1988,108321,"Steven Alger",0,1,1,0
1988,108372,"Thibault Kuentz",0,1,1,0
1988,108468,"Victor Caballero",0,1,1,0
1988,108471,"Victor Lopez",0,1,1,0
1989,100398,"Julio Goes",0,1,1,0
1989,100460,"Jose Lopez Maeso",0,1,1,0
1989,100485,"Tsuyoshi Fukui",0,1,1,0
1989,100490,"Jaroslav Navratil",0,1,1,0
1989,100518,"Ricardo Acuna",0,3,3,0
1989,100524,"Shozo Shiraishi",0,1,1,0
1989,100530,"Andreas Maurer",0,2,2,0
1989,100603,"Roland Stadler",0,3,3,0
1989,100611,"Mel Purcell",0,1,1,0
1989,100619,"George Kalovelonis",0,1,1,0
1989,100620,"Eduardo Osta",0,2,2,0
1989,100719,"Juan Avendano",0,1,1,0
1989,100728,"Todd Nelson",0,3,3,0
1989,100782,"Pablo Arraya",0,6,6,0
1989,100785,"Jesus Colas",0,2,2,0
1989,100790,"Bruce Derlin",0,1,1,0
1989,100794,"Srinivasan Vasudevan",0,1,1,0
1989,100802,"Charles Honey",0,1,1,0
1989,100819,"Daniel Montes De Oca",0,1,1,0
1989,100833,"Marc Flur",0,3,3,0
1989,100863,"Gustavo Luza",0,1,1,0
1989,100865,"Marcelo Ingaramo",0,5,5,0
1989,100871,"Laurie Warder",0,1,1,0
1989,100880,"Russell Barlow",0,1,1,0
1989,100899,"Jorgen Windahl",0,1,1,0
1989,100910,"Magnus Tideman",0,1,1,0
1989,100917,"Nelson Aerts",0,1,1,0
1989,100924,"Jorge Lozano",0,7,7,0
1989,100931,"Andrew Burrow",0,1,1,0
1989,100943,"Girts Dzelde",0,2,2,0
1989,100945,"Craig Campbell",0,2,2,0
1989,100951,"Alessandro De Minicis",0,1,1,0
1989,100955,"Yahiya Doumbia",0,11,11,0
1989,100980,"Edvaldo Oliveira",0,1,1,0
1989,100982,"Charlton Eagle",0,1,1,0
1989,100985,"Tim Pawsat",0,1,1,0
1989,100986,"Dacio Campos",0,1,1,0
1989,101003,"Ricardo Acioly",0,1,1,0
1989,101013,"Henrik Sundstrom",0,1,1,0
1989,101017,"Gap Taik Ro",0,1,1,0
1989,101018,"Edoardo Mazza",0,2,2,0
1989,101053,"Michael Kures",0,5,5,0
1989,101057,"Peter Carter",0,2,2,0
1989,101059,"Richard Vogel",0,2,2,0
1989,101068,"Byron Talbot",0,4,4,0
1989,101074,"Carlos Di Laura",0,1,1,0
1989,101076,"Cesar Kist",0,2,2,0
1989,101083,"Tom Mercer",0,2,2,0
1989,101088,"Larry Scott",0,2,2,0
1989,101093,"Steve Devries",0,1,1,0
1989,101105,"Jose Antonio Fernandez",0,1,1,0
1989,101107,"Charles Merzbacher",0,1,1,0
1989,101108,"Richard Schmidt",0,2,2,0
1989,101110,"David De Miguel",0,1,1,0
1989,101112,"Michele Fioroni",0,1,1,0
1989,101114,"Charles Beckman",0,1,1,0
1989,101125,"Ville Jansson",0,1,1,0
1989,101129,"Andrew Lobb",0,1,1,0
1989,101149,"Morten Christensen",0,1,1,0
1989,101155,"James Turner",0,2,2,0
1989,101161,"Thomas Haldin",0,5,5,0
1989,101165,"Mario Tabares",0,1,1,0
1989,101193,"James Schor",0,1,1,0
1989,101207,"Michael Daniel",0,1,1,0
1989,101217,"Andreas Lesch",0,2,2,0
1989,101247,"Stephen Botfield",0,1,1,0
1989,101250,"Jose Daher",0,1,1,0
1989,101267,"Michael Oberleitner",0,1,1,0
1989,101283,"Dirk Leppen",0,1,1,0
1989,101299,"Sven Salumaa",0,1,1,0
1989,101311,"Kent Kinnear",0,6,6,0
1989,101322,"Shigeru Ota",0,1,1,0
1989,101325,"Jason Goodall",0,2,2,0
1989,101342,"Patrick Galbraith",0,2,2,0
1989,101353,"Lionel Barthez",0,1,1,0
1989,101363,"Vojtech Flegl",0,1,1,0
1989,101368,"Christian Miniussi",0,4,4,0
1989,101384,"Marco Filippeschi",0,2,2,0
1989,101385,"Mario Carnevale",0,1,1,0
1989,101392,"Dan Goldberg",0,2,2,0
1989,101398,"Neil Borwick",0,1,1,0
1989,101416,"Joao Cunha Silva",0,3,3,0
1989,101417,"Mario Rincon",0,1,1,0
1989,101419,"Frank Dennhardt",0,2,2,0
1989,101423,"John Boytim",0,4,4,0
1989,101433,"Austen Brice",0,1,1,0
1989,101438,"Michael Bauer",0,1,1,0
1989,101452,"Greg Failla",0,1,1,0
1989,101461,"Brett Custer",0,1,1,0
1989,101503,"Donni Leaycraft",0,2,2,0
1989,101504,"Laurent Prades",0,2,2,0
1989,101508,"Magnus Zeile",0,1,1,0
1989,101549,"Rodolphe Gilbert",0,1,1,0
1989,101550,"Al Parker",0,2,2,0
1989,101556,"Carl Turich",0,1,1,0
1989,101567,"Hendrik Jan Davids",0,1,1,0
1989,101570,"Vicente Solves",0,1,1,0
1989,101578,"Markus Rackl",0,3,3,0
1989,101582,"Gilbert Schaller",0,1,1,0
1989,101611,"Cedric Pioline",0,3,3,0
1989,101615,"Otavio Della",0,1,1,0
1989,101632,"Per Henricsson",0,2,2,0
1989,101659,"Jan Apell",0,2,2,0
1989,101670,"Martin Schaffl",0,1,1,0
1989,101674,"Rudiger Haas",0,1,1,0
1989,101676,"Adam Anderson",0,1,1,0
1989,101696,"Federico Mordegan",0,2,2,0
1989,101719,"Frederic Fontang",0,1,1,0
1989,101721,"Markus Zillner",0,1,1,0
1989,101723,"Magnus Larsson",0,3,3,0
1989,101730,"Piet Norval",0,3,3,0
1989,101761,"Jaime Oncins",0,2,2,0
1989,101765,"Tomas Anzari",0,1,1,0
1989,101776,"Sandon Stolle",0,1,1,0
1989,101787,"Darren Patten",0,1,1,0
1989,101792,"Slava Dosedel",0,2,2,0
1989,101797,"Jacco Eltingh",0,1,1,0
1989,101847,"Bret Richardson",0,1,1,0
1989,101862,"Maurice Ruah",0,1,1,0
1989,101881,"Oliver Fuchs",0,2,2,0
1989,101901,"Chuck Adams",0,2,2,0
1989,101912,"Felipe Rivera",0,1,1,0
1989,101920,"Jamie Morgan",0,2,2,0
1989,101934,"Paul Dogger",0,1,1,0
1989,101956,"Mark Knowles",0,3,3,0
1989,102071,"Robert Janecek",0,1,1,0
1989,102080,"Will Bull",0,1,1,0
1989,102110,"Daniel Nestor",0,1,1,0
1989,102118,"Radomir Vasek",0,1,1,0
1989,102187,"John Laffnie De Jager",0,1,1,0
1989,102205,"Sebastien Lareau",0,1,1,0
1989,102235,"Tommy Ho",0,5,5,0
1989,102301,"Sebastien Leblanc",0,1,1,0
1989,102358,"Thomas Enqvist",0,1,1,0
1989,102540,"Peter Hajek",0,1,1,0
1989,106923,"Eduardo Mandarino",0,1,1,0
1989,106937,"Emilio Marturano",0,1,1,0
1989,106978,"Fabio Di Mauro",0,1,1,0
1989,107028,"Francisco Pinto",0,1,1,0
1989,107170,"Hans Priller",0,1,1,0
1989,107178,"Haruo Nakano",0,1,1,0
1989,107201,"Hidehiko Tanizawa",0,1,1,0
1989,107221,"Ian Peter Budge",0,1,1,0
1989,107388,"John Marinov",0,1,1,0
1989,107688,"Mark Greenan",0,1,1,0
1989,107818,"Miles Walker",0,1,1,0
1989,108043,"Ralph Kok",0,2,2,0
1989,108367,"Tertius Reynders",0,1,1,0
1989,108500,"Warren Green",0,2,2,0
1989,108565,"Young Min Kwon",0,3,3,0
1989,210013,"Martin Damm Sr",0,1,1,0
1990,100284,"Jimmy Connors",0,3,3,0
1990,100321,"Vijay Amritraj",0,3,3,0
1990,100489,"Larry Stefanki",0,1,1,0
1990,100532,"Johan Kriek",0,1,1,0
1990,100570,"Marty Davis",0,2,2,0
1990,100592,"Robert Vant Hof",0,1,1,0
1990,100595,"Ronnie Bathman",0,2,2,0
1990,100619,"George Kalovelonis",0,1,1,0
1990,100701,"Marko Ostoja",0,1,1,0
1990,100719,"Juan Avendano",0,1,1,0
1990,100728,"Todd Nelson",0,2,2,0
1990,100740,"Dan Cassidy",0,7,7,0
1990,100744,"Peter Doohan",0,2,2,0
1990,100819,"Daniel Montes De Oca",0,1,1,0
1990,100836,"Glenn Michibata",0,1,1,0
1990,100876,"Bong Soo Kim",0,2,2,0
1990,100917,"Nelson Aerts",0,1,1,0
1990,100919,"Khalid Outaleb",0,1,1,0
1990,100949,"Mauro Menezes",0,1,1,0
1990,100951,"Alessandro De Minicis",0,1,1,0
1990,100955,"Yahiya Doumbia",0,1,1,0
1990,100978,"Andrew Castle",0,3,3,0
1990,100982,"Charlton Eagle",0,1,1,0
1990,101007,"Guillermo Rivas",0,1,1,0
1990,101020,"Hans Schwaier",0,3,3,0
1990,101024,"Christian Geyer",0,1,1,0
1990,101044,"Mark Ozer",0,1,1,0
1990,101048,"Francisco Maciel",0,2,2,0
1990,101059,"Richard Vogel",0,1,1,0
1990,101067,"Philip Johnson",0,1,1,0
1990,101083,"Tom Mercer",0,1,1,0
1990,101110,"David De Miguel",0,2,2,0
1990,101143,"Branislav Stankovic",0,1,1,0
1990,101155,"James Turner",0,1,1,0
1990,101172,"Royce Deppe",0,1,1,0
1990,101180,"Jose Clavet",0,2,2,0
1990,101207,"Michael Daniel",0,1,1,0
1990,101217,"Andreas Lesch",0,1,1,0
1990,101238,"Andres Vysand",0,2,2,0
1990,101250,"Jose Daher",0,1,1,0
1990,101255,"Greg Van Emburgh",0,1,1,0
1990,101263,"Luke Jensen",0,4,4,0
1990,101283,"Dirk Leppen",0,2,2,0
1990,101295,"Toshihisa Tsuchihashi",0,1,1,0
1990,101302,"Ola Jonsson J092",0,2,2,0
1990,101314,"Woody Hunt",0,1,1,0
1990,101327,"Cyril Suk",0,4,4,0
1990,101328,"Mihnea Ion Nastase",0,1,1,0
1990,101329,"Christer Allgardh",0,1,1,0
1990,101338,"Olivier Soules",0,3,3,0
1990,101341,"Pablo Albano",0,2,2,0
1990,101342,"Patrick Galbraith",0,1,1,0
1990,101352,"Jae Sik Kim",0,1,1,0
1990,101366,"David Macpherson",0,3,3,0
1990,101368,"Christian Miniussi",0,4,4,0
1990,101373,"Karsten Braasch",0,1,1,0
1990,101383,"Stephane Sansoni",0,1,1,0
1990,101389,"Oren Motevassel",0,1,1,0
1990,101392,"Dan Goldberg",0,2,2,0
1990,101417,"Mario Rincon",0,1,1,0
1990,101419,"Frank Dennhardt",0,1,1,0
1990,101430,"Sergio Cortes",0,1,1,0
1990,101435,"Brian Gyetko",0,1,1,0
1990,101452,"Greg Failla",0,1,1,0
1990,101477,"Chris Bailey",0,2,2,0
1990,101490,"Daniel Orsanic",0,1,1,0
1990,101499,"Eduardo Furusho",0,1,1,0
1990,101502,"Torben Theine",0,1,1,0
1990,101508,"Magnus Zeile",0,1,1,0
1990,101514,"Mike Briggs",0,1,1,0
1990,101516,"Joao Zwetsch",0,1,1,0
1990,101534,"Libor Nemecek",0,2,2,0
1990,101549,"Rodolphe Gilbert",0,1,1,0
1990,101570,"Vicente Solves",0,1,1,0
1990,101581,"Jose Luis Aparisi",0,1,1,0
1990,101584,"Keith Evans",0,1,1,0
1990,101608,"Tom Kempers",0,1,1,0
1990,101615,"Otavio Della",0,1,1,0
1990,101650,"Shane Barr",0,2,2,0
1990,101659,"Jan Apell",0,2,2,0
1990,101668,"Peter Nyborg",0,3,3,0
1990,101696,"Federico Mordegan",0,5,5,0
1990,101707,"Yuval Karutzi",0,1,1,0
1990,101710,"Martin Blackman",0,1,1,0
1990,101726,"Boaz Merenstein",0,1,1,0
1990,101761,"Jaime Oncins",0,4,4,0
1990,101765,"Tomas Anzari",0,1,1,0
1990,101787,"Darren Patten",0,1,1,0
1990,101800,"Daniele Balducci",0,1,1,0
1990,101812,"Raviv Weidenfeld",0,1,1,0
1990,101819,"Frederic Vitoux",0,1,1,0
1990,101823,"Gerald Mandl",0,1,1,0
1990,101849,"Nicola Bruno",0,1,1,0
1990,101861,"Thomas Buchmayer",0,2,2,0
1990,101866,"David Rikl",0,1,1,0
1990,101869,"Juan Luis Tati Rascon",0,1,1,0
1990,101881,"Oliver Fuchs",0,2,2,0
1990,101886,"Ohad Weinberg",0,1,1,0
1990,101890,"Jonathan Stark",0,1,1,0
1990,101895,"Michael Brown B395",0,1,1,0
1990,101917,"Grant Stafford",0,1,1,0
1990,101920,"Jamie Morgan",0,1,1,0
1990,101925,"Massimo Boscatto",0,1,1,0
1990,101934,"Paul Dogger",0,1,1,0
1990,101945,"Thierry Guardiola",0,1,1,0
1990,101953,"Kentaro Masuda",0,2,2,0
1990,101962,"Younes El Aynaoui",0,1,1,0
1990,101968,"Ola Kristiansson",0,1,1,0
1990,101995,"Krister Wedenby",0,1,1,0
1990,102019,"Dirk Dier",0,1,1,0
1990,102047,"Pier Gauthier",0,1,1,0
1990,102132,"Ivan Baron",0,1,1,0
1990,102139,"Eyal Ran",0,1,1,0
1990,102146,"Jordi Burillo",0,1,1,0
1990,102171,"Reinhard Wawra",0,1,1,0
1990,102210,"Rene Hanak",0,1,1,0
1990,102223,"Karim Alami",0,1,1,0
1990,102226,"David Witt",0,1,1,0
1990,102247,"Andrea Gaudenzi",0,1,1,0
1990,102358,"Thomas Enqvist",0,1,1,0
1990,102446,"Andrei Medvedev",0,1,1,0
1990,102669,"Noam Behr",0,1,1,0
1990,106874,"Dick Bosse",0,1,1,0
1990,106967,"Ettore Rossetti",0,1,1,0
1990,107172,"Harald Mair",0,1,1,0
1990,107201,"Hidehiko Tanizawa",0,1,1,0
1990,107221,"Ian Peter Budge",0,1,1,0
1990,107345,"Jin So Lee",0,1,1,0
1990,108043,"Ralph Kok",0,1,1,0
1990,108247,"Shai Friedman",0,1,1,0
1990,108571,"Yuval Hirsch",0,1,1,0
1990,210013,"Martin Damm Sr",0,1,1,0
1991,100286,"Harold Solomon",0,1,1,0
1991,100437,"Bjorn Borg",0,1,1,0
1991,100536,"Fernando Luna",0,3,3,0
1991,100553,"Nduka Odizor",0,1,1,0
1991,100587,"Steve Guy",0,1,1,0
1991,100619,"George Kalovelonis",0,1,1,0
1991,100714,"Broderick Dyke",0,2,2,0
1991,100727,"Raul Antonio Viver",0,1,1,0
1991,100744,"Peter Doohan",0,1,1,0
1991,100810,"Paul Chamberlin",0,1,1,0
1991,100826,"Juan Antonio Rodriguez",0,1,1,0
1991,100857,"Sergio Casal",0,1,1,0
1991,100865,"Marcelo Ingaramo",0,2,2,0
1991,100866,"Shahar Perkiss",0,1,1,0
1991,100876,"Bong Soo Kim",0,1,1,0
1991,100892,"Alexandre Hocevar",0,1,1,0
1991,100920,"Robert Seguso",0,1,1,0
1991,100926,"Ken Flach",0,2,2,0
1991,100930,"Paul Vojtischek",0,3,3,0
1991,100935,"Michael Robertson",0,2,2,0
1991,100939,"Joey Rive",0,2,2,0
1991,100942,"Thierry Tulasne",0,4,4,0
1991,100955,"Yahiya Doumbia",0,2,2,0
1991,101009,"John Sobel",0,2,2,0
1991,101014,"John Ross",0,1,1,0
1991,101066,"Richard Matuszewski",0,1,1,0
1991,101076,"Cesar Kist",0,1,1,0
1991,101080,"Lawson Duncan",0,2,2,0
1991,101083,"Tom Mercer",0,1,1,0
1991,101097,"Rick Leach",0,7,7,0
1991,101105,"Jose Antonio Fernandez",0,1,1,0
1991,101108,"Richard Schmidt",0,1,1,0
1991,101128,"Michael Walker",0,1,1,0
1991,101143,"Branislav Stankovic",0,1,1,0
1991,101145,"Jonathan Canter",0,2,2,0
1991,101202,"Ian Aler",0,1,1,0
1991,101216,"Olli Rahnasto",0,1,1,0
1991,101224,"Kenny Thorne",0,1,1,0
1991,101248,"Pat Crow",0,1,1,0
1991,101262,"Rikard Bergh",0,1,1,0
1991,101264,"Michael Tauson",0,1,1,0
1991,101295,"Toshihisa Tsuchihashi",0,1,1,0
1991,101321,"Juan Carlos Baguena",0,2,2,0
1991,101327,"Cyril Suk",0,2,2,0
1991,101328,"Mihnea Ion Nastase",0,1,1,0
1991,101329,"Christer Allgardh",0,2,2,0
1991,101331,"Alex Nizet",0,1,1,0
1991,101337,"Martin Strelba",0,3,3,0
1991,101338,"Olivier Soules",0,1,1,0
1991,101352,"Jae Sik Kim",0,1,1,0
1991,101356,"Buff Farrow",0,1,1,0
1991,101365,"Paul Wekesa",0,1,1,0
1991,101366,"David Macpherson",0,1,1,0
1991,101375,"Brian Devening",0,1,1,0
1991,101420,"Vaclav Roubicek",0,2,2,0
1991,101448,"Tasos Bavelas",0,1,1,0
1991,101463,"Bernd Karbacher",0,1,1,0
1991,101477,"Chris Bailey",0,2,2,0
1991,101479,"Tj Middleton",0,2,2,0
1991,101483,"Ricardo Camargo",0,1,1,0
1991,101484,"Vladimir Gabrichidze",0,3,3,0
1991,101499,"Eduardo Furusho",0,1,1,0
1991,101502,"Torben Theine",0,1,1,0
1991,101531,"Mario Visconti",0,1,1,0
1991,101567,"Hendrik Jan Davids",0,2,2,0
1991,101570,"Vicente Solves",0,1,1,0
1991,101576,"Ryuso Tsujino",0,1,1,0
1991,101581,"Jose Luis Aparisi",0,1,1,0
1991,101584,"Keith Evans",0,1,1,0
1991,101585,"Fabio Silberberg",0,2,2,0
1991,101588,"Jason Netter",0,1,1,0
1991,101616,"Serge Soulie",0,1,1,0
1991,101632,"Per Henricsson",0,1,1,0
1991,101670,"Martin Schaffl",0,1,1,0
1991,101672,"Michael Geserer",0,1,1,0
1991,101681,"Chris Wilkinson",0,2,2,0
1991,101682,"David Adams",0,1,1,0
1991,101685,"Markus Naewie",0,2,2,0
1991,101691,"Florian Krumrey",0,1,1,0
1991,101696,"Federico Mordegan",0,1,1,0
1991,101722,"Han Cheol Shin",0,1,1,0
1991,101765,"Tomas Anzari",0,4,4,0
1991,101844,"Heath Denman",0,1,1,0
1991,101847,"Bret Richardson",0,1,1,0
1991,101851,"Alexis Hombrecher",0,2,2,0
1991,101876,"Massimo Ardinghi",0,1,1,0
1991,101877,"Milan Trneny",0,1,1,0
1991,101886,"Ohad Weinberg",0,1,1,0
1991,101906,"Yasufumi Yamamoto",0,2,2,0
1991,101926,"Andrei Merinov",0,1,1,0
1991,101945,"Thierry Guardiola",0,4,4,0
1991,101953,"Kentaro Masuda",0,1,1,0
1991,101957,"Milen Velev",0,1,1,0
1991,102026,"Jan Kodes Jr",0,1,1,0
1991,102031,"Sandor Noszaly",0,1,1,0
1991,102035,"Jonas Bjorkman",0,1,1,0
1991,102055,"Bertrand Madsen",0,2,2,0
1991,102067,"Emanuel Rasberger",0,1,1,0
1991,102085,"Sasa Hirszon",0,1,1,0
1991,102090,"Ofer Sela",0,1,1,0
1991,102118,"Radomir Vasek",0,1,1,0
1991,102132,"Ivan Baron",0,1,1,0
1991,102147,"Oliver Fernandez",0,2,2,0
1991,102158,"Patrick Rafter",0,1,1,0
1991,102171,"Reinhard Wawra",0,1,1,0
1991,102247,"Andrea Gaudenzi",0,3,3,0
1991,102250,"Emanuel Couto",0,1,1,0
1991,102304,"Grant Doyle",0,1,1,0
1991,102378,"Juan Gisbert Jr",0,1,1,0
1991,102394,"Johan Van Herck",0,1,1,0
1991,106670,"Bruce Steel",0,1,1,0
1991,107201,"Hidehiko Tanizawa",0,1,1,0
1991,107375,"John Arbanas",0,1,1,0
1991,107607,"Lukas Thomas",0,1,1,0
1991,108008,"Phillip Williamson",0,1,1,0
1991,108136,"Roberto Raffa",0,1,1,0
1991,108147,"Rodrigo Faria",0,1,1,0
1991,108227,"Sebastian Soresini",0,1,1,0
1991,108235,"Sergej Skakun",0,1,1,0
1991,108263,"Silvio Moine",0,1,1,0
1991,108520,"William Kyriakos",0,1,1,0
1992,100282,"Guillermo Vilas",0,2,2,0
1992,100431,"Mansour Bahrami",0,2,2,0
1992,100437,"Bjorn Borg",0,8,8,0
1992,100532,"Johan Kriek",0,1,1,0
1992,100553,"Nduka Odizor",0,2,2,0
1992,100689,"Tim Mayotte",0,1,1,0
1992,100714,"Broderick Dyke",0,2,2,0
1992,100727,"Raul Antonio Viver",0,5,5,0
1992,100728,"Todd Nelson",0,1,1,0
1992,100744,"Peter Doohan",0,1,1,0
1992,100836,"Glenn Michibata",0,1,1,0
1992,100857,"Sergio Casal",0,2,2,0
1992,100864,"Martin Wostenholme",0,1,1,0
1992,100866,"Shahar Perkiss",0,1,1,0
1992,100876,"Bong Soo Kim",0,1,1,0
1992,100904,"George Bezecny",0,1,1,0
1992,100926,"Ken Flach",0,1,1,0
1992,100946,"Slobodan Zivojinovic",0,1,1,0
1992,100950,"Libor Pimek",0,1,1,0
1992,100978,"Andrew Castle",0,3,3,0
1992,100997,"Roger Smith",0,2,2,0
1992,101004,"Jim Pugh",0,1,1,0
1992,101009,"John Sobel",0,1,1,0
1992,101048,"Francisco Maciel",0,1,1,0
1992,101083,"Tom Mercer",0,1,1,0
1992,101097,"Rick Leach",0,3,3,0
1992,101109,"Tarik Benhabiles",0,1,1,0
1992,101110,"David De Miguel",0,1,1,0
1992,101119,"Marian Vajda",0,8,8,0
1992,101128,"Michael Walker",0,1,1,0
1992,101238,"Andres Vysand",0,4,4,0
1992,101248,"Pat Crow",0,1,1,0
1992,101250,"Jose Daher",0,1,1,0
1992,101256,"Mark Kratzmann",0,1,1,0
1992,101280,"Mikael Stadling",0,2,2,0
1992,101281,"Shelby Cannon",0,1,1,0
1992,101295,"Toshihisa Tsuchihashi",0,1,1,0
1992,101299,"Sven Salumaa",0,1,1,0
1992,101308,"Neil Broad",0,1,1,0
1992,101316,"Juan Rios",0,1,1,0
1992,101321,"Juan Carlos Baguena",0,2,2,0
1992,101324,"Ulf Stenlund",0,1,1,0
1992,101327,"Cyril Suk",0,2,2,0
1992,101329,"Christer Allgardh",0,1,1,0
1992,101338,"Olivier Soules",0,4,4,0
1992,101352,"Jae Sik Kim",0,1,1,0
1992,101360,"Mark Keil",0,1,1,0
1992,101365,"Paul Wekesa",0,1,1,0
1992,101413,"Felix Barrientos",0,1,1,0
1992,101420,"Vaclav Roubicek",0,3,3,0
1992,101430,"Sergio Cortes",0,1,1,0
1992,101437,"Seung Ho Ji",0,1,1,0
1992,101441,"Martin Sinner",0,1,1,0
1992,101448,"Tasos Bavelas",0,1,1,0
1992,101477,"Chris Bailey",0,1,1,0
1992,101490,"Daniel Orsanic",0,2,2,0
1992,101531,"Mario Visconti",0,1,1,0
1992,101536,"Murphy Jensen",0,1,1,0
1992,101544,"Marcos Perez Hubert",0,1,1,0
1992,101566,"Fabien Cousin",0,1,1,0
1992,101567,"Hendrik Jan Davids",0,4,4,0
1992,101576,"Ryuso Tsujino",0,2,2,0
1992,101581,"Jose Luis Aparisi",0,2,2,0
1992,101591,"Danny Sapsford",0,1,1,0
1992,101608,"Tom Kempers",0,1,1,0
1992,101612,"Roland Burtscher",0,1,1,0
1992,101651,"Owen Casey",0,1,1,0
1992,101661,"Nicolas Becerra",0,2,2,0
1992,101668,"Peter Nyborg",0,2,2,0
1992,101672,"Michael Geserer",0,1,1,0
1992,101682,"David Adams",0,1,1,0
1992,101704,"Ellis Ferreira",0,1,1,0
1992,101728,"Laszlo Markovits",0,1,1,0
1992,101732,"Pietro Pennisi",0,1,1,0
1992,101740,"Sascha Nensel",0,2,2,0
1992,101764,"Yu Hui Lien",0,1,1,0
1992,101779,"Pavel Vizner",0,1,1,0
1992,101809,"Nicolas Pereira",0,1,1,0
1992,101823,"Gerald Mandl",0,1,1,0
1992,101857,"Jason Cask",0,1,1,0
1992,101863,"Roberto Alvarez",0,1,1,0
1992,101868,"Dick Norman",0,1,1,0
1992,101876,"Massimo Ardinghi",0,2,2,0
1992,101892,"Axel Finnberg",0,1,1,0
1992,101906,"Yasufumi Yamamoto",0,1,1,0
1992,101938,"Bernardo Mota",0,2,2,0
1992,101953,"Kentaro Masuda",0,1,1,0
1992,101971,"Johan Anderson",0,1,1,0
1992,101982,"Jordi Mas",0,1,1,0
1992,101983,"Andrew Kratzmann",0,1,1,0
1992,102010,"Clinton Marsh",0,2,2,0
1992,102026,"Jan Kodes Jr",0,1,1,0
1992,102028,"Massimo Valeri",0,4,4,0
1992,102030,"Andrew Foster",0,1,1,0
1992,102035,"Jonas Bjorkman",0,1,1,0
1992,102069,"Andrei Rybalko",0,1,1,0
1992,102104,"Christian Ruud",0,2,2,0
1992,102118,"Radomir Vasek",0,1,1,0
1992,102119,"Chih Jung Chen",0,1,1,0
1992,102132,"Ivan Baron",0,1,1,0
1992,102139,"Eyal Ran",0,1,1,0
1992,102158,"Patrick Rafter",0,3,3,0
1992,102169,"Michael Joyce",0,1,1,0
1992,102178,"Scott Gessner",0,1,1,0
1992,102187,"John Laffnie De Jager",0,2,2,0
1992,102198,"Paul Kilderry",0,2,2,0
1992,102219,"Juan Garat",0,1,1,0
1992,102223,"Karim Alami",0,3,3,0
1992,102226,"David Witt",0,2,2,0
1992,102233,"Leander Paes",0,1,1,0
1992,102250,"Emanuel Couto",0,1,1,0
1992,102318,"Andrei Pavel",0,2,2,0
1992,102344,"Karol Kucera",0,1,1,0
1992,102348,"Hideki Kaneko",0,1,1,0
1992,102359,"Andrew Richardson",0,1,1,0
1992,102382,"Julian Knowle",0,1,1,0
1992,102454,"Hyeong Keun Song",0,1,1,0
1992,102478,"Jorg Schors",0,1,1,0
1992,102491,"Alex Radulescu",0,1,1,0
1992,102524,"Neville Godwin",0,1,1,0
1992,102536,"James Greenhalgh",0,2,2,0
1992,102615,"Dennis Van Scheppingen",0,1,1,0
1992,102796,"Magnus Norman",0,1,1,0
1992,106493,"Alexander Windisch",0,1,1,0
1992,106527,"Andreas Fikas",0,1,1,0
1992,106718,"Cheng Fong Chang",0,1,1,0
1992,106874,"Dick Bosse",0,1,1,0
1992,107022,"Francesco Michelotti",0,2,2,0
1992,107093,"Gil Kovalski",0,1,1,0
1992,107201,"Hidehiko Tanizawa",0,1,1,0
1992,107460,"Juan Pablo Etchecoin",0,1,1,0
1992,108277,"Srdan Muskatirovic",0,1,1,0
1992,108354,"Talito Corrales",0,1,1,0
1992,108378,"Thierry Van Den Daele",0,1,1,0
1992,108390,"Thomas Prerovsky",0,1,1,0
1993,100321,"Vijay Amritraj",0,1,1,0
1993,100437,"Bjorn Borg",0,3,3,0
1993,100529,"Kevin Curren",0,1,1,0
1993,100619,"George Kalovelonis",0,1,1,0
1993,100631,"Tim Wilkison",0,1,1,0
1993,100652,"Cassio Motta",0,1,1,0
1993,100714,"Broderick Dyke",0,2,2,0
1993,100727,"Raul Antonio Viver",0,1,1,0
1993,100773,"Brian Joelson",0,1,1,0
1993,100832,"Constantinos Efremoglou",0,1,1,0
1993,100876,"Bong Soo Kim",0,2,2,0
1993,100901,"Paul Annacone",0,1,1,0
1993,100924,"Jorge Lozano",0,1,1,0
1993,100943,"Girts Dzelde",0,1,1,0
1993,100962,"Thomas Hogstedt",0,2,2,0
1993,100970,"Stefan Eriksson",0,1,1,0
1993,101031,"Massimo Cierro",0,1,1,0
1993,101083,"Tom Mercer",0,1,1,0
1993,101106,"Peter Lundgren",0,1,1,0
1993,101108,"Richard Schmidt",0,1,1,0
1993,101119,"Marian Vajda",0,2,2,0
1993,101174,"Fernando Roese",0,4,4,0
1993,101184,"Damir Buljevic",0,1,1,0
1993,101205,"Grant Connell",0,1,1,0
1993,101232,"Nicklas Kroon",0,1,1,0
1993,101237,"Danilo Marcelino",0,1,1,0
1993,101242,"Brad Pearce",0,3,3,0
1993,101244,"Johan Donar",0,1,1,0
1993,101260,"Sean Cole",0,1,1,0
1993,101263,"Luke Jensen",0,2,2,0
1993,101274,"Udo Riglewski",0,1,1,0
1993,101280,"Mikael Stadling",0,1,1,0
1993,101281,"Shelby Cannon",0,1,1,0
1993,101308,"Neil Broad",0,1,1,0
1993,101329,"Christer Allgardh",0,2,2,0
1993,101349,"Adam Malik",0,1,1,0
1993,101364,"Bret Garnett",0,4,4,0
1993,101367,"Igor Saric",0,1,1,0
1993,101383,"Stephane Sansoni",0,3,3,0
1993,101420,"Vaclav Roubicek",0,1,1,0
1993,101440,"Mark Koevermans",0,5,5,0
1993,101448,"Tasos Bavelas",0,1,1,0
1993,101472,"Tino Anda",0,1,1,0
1993,101492,"Sander Groen",0,3,3,0
1993,101536,"Murphy Jensen",0,1,1,0
1993,101565,"Marius Barnard",0,1,1,0
1993,101567,"Hendrik Jan Davids",0,3,3,0
1993,101573,"Carl Chang",0,2,2,0
1993,101574,"Alejandro Aramburu",0,1,1,0
1993,101577,"Jia Ping Xia",0,2,2,0
1993,101590,"Eui Jong Chang",0,1,1,0
1993,101596,"Mohamed Ridaoui",0,1,1,0
1993,101597,"Louis Gloria",0,2,2,0
1993,101654,"Michael Shyjan",0,1,1,0
1993,101670,"Martin Schaffl",0,1,1,0
1993,101672,"Michael Geserer",0,1,1,0
1993,101687,"David Dilucia",0,6,6,0
1993,101701,"Bing Pan",0,1,1,0
1993,101704,"Ellis Ferreira",0,1,1,0
1993,101715,"Jose Antonio Pepe Conde",0,1,1,0
1993,101731,"Nuno Marques",0,1,1,0
1993,101732,"Pietro Pennisi",0,1,1,0
1993,101765,"Tomas Anzari",0,3,3,0
1993,101771,"Ashley Naumann",0,1,1,0
1993,101775,"Frederik Fetterlein",0,2,2,0
1993,101780,"Alejo Mancisidor",0,6,6,0
1993,101802,"Ramayah Ramachandran",0,2,2,0
1993,101815,"Sergio Gomez Barrio",0,1,1,0
1993,101819,"Frederic Vitoux",0,1,1,0
1993,101865,"Albert Chang",0,2,2,0
1993,101869,"Juan Luis Tati Rascon",0,2,2,0
1993,101874,"Ciprian Petre Porumb",0,1,1,0
1993,101906,"Yasufumi Yamamoto",0,4,4,0
1993,101937,"Robbie Koenig",0,1,1,0
1993,101938,"Bernardo Mota",0,1,1,0
1993,101945,"Thierry Guardiola",0,3,3,0
1993,101957,"Milen Velev",0,3,3,0
1993,101958,"Pierre Bouteyre",0,1,1,0
1993,101982,"Jordi Mas",0,1,1,0
1993,101989,"Patrik Langvardt",0,1,1,0
1993,102001,"German Lopez",0,1,1,0
1993,102005,"Johan De Beer",0,2,2,0
1993,102025,"Mikael Tillstrom",0,3,3,0
1993,102062,"Guillaume Marx",0,2,2,0
1993,102067,"Emanuel Rasberger",0,1,1,0
1993,102103,"Michael Sell",0,1,1,0
1993,102118,"Radomir Vasek",0,1,1,0
1993,102132,"Ivan Baron",0,3,3,0
1993,102161,"Robert Kroll",0,1,1,0
1993,102173,"Rainer Falenti",0,1,1,0
1993,102178,"Scott Gessner",0,1,1,0
1993,102201,"Lionel Roux",0,4,4,0
1993,102219,"Juan Garat",0,1,1,0
1993,102234,"Oliver Gross",0,1,1,0
1993,102277,"Bing Chao Lin",0,2,2,0
1993,102286,"Wayne Black",0,1,1,0
1993,102287,"Albert Portas",0,1,1,0
1993,102293,"Xavier Avila",0,1,1,0
1993,102300,"Gouichi Motomura",0,3,3,0
1993,102304,"Grant Doyle",0,6,6,0
1993,102382,"Julian Knowle",0,1,1,0
1993,102417,"Steven Baldas",0,1,1,0
1993,102529,"Thomas Shimada",0,1,1,0
1993,102536,"James Greenhalgh",0,1,1,0
1993,102539,"Bohdan Ulihrach",0,1,1,0
1993,102615,"Dennis Van Scheppingen",0,1,1,0
1993,102667,"Satoshi Iwabuchi",0,1,1,0
1993,102669,"Noam Behr",0,1,1,0
1993,102687,"Herbert Wiltschnig",0,1,1,0
1993,102760,"Rene Nicklisch",0,1,1,0
1993,102765,"Nicolas Escude",0,1,1,0
1993,102795,"Scott Humphries",0,1,1,0
1993,102824,"John Roddick",0,1,1,0
1993,102834,"Paul Goldstein",0,1,1,0
1993,102843,"Suwandi Suwandi",0,1,1,0
1993,103009,"Razvan Sabau",0,1,1,0
1993,106539,"Andrew Mclean",0,1,1,0
1993,106741,"Christian Camradt",0,1,1,0
1993,108008,"Phillip Williamson",0,1,1,0
1993,108390,"Thomas Prerovsky",0,1,1,0
1993,108429,"Tony Bujan",0,1,1,0
1994,100581,"John McEnroe",0,1,1,0
1994,100619,"George Kalovelonis",0,1,1,0
1994,100713,"John Fitzgerald",0,1,1,0
1994,100772,"Kelly Evernden",0,1,1,0
1994,100800,"Diego Perez",0,1,1,0
1994,100852,"Howard Herr",0,1,1,0
1994,100855,"Scott Davis",0,1,1,0
1994,100944,"Mikael Pernfors",0,7,7,0
1994,101022,"Kelly Jones",0,1,1,0
1994,101035,"Menno Oosting",0,1,1,0
1994,101071,"Tom Nijssen",0,4,4,0
1994,101119,"Marian Vajda",0,2,2,0
1994,101126,"Chris Pridham",0,1,1,0
1994,101138,"Pat Cash",0,2,2,0
1994,101145,"Jonathan Canter",0,3,3,0
1994,101167,"Jaime Cortes",0,1,1,0
1994,101226,"Johan Carlsson",0,1,1,0
1994,101231,"Ryan Blake",0,1,1,0
1994,101242,"Brad Pearce",0,1,1,0
1994,101263,"Luke Jensen",0,1,1,0
1994,101274,"Udo Riglewski",0,1,1,0
1994,101280,"Mikael Stadling",0,2,2,0
1994,101317,"John Sullivan",0,1,1,0
1994,101327,"Cyril Suk",0,2,2,0
1994,101353,"Lionel Barthez",0,3,3,0
1994,101354,"Andrew Sznajder",0,2,2,0
1994,101360,"Mark Keil",0,1,1,0
1994,101365,"Paul Wekesa",0,1,1,0
1994,101374,"Leonardo Lavalle",0,2,2,0
1994,101375,"Brian Devening",0,1,1,0
1994,101386,"Glenn Wilson",0,1,1,0
1994,101418,"Herve Grenier",0,1,1,0
1994,101444,"Bonit Wiryawan",0,1,1,0
1994,101484,"Vladimir Gabrichidze",0,1,1,0
1994,101502,"Torben Theine",0,1,1,0
1994,101512,"Trevor Kronemann",0,1,1,0
1994,101522,"Chi Wan Kim",0,1,1,0
1994,101531,"Mario Visconti",0,1,1,0
1994,101565,"Marius Barnard",0,1,1,0
1994,101574,"Alejandro Aramburu",0,1,1,0
1994,101576,"Ryuso Tsujino",0,3,3,0
1994,101577,"Jia Ping Xia",0,1,1,0
1994,101584,"Keith Evans",0,1,1,0
1994,101590,"Eui Jong Chang",0,2,2,0
1994,101593,"Chris Garner",0,2,2,0
1994,101596,"Mohamed Ridaoui",0,1,1,0
1994,101629,"Matt Lucena",0,1,1,0
1994,101641,"Jose Luis Noriega",0,2,2,0
1994,101672,"Michael Geserer",0,1,1,0
1994,101675,"Martin Rodriguez",0,1,1,0
1994,101687,"David Dilucia",0,1,1,0
1994,101688,"Geoff Grant",0,1,1,0
1994,101699,"Alois Beust",0,1,1,0
1994,101701,"Bing Pan",0,1,1,0
1994,101710,"Martin Blackman",0,5,5,0
1994,101731,"Nuno Marques",0,4,4,0
1994,101765,"Tomas Anzari",0,1,1,0
1994,101775,"Frederik Fetterlein",0,1,1,0
1994,101779,"Pavel Vizner",0,1,1,0
1994,101819,"Frederic Vitoux",0,1,1,0
1994,101821,"Peter Tramacchi",0,3,3,0
1994,101871,"Alexander Reichel",0,2,2,0
1994,101902,"Stephane Huet",0,1,1,0
1994,101906,"Yasufumi Yamamoto",0,2,2,0
1994,101937,"Robbie Koenig",0,2,2,0
1994,101938,"Bernardo Mota",0,1,1,0
1994,101953,"Kentaro Masuda",0,1,1,0
1994,101955,"Luis Herrera",0,2,2,0
1994,101957,"Milen Velev",0,3,3,0
1994,101959,"Robert Eriksson",0,1,1,0
1994,101961,"Martin Stringari",0,1,1,0
1994,101973,"Viktor Nagy",0,1,1,0
1994,101977,"Patricio Arnold",0,7,7,0
1994,101983,"Andrew Kratzmann",0,1,1,0
1994,102001,"German Lopez",0,1,1,0
1994,102010,"Clinton Marsh",0,1,1,0
1994,102018,"Tamer El Sawy",0,2,2,0
1994,102019,"Dirk Dier",0,3,3,0
1994,102042,"Brandon Coupe",0,1,1,0
1994,102047,"Pier Gauthier",0,1,1,0
1994,102050,"Marco Meneschincheri",0,2,2,0
1994,102061,"Kevin Ullyett",0,6,6,0
1994,102067,"Emanuel Rasberger",0,1,1,0
1994,102076,"Mark Merklein",0,2,2,0
1994,102083,"Nick Gould",0,1,1,0
1994,102085,"Sasa Hirszon",0,1,1,0
1994,102087,"Oleg Ogorodov",0,1,1,0
1994,102090,"Ofer Sela",0,1,1,0
1994,102106,"Davide Sanguinetti",0,2,2,0
1994,102113,"Daniele Musa",0,2,2,0
1994,102117,"Eduardo Nicolas",0,1,1,0
1994,102132,"Ivan Baron",0,1,1,0
1994,102133,"Laurence Tieleman",0,1,1,0
1994,102139,"Eyal Ran",0,1,1,0
1994,102152,"Pablo Campana",0,1,1,0
1994,102153,"German Puentes",0,3,3,0
1994,102161,"Robert Kroll",0,1,1,0
1994,102162,"Chris Woodruff",0,2,2,0
1994,102192,"Luis Adrian Morejon",0,1,1,0
1994,102203,"Jonathan Leach",0,1,1,0
1994,102206,"Stephane Matheu",0,1,1,0
1994,102214,"Oscar Ortiz",0,3,3,0
1994,102231,"Alex Calatrava",0,1,1,0
1994,102263,"Yong Il Yoon",0,1,1,0
1994,102271,"Hicham Arazi",0,1,1,0
1994,102282,"Tetsuya Chaen",0,1,1,0
1994,102300,"Gouichi Motomura",0,1,1,0
1994,102304,"Grant Doyle",0,3,3,0
1994,102316,"Jong Woong Yoon",0,1,1,0
1994,102382,"Julian Knowle",0,1,1,0
1994,102443,"Barry Cowan",0,1,1,0
1994,102455,"Lorenzo Manta",0,1,1,0
1994,102456,"Felix Mantilla",0,1,1,0
1994,102457,"Miles Maclagan",0,1,1,0
1994,102465,"Gabriel Silberstein",0,1,1,0
1994,102469,"Solon Peppas",0,1,1,0
1994,102490,"Pantelis Moschoutis",0,1,1,0
1994,102524,"Neville Godwin",0,1,1,0
1994,102529,"Thomas Shimada",0,1,1,0
1994,102533,"Jens Knippschild",0,1,1,0
1994,102539,"Bohdan Ulihrach",0,1,1,0
1994,102562,"Jiri Novak",0,1,1,0
1994,102563,"Thomas Johansson",0,2,2,0
1994,102596,"Christian Hill",0,1,1,0
1994,102652,"Christian Vinck",0,2,2,0
1994,102654,"Steven Downs",0,1,1,0
1994,102694,"Lars Burgsmuller",0,2,2,0
1994,102743,"Ben Ellwood",0,1,1,0
1994,102768,"Federico Browne",0,1,1,0
1994,102791,"Bobby Kokavec",0,1,1,0
1994,102831,"Jacobo Diaz",0,1,1,0
1994,102834,"Paul Goldstein",0,1,1,0
1994,102843,"Suwandi Suwandi",0,1,1,0
1994,102869,"Galo Blanco",0,1,1,0
1994,102903,"Eyal Erlich",0,1,1,0
1994,102905,"Stefan Koubek",0,1,1,0
1994,103017,"Nicolas Kiefer",0,1,1,0
1994,103029,"Mehdi Tahiri",0,1,1,0
1994,103059,"Radovan Chrz",0,1,1,0
1994,103182,"Markus Hipfl",0,1,1,0
1994,106906,"Dusan Prchlik",0,1,1,0
1994,108229,"Sebastien Hette",0,1,1,0
1994,108297,"Stephane Andriolo",0,1,1,0
1994,108443,"Toshitsugu Mori",0,2,2,0
1994,108995,"Otakar Jurecka",0,1,1,0
1995,100606,"Mike Bauer",0,1,1,0
1995,100713,"John Fitzgerald",0,1,1,0
1995,100815,"David Pate",0,1,1,0
1995,100857,"Sergio Casal",0,1,1,0
1995,100870,"Christo Van Rensburg",0,2,2,0
1995,100926,"Ken Flach",0,1,1,0
1995,100944,"Mikael Pernfors",0,1,1,0
1995,100997,"Roger Smith",0,2,2,0
1995,101004,"Jim Pugh",0,2,2,0
1995,101016,"Marcos Aurelio Gorriz",0,3,3,0
1995,101022,"Kelly Jones",0,1,1,0
1995,101027,"Jaroslav Bulant",0,2,2,0
1995,101066,"Richard Matuszewski",0,1,1,0
1995,101071,"Tom Nijssen",0,1,1,0
1995,101096,"Gary Muller",0,1,1,0
1995,101124,"Paolo Cane",0,1,1,0
1995,101205,"Grant Connell",0,3,3,0
1995,101270,"Thomas Gollwitzer",0,1,1,0
1995,101279,"Philippe Pech",0,1,1,0
1995,101284,"Lars Anders Wahlgren",0,1,1,0
1995,101298,"Jonas Svensson",0,1,1,0
1995,101312,"Robbie Weiss",0,1,1,0
1995,101332,"Gilad Bloom",0,1,1,0
1995,101339,"Agustin Moreno",0,1,1,0
1995,101341,"Pablo Albano",0,1,1,0
1995,101349,"Adam Malik",0,1,1,0
1995,101354,"Andrew Sznajder",0,5,5,0
1995,101362,"Stephane Simian",0,2,2,0
1995,101368,"Christian Miniussi",0,1,1,0
1995,101398,"Neil Borwick",0,1,1,0
1995,101407,"David Engel",0,1,1,0
1995,101416,"Joao Cunha Silva",0,1,1,0
1995,101417,"Mario Rincon",0,3,3,0
1995,101424,"Brent Haygarth",0,1,1,0
1995,101436,"George Cosac",0,1,1,0
1995,101444,"Bonit Wiryawan",0,1,1,0
1995,101459,"Tomas Nydahl",0,2,2,0
1995,101462,"Francisco Roig",0,3,3,0
1995,101490,"Daniel Orsanic",0,1,1,0
1995,101536,"Murphy Jensen",0,1,1,0
1995,101561,"Nicklas Utgren",0,2,2,0
1995,101573,"Carl Chang",0,1,1,0
1995,101577,"Jia Ping Xia",0,1,1,0
1995,101590,"Eui Jong Chang",0,1,1,0
1995,101596,"Mohamed Ridaoui",0,1,1,0
1995,101600,"Daniel Courcol",0,2,2,0
1995,101608,"Tom Kempers",0,1,1,0
1995,101617,"Dennis Schmid",0,1,1,0
1995,101625,"Steve Herdoiza",0,1,1,0
1995,101630,"Clement Ngoran",0,1,1,0
1995,101662,"Selvam Veerasingam",0,1,1,0
1995,101669,"Gary Henderson",0,1,1,0
1995,101687,"David Dilucia",0,1,1,0
1995,101719,"Frederic Fontang",0,2,2,0
1995,101730,"Piet Norval",0,1,1,0
1995,101745,"Roberto Jabali",0,1,1,0
1995,101751,"Ross Matheson",0,1,1,0
1995,101766,"Bill Behrens",0,1,1,0
1995,101771,"Ashley Naumann",0,1,1,0
1995,101788,"Doug Flach",0,1,1,0
1995,101800,"Daniele Balducci",0,1,1,0
1995,101814,"Colin Beecher",0,1,1,0
1995,101819,"Frederic Vitoux",0,2,2,0
1995,101821,"Peter Tramacchi",0,1,1,0
1995,101841,"Aleksandar Kitinov",0,1,1,0
1995,101849,"Nicola Bruno",0,2,2,0
1995,101858,"Gilles Bastie",0,1,1,0
1995,101861,"Thomas Buchmayer",0,1,1,0
1995,101862,"Maurice Ruah",0,1,1,0
1995,101893,"Patrick Mohr",0,1,1,0
1995,101970,"Iztok Bozic",0,1,1,0
1995,101989,"Patrik Langvardt",0,1,1,0
1995,101994,"Remus Farcas",0,1,1,0
1995,102006,"Brent Larkham",0,1,1,0
1995,102010,"Clinton Marsh",0,1,1,0
1995,102015,"Tomislav Prpic",0,1,1,0
1995,102023,"Petr Luxa",0,1,1,0
1995,102047,"Pier Gauthier",0,1,1,0
1995,102050,"Marco Meneschincheri",0,2,2,0
1995,102060,"Ignacio Martinez",0,2,2,0
1995,102067,"Emanuel Rasberger",0,1,1,0
1995,102076,"Mark Merklein",0,1,1,0
1995,102081,"Brett Hansen Dent",0,1,1,0
1995,102083,"Nick Gould",0,1,1,0
1995,102090,"Ofer Sela",0,1,1,0
1995,102106,"Davide Sanguinetti",0,3,3,0
1995,102167,"Juan Albert Viloca Puig",0,8,8,0
1995,102207,"Jan Weinzierl",0,1,1,0
1995,102208,"Rob Givone",0,2,2,0
1995,102214,"Oscar Ortiz",0,3,3,0
1995,102215,"Joshua Eagle",0,1,1,0
1995,102220,"Patrik Fredriksson",0,1,1,0
1995,102226,"David Witt",0,1,1,0
1995,102231,"Alex Calatrava",0,1,1,0
1995,102263,"Yong Il Yoon",0,2,2,0
1995,102269,"Jeff Salzenstein",0,2,2,0
1995,102277,"Bing Chao Lin",0,1,1,0
1995,102348,"Hideki Kaneko",0,1,1,0
1995,102354,"Jerome Hanquez",0,2,2,0
1995,102359,"Andrew Richardson",0,2,2,0
1995,102365,"Donny Susetyo",0,1,1,0
1995,102373,"Toshiaki Sakai",0,1,1,0
1995,102405,"Mahesh Bhupathi",0,1,1,0
1995,102430,"Adam Peterson",0,1,1,0
1995,102443,"Barry Cowan",0,1,1,0
1995,102455,"Lorenzo Manta",0,3,3,0
1995,102465,"Gabriel Silberstein",0,3,3,0
1995,102536,"James Greenhalgh",0,1,1,0
1995,102556,"Claude Ngoran",0,1,1,0
1995,102572,"Igor Gaudi",0,1,1,0
1995,102581,"Goran Oresic",0,1,1,0
1995,102600,"David Miketa",0,1,1,0
1995,102624,"Andrew Painter",0,1,1,0
1995,102667,"Satoshi Iwabuchi",0,1,1,0
1995,102687,"Herbert Wiltschnig",0,2,2,0
1995,102743,"Ben Ellwood",0,2,2,0
1995,102753,"Wolfgang Schranz",0,1,1,0
1995,102783,"Rainer Schuettler",0,1,1,0
1995,102795,"Scott Humphries",0,6,6,0
1995,102834,"Paul Goldstein",0,1,1,0
1995,102843,"Suwandi Suwandi",0,1,1,0
1995,102863,"Takao Suzuki",0,2,2,0
1995,102872,"James Sekulov",0,1,1,0
1995,102903,"Eyal Erlich",0,3,3,0
1995,102998,"Jan Michael Gambill",0,1,1,0
1995,103029,"Mehdi Tahiri",0,1,1,0
1995,103110,"Daniele Bracciali",0,1,1,0
1995,103133,"Olivier Mutis",0,2,2,0
1995,103166,"Vladimir Voltchkov",0,1,1,0
1995,103182,"Markus Hipfl",0,1,1,0
1995,103216,"Clemens Trimmel",0,2,2,0
1995,107653,"Marco Cacopardo",0,1,1,0
1995,108214,"Scott Clark",0,1,1,0
1995,108995,"Otakar Jurecka",0,1,1,0
1996,100284,"Jimmy Connors",0,1,1,0
1996,100676,"Yannick Noah",0,1,1,0
1996,100837,"Jeremy Bates",0,3,3,0
1996,100936,"Henri Leconte",0,4,4,0
1996,100944,"Mikael Pernfors",0,1,1,0
1996,100955,"Yahiya Doumbia",0,1,1,0
1996,100997,"Roger Smith",0,1,1,0
1996,101030,"Goran Prpic",0,1,1,0
1996,101063,"Jordi Arrese",0,10,10,0
1996,101086,"Ronald Agenor",0,5,5,0
1996,101123,"Alexander Mronz",0,1,1,0
1996,101138,"Pat Cash",0,3,3,0
1996,101149,"Morten Christensen",0,1,1,0
1996,101224,"Kenny Thorne",0,2,2,0
1996,101280,"Mikael Stadling",0,1,1,0
1996,101311,"Kent Kinnear",0,2,2,0
1996,101341,"Pablo Albano",0,1,1,0
1996,101353,"Lionel Barthez",0,1,1,0
1996,101373,"Karsten Braasch",0,1,1,0
1996,101377,"Christian Bergstrom",0,1,1,0
1996,101381,"Aaron Krickstein",0,4,4,0
1996,101417,"Mario Rincon",0,2,2,0
1996,101430,"Sergio Cortes",0,1,1,0
1996,101485,"Tanakorn Srichaphan",0,1,1,0
1996,101492,"Sander Groen",0,3,3,0
1996,101495,"Miguel Tobon",0,1,1,0
1996,101549,"Rodolphe Gilbert",0,3,3,0
1996,101561,"Nicklas Utgren",0,1,1,0
1996,101573,"Carl Chang",0,1,1,0
1996,101575,"Sulistyo Wibowo",0,1,1,0
1996,101577,"Jia Ping Xia",0,2,2,0
1996,101597,"Louis Gloria",0,1,1,0
1996,101602,"Jack Waite",0,3,3,0
1996,101626,"Stephen Noteboom",0,1,1,0
1996,101668,"Peter Nyborg",0,1,1,0
1996,101672,"Michael Geserer",0,1,1,0
1996,101675,"Martin Rodriguez",0,1,1,0
1996,101682,"David Adams",0,2,2,0
1996,101686,"Franco Davin",0,1,1,0
1996,101701,"Bing Pan",0,2,2,0
1996,101721,"Markus Zillner",0,1,1,0
1996,101725,"Gabriel Markus",0,1,1,0
1996,101730,"Piet Norval",0,3,3,0
1996,101761,"Jaime Oncins",0,2,2,0
1996,101826,"Alex Lopez Moron",0,2,2,0
1996,101844,"Heath Denman",0,1,1,0
1996,101849,"Nicola Bruno",0,1,1,0
1996,101862,"Maurice Ruah",0,1,1,0
1996,101865,"Albert Chang",0,3,3,0
1996,101871,"Alexander Reichel",0,1,1,0
1996,101893,"Patrick Mohr",0,1,1,0
1996,101902,"Stephane Huet",0,1,1,0
1996,101906,"Yasufumi Yamamoto",0,1,1,0
1996,101920,"Jamie Morgan",0,1,1,0
1996,101926,"Andrei Merinov",0,1,1,0
1996,101931,"Marcus Hilpert",0,1,1,0
1996,101947,"Vincenzo Santopadre",0,1,1,0
1996,101989,"Patrik Langvardt",0,1,1,0
1996,102001,"German Lopez",0,1,1,0
1996,102023,"Petr Luxa",0,2,2,0
1996,102030,"Andrew Foster",0,1,1,0
1996,102050,"Marco Meneschincheri",0,1,1,0
1996,102061,"Kevin Ullyett",0,1,1,0
1996,102069,"Andrei Rybalko",0,2,2,0
1996,102076,"Mark Merklein",0,1,1,0
1996,102077,"Alexander Shvec",0,1,1,0
1996,102083,"Nick Gould",0,1,1,0
1996,102103,"Michael Sell",0,2,2,0
1996,102111,"Diego Del Rio",0,1,1,0
1996,102116,"Sang Hoon Lee",0,1,1,0
1996,102131,"Alistair Hunt",0,1,1,0
1996,102132,"Ivan Baron",0,1,1,0
1996,102153,"German Puentes",0,1,1,0
1996,102165,"Srinath Prahlad",0,1,1,0
1996,102180,"Charles Auffray",0,1,1,0
1996,102190,"Philippe Moggio",0,1,1,0
1996,102194,"Min Kyu Han",0,1,1,0
1996,102198,"Paul Kilderry",0,2,2,0
1996,102212,"Corrado Borroni",0,1,1,0
1996,102215,"Joshua Eagle",0,2,2,0
1996,102250,"Emanuel Couto",0,1,1,0
1996,102263,"Yong Il Yoon",0,1,1,0
1996,102276,"Sandeep Kirtane",0,1,1,0
1996,102285,"Nasser Ghanim Al Khulaifi",0,1,1,0
1996,102287,"Albert Portas",0,4,4,0
1996,102300,"Gouichi Motomura",0,1,1,0
1996,102301,"Sebastien Leblanc",0,2,2,0
1996,102304,"Grant Doyle",0,3,3,0
1996,102332,"Adolf Musil",0,1,1,0
1996,102347,"Dmitri Tomashevich",0,1,1,0
1996,102348,"Hideki Kaneko",0,2,2,0
1996,102354,"Jerome Hanquez",0,1,1,0
1996,102359,"Andrew Richardson",0,1,1,0
1996,102372,"Sule Ladipo",0,1,1,0
1996,102410,"David Caldwell",0,2,2,0
1996,102455,"Lorenzo Manta",0,2,2,0
1996,102464,"Todd Larkham",0,2,2,0
1996,102473,"Thomas Schiessling",0,1,1,0
1996,102497,"Mashiska Washington",0,2,2,0
1996,102528,"Carlos Drada",0,1,1,0
1996,102533,"Jens Knippschild",0,1,1,0
1996,102536,"James Greenhalgh",0,1,1,0
1996,102548,"Juan Antonio Marin",0,1,1,0
1996,102567,"George Bastl",0,1,1,0
1996,102574,"Gabriel Trifu",0,1,1,0
1996,102581,"Goran Oresic",0,1,1,0
1996,102588,"Lars Rehmann",0,1,1,0
1996,102600,"David Miketa",0,1,1,0
1996,102617,"Kim Tiilikainen",0,2,2,0
1996,102654,"Steven Downs",0,2,2,0
1996,102664,"Petr Pala",0,1,1,0
1996,102669,"Noam Behr",0,2,2,0
1996,102703,"Hyung Taik Lee",0,1,1,0
1996,102753,"Wolfgang Schranz",0,1,1,0
1996,102770,"John Van Lottum",0,2,2,0
1996,102785,"Glenn Weiner",0,1,1,0
1996,102795,"Scott Humphries",0,1,1,0
1996,102821,"Cecil Mamiit",0,4,4,0
1996,102832,"Andrian Raturandang",0,1,1,0
1996,102834,"Paul Goldstein",0,1,1,0
1996,102843,"Suwandi Suwandi",0,1,1,0
1996,102862,"Allen Belobrajdic",0,1,1,0
1996,102872,"James Sekulov",0,2,2,0
1996,102929,"Ryan Wolters",0,1,1,0
1996,102956,"Sultan Khalfan",0,1,1,0
1996,102966,"Fredrik Jonsson",0,1,1,0
1996,103018,"Max Mirnyi",0,2,2,0
1996,103031,"Julian Alonso",0,2,2,0
1996,103084,"Guillermo Canas",0,3,3,0
1996,103102,"John Hui",0,1,1,0
1996,103103,"Dominik Hrbaty",0,1,1,0
1996,103104,"Bjorn Rehnquist",0,1,1,0
1996,103114,"Martin Lee",0,2,2,0
1996,103133,"Olivier Mutis",0,1,1,0
1996,103164,"Artemi Tchernenko",0,1,1,0
1996,103167,"Jocelyn Robichaud",0,1,1,0
1996,103171,"Raemon Sluiter",0,1,1,0
1996,103193,"Peter Wessels",0,3,3,0
1996,103216,"Clemens Trimmel",0,1,1,0
1996,103240,"Kevin Kim",0,1,1,0
1996,108381,"Thomas Andersen",0,1,1,0
1996,108511,"Werner Hipfl",0,1,1,0
1996,108999,"Dan Cantwell",0,1,1,0
1997,100997,"Roger Smith",0,1,1,0
1997,101098,"Guy Forget",0,5,5,0
1997,101142,"Emilio Sanchez",0,4,4,0
1997,101249,"Andrei Olhovskiy",0,14,14,0
1997,101311,"Kent Kinnear",0,1,1,0
1997,101374,"Leonardo Lavalle",0,1,1,0
1997,101389,"Oren Motevassel",0,2,2,0
1997,101490,"Daniel Orsanic",0,1,1,0
1997,101534,"Libor Nemecek",0,1,1,0
1997,101536,"Murphy Jensen",0,1,1,0
1997,101573,"Carl Chang",0,1,1,0
1997,101577,"Jia Ping Xia",0,2,2,0
1997,101608,"Tom Kempers",0,1,1,0
1997,101636,"Wade Mcguire",0,2,2,0
1997,101654,"Michael Shyjan",0,1,1,0
1997,101660,"Francisco Montana",0,1,1,0
1997,101682,"David Adams",0,1,1,0
1997,101701,"Bing Pan",0,1,1,0
1997,101745,"Roberto Jabali",0,4,4,0
1997,101761,"Jaime Oncins",0,6,6,0
1997,101789,"Steve Bryan",0,8,8,0
1997,101809,"Nicolas Pereira",0,7,7,0
1997,101815,"Sergio Gomez Barrio",0,1,1,0
1997,101826,"Alex Lopez Moron",0,2,2,0
1997,101835,"Arne Thoms",0,1,1,0
1997,101862,"Maurice Ruah",0,1,1,0
1997,101865,"Albert Chang",0,1,1,0
1997,101871,"Alexander Reichel",0,2,2,0
1997,101902,"Stephane Huet",0,2,2,0
1997,101904,"Chris Haggard",0,1,1,0
1997,101906,"Yasufumi Yamamoto",0,1,1,0
1997,101924,"Stefano Pescosolido",0,2,2,0
1997,101929,"Joost Winnink",0,3,3,0
1997,101956,"Mark Knowles",0,5,5,0
1997,101989,"Patrik Langvardt",0,1,1,0
1997,102023,"Petr Luxa",0,2,2,0
1997,102028,"Massimo Valeri",0,1,1,0
1997,102036,"Marco Osorio",0,1,1,0
1997,102047,"Pier Gauthier",0,1,1,0
1997,102055,"Bertrand Madsen",0,1,1,0
1997,102067,"Emanuel Rasberger",0,1,1,0
1997,102069,"Andrei Rybalko",0,1,1,0
1997,102085,"Sasa Hirszon",0,5,5,0
1997,102113,"Daniele Musa",0,2,2,0
1997,102131,"Alistair Hunt",0,2,2,0
1997,102132,"Ivan Baron",0,1,1,0
1997,102133,"Laurence Tieleman",0,2,2,0
1997,102140,"Bruno Fragoso",0,1,1,0
1997,102143,"Nicolas Thomann",0,2,2,0
1997,102192,"Luis Adrian Morejon",0,1,1,0
1997,102210,"Rene Hanak",0,1,1,0
1997,102221,"Diego Lozano",0,1,1,0
1997,102224,"Miguel Pastura",0,1,1,0
1997,102256,"Nick Weal",0,1,1,0
1997,102273,"David Salvador Estepa",0,1,1,0
1997,102300,"Gouichi Motomura",0,2,2,0
1997,102323,"Regis Lavergne",0,2,2,0
1997,102339,"Kris Goossens",0,2,2,0
1997,102347,"Dmitri Tomashevich",0,1,1,0
1997,102354,"Jerome Hanquez",0,1,1,0
1997,102381,"Werner Eschauer",0,1,1,0
1997,102400,"Elia Grossi",0,1,1,0
1997,102410,"David Caldwell",0,3,3,0
1997,102416,"Reed Cordish",0,1,1,0
1997,102428,"Johan Hede",0,1,1,0
1997,102455,"Lorenzo Manta",0,1,1,0
1997,102473,"Thomas Schiessling",0,1,1,0
1997,102497,"Mashiska Washington",0,1,1,0
1997,102529,"Thomas Shimada",0,1,1,0
1997,102537,"Melvin Tong",0,1,1,0
1997,102538,"Tuomas Ketola",0,2,2,0
1997,102571,"Gregory Carraz",0,1,1,0
1997,102575,"Julien Chauvin",0,1,1,0
1997,102578,"Fredrik Bergh",0,1,1,0
1997,102588,"Lars Rehmann",0,1,1,0
1997,102623,"Thomas Larsen",0,1,1,0
1997,102629,"Oscar Burrieza",0,2,2,0
1997,102654,"Steven Downs",0,1,1,0
1997,102655,"Jimy Szymanski",0,1,1,0
1997,102667,"Satoshi Iwabuchi",0,2,2,0
1997,102687,"Herbert Wiltschnig",0,1,1,0
1997,102753,"Wolfgang Schranz",0,3,3,0
1997,102756,"Eduardo Rincon",0,1,1,0
1997,102777,"Larbi Rharnit",0,1,1,0
1997,102778,"Abdul Hamid Makhkamov",0,1,1,0
1997,102780,"Frederic Niemeyer",0,1,1,0
1997,102791,"Bobby Kokavec",0,1,1,0
1997,102795,"Scott Humphries",0,1,1,0
1997,102818,"Sergi Duran",0,2,2,0
1997,102835,"Luke Milligan",0,1,1,0
1997,102842,"Toby Mitchell",0,1,1,0
1997,102872,"James Sekulov",0,2,2,0
1997,102892,"Susheel Narla",0,1,1,0
1997,102912,"Igor Tchelychev",0,1,1,0
1997,102929,"Ryan Wolters",0,1,1,0
1997,102956,"Sultan Khalfan",0,1,1,0
1997,102961,"Nicklas Timfjord",0,1,1,0
1997,102965,"Jamie Delgado",0,1,1,0
1997,102966,"Fredrik Jonsson",0,1,1,0
1997,102983,"Henrik Andersson",0,1,1,0
1997,102996,"Franz Stauder",0,1,1,0
1997,102997,"Hermes Gamonal",0,1,1,0
1997,103007,"Mounir El Aarej",0,1,1,0
1997,103018,"Max Mirnyi",0,3,3,0
1997,103029,"Mehdi Tahiri",0,1,1,0
1997,103112,"Ruben Fernandez",0,1,1,0
1997,103118,"Ion Moldovan",0,2,2,0
1997,103133,"Olivier Mutis",0,1,1,0
1997,103151,"Mariano Zabaleta",0,6,6,0
1997,103154,"Jaymon Crabb",0,1,1,0
1997,103166,"Vladimir Voltchkov",0,1,1,0
1997,103167,"Jocelyn Robichaud",0,1,1,0
1997,103176,"David Sanchez",0,1,1,0
1997,103182,"Markus Hipfl",0,2,2,0
1997,103184,"Bob Bryan",0,1,1,0
1997,103185,"Mike Bryan",0,1,1,0
1997,103193,"Peter Wessels",0,2,2,0
1997,103206,"Sebastien Grosjean",0,5,5,0
1997,103297,"Alex Kim",0,1,1,0
1997,103305,"Daniel Elsner",0,3,3,0
1997,103318,"Zeljko Krajan",0,1,1,0
1997,103387,"Paradorn Srichaphan",0,1,1,0
1997,103405,"Rodolfo Rake",0,1,1,0
1997,103420,"Michal Tabara",0,2,2,0
1997,103454,"Nicolas Massu",0,1,1,0
1997,103457,"Petr Kralert",0,1,1,0
1997,103498,"Marat Safin",0,1,1,0
1997,103720,"Lleyton Hewitt",0,1,1,0
1997,108992,"Alexei Belov",0,1,1,0
1998,101249,"Andrei Olhovskiy",0,1,1,0
1998,101263,"Luke Jensen",0,1,1,0
1998,101362,"Stephane Simian",0,1,1,0
1998,101389,"Oren Motevassel",0,1,1,0
1998,101412,"Shuzo Matsuoka",0,1,1,0
1998,101479,"Tj Middleton",0,2,2,0
1998,101481,"Omar Camporese",0,1,1,0
1998,101490,"Daniel Orsanic",0,1,1,0
1998,101534,"Libor Nemecek",0,1,1,0
1998,101536,"Murphy Jensen",0,1,1,0
1998,101591,"Danny Sapsford",0,3,3,0
1998,101594,"Carsten Arriens",0,1,1,0
1998,101636,"Wade Mcguire",0,3,3,0
1998,101668,"Peter Nyborg",0,1,1,0
1998,101730,"Piet Norval",0,1,1,0
1998,101731,"Nuno Marques",0,1,1,0
1998,101745,"Roberto Jabali",0,1,1,0
1998,101772,"Andrei Cherkasov",0,3,3,0
1998,101775,"Frederik Fetterlein",0,1,1,0
1998,101783,"Mark Petchey",0,2,2,0
1998,101841,"Aleksandar Kitinov",0,1,1,0
1998,101868,"Dick Norman",0,3,3,0
1998,101869,"Juan Luis Tati Rascon",0,1,1,0
1998,101932,"Jared Palmer",0,3,3,0
1998,101938,"Bernardo Mota",0,1,1,0
1998,101945,"Thierry Guardiola",0,1,1,0
1998,101953,"Kentaro Masuda",0,1,1,0
1998,101969,"Orlin Stanoytchev",0,3,3,0
1998,101992,"Pietro Angelini",0,1,1,0
1998,102019,"Dirk Dier",0,1,1,0
1998,102023,"Petr Luxa",0,3,3,0
1998,102050,"Marco Meneschincheri",0,4,4,0
1998,102061,"Kevin Ullyett",0,1,1,0
1998,102067,"Emanuel Rasberger",0,1,1,0
1998,102076,"Mark Merklein",0,4,4,0
1998,102083,"Nick Gould",0,1,1,0
1998,102087,"Oleg Ogorodov",0,2,2,0
1998,102162,"Chris Woodruff",0,1,1,0
1998,102220,"Patrik Fredriksson",0,2,2,0
1998,102226,"David Witt",0,2,2,0
1998,102235,"Tommy Ho",0,1,1,0
1998,102250,"Emanuel Couto",0,1,1,0
1998,102263,"Yong Il Yoon",0,1,1,0
1998,102269,"Jeff Salzenstein",0,3,3,0
1998,102282,"Tetsuya Chaen",0,1,1,0
1998,102304,"Grant Doyle",0,1,1,0
1998,102347,"Dmitri Tomashevich",0,1,1,0
1998,102348,"Hideki Kaneko",0,1,1,0
1998,102405,"Mahesh Bhupathi",0,3,3,0
1998,102433,"Mose Navarra",0,1,1,0
1998,102443,"Barry Cowan",0,3,3,0
1998,102455,"Lorenzo Manta",0,1,1,0
1998,102457,"Miles Maclagan",0,1,1,0
1998,102491,"Alex Radulescu",0,7,7,0
1998,102502,"Paul Harsanyi",0,1,1,0
1998,102522,"Fabio Maggi",0,1,1,0
1998,102574,"Gabriel Trifu",0,2,2,0
1998,102577,"Steven Randjelovic",0,1,1,0
1998,102578,"Fredrik Bergh",0,1,1,0
1998,102668,"Tapio Nurminen",0,1,1,0
1998,102669,"Noam Behr",0,1,1,0
1998,102675,"Timur Ganiev",0,1,1,0
1998,102720,"Tomas Zib",0,1,1,0
1998,102734,"Lior Mor",0,1,1,0
1998,102768,"Federico Browne",0,1,1,0
1998,102769,"Andres Schneiter",0,1,1,0
1998,102772,"Yu Zhang",0,1,1,0
1998,102780,"Frederic Niemeyer",0,1,1,0
1998,102790,"Yu Zheng",0,1,1,0
1998,102795,"Scott Humphries",0,1,1,0
1998,102808,"Kalle Flygt",0,1,1,0
1998,102809,"Axel Pretzsch",0,1,1,0
1998,102821,"Cecil Mamiit",0,1,1,0
1998,102868,"Jonathan Printzlau",0,1,1,0
1998,102872,"James Sekulov",0,1,1,0
1998,102875,"Luke Smith",0,1,1,0
1998,102897,"Nir Welgreen",0,1,1,0
1998,102903,"Eyal Erlich",0,3,3,0
1998,102910,"Salvador Navarro",0,1,1,0
1998,102920,"Diego Hipperdinger",0,1,1,0
1998,102922,"Tomas Catar",0,1,1,0
1998,102956,"Sultan Khalfan",0,1,1,0
1998,102957,"Vadim Kutsenko",0,1,1,0
1998,102966,"Fredrik Jonsson",0,2,2,0
1998,102996,"Franz Stauder",0,1,1,0
1998,103007,"Mounir El Aarej",0,1,1,0
1998,103009,"Razvan Sabau",0,1,1,0
1998,103021,"Ricardo Schlachter",0,1,1,0
1998,103026,"Teo Susnjak",0,1,1,0
1998,103029,"Mehdi Tahiri",0,1,1,0
1998,103053,"Nikos Rovas",0,1,1,0
1998,103082,"Markus Hantschk",0,1,1,0
1998,103114,"Martin Lee",0,4,4,0
1998,103133,"Olivier Mutis",0,1,1,0
1998,103164,"Artemi Tchernenko",0,1,1,0
1998,103176,"David Sanchez",0,2,2,0
1998,103179,"Jurek Stasiak",0,1,1,0
1998,103188,"Michael Russell",0,2,2,0
1998,103216,"Clemens Trimmel",0,1,1,0
1998,103285,"Radek Stepanek",0,1,1,0
1998,103339,"Wesley Whitehouse",0,1,1,0
1998,103344,"Ivan Ljubicic",0,1,1,0
1998,103451,"Bjorn Phau",0,1,1,0
1998,103454,"Nicolas Massu",0,2,2,0
1998,103457,"Petr Kralert",0,1,1,0
1998,103475,"Thomas Messmer",0,1,1,0
1998,103484,"James Blake",0,1,1,0
1998,103487,"Federico Luzzi",0,1,1,0
1998,103632,"Luis Horna",0,1,1,0
1998,103714,"Andreas Vinciguerra",0,2,2,0
1998,103715,"Kirill Ivanov Smolensky",0,1,1,0
1998,103753,"Boris Bachert",0,1,1,0
1998,103852,"Feliciano Lopez",0,1,1,0
1998,108593,"Wing Luen Wong",0,1,1,0
1998,108994,"Andrew Park",0,1,1,0
1999,101230,"Andrei Chesnokov",0,1,1,0
1999,101389,"Oren Motevassel",0,1,1,0
1999,101462,"Francisco Roig",0,1,1,0
1999,101468,"Gerard Solves",0,2,2,0
1999,101507,"Tomas Carbonell",0,2,2,0
1999,101609,"David Wheaton",0,2,2,0
1999,101613,"Malivai Washington",0,2,2,0
1999,101659,"Jan Apell",0,1,1,0
1999,101687,"David Dilucia",0,1,1,0
1999,101805,"David Nainkin",0,1,1,0
1999,101816,"Steve Campbell",0,6,6,0
1999,101843,"Sergi Bruguera",0,1,1,0
1999,101860,"Mark Draper",0,2,2,0
1999,101866,"David Rikl",0,1,1,0
1999,101906,"Yasufumi Yamamoto",0,1,1,0
1999,101917,"Grant Stafford",0,3,3,0
1999,101945,"Thierry Guardiola",0,1,1,0
1999,101956,"Mark Knowles",0,3,3,0
1999,101997,"Marzio Martelli",0,2,2,0
1999,102002,"Davide Scala",0,2,2,0
1999,102053,"Brian Macphie",0,3,3,0
1999,102077,"Alexander Shvec",0,1,1,0
1999,102087,"Oleg Ogorodov",0,2,2,0
1999,102107,"Jan Frode Andersen",0,1,1,0
1999,102131,"Alistair Hunt",0,1,1,0
1999,102135,"Emilio Benfele Alvarez",0,1,1,0
1999,102139,"Eyal Ran",0,1,1,0
1999,102154,"Marcos Ondruska",0,2,2,0
1999,102168,"Hector Moretti",0,1,1,0
1999,102169,"Michael Joyce",0,1,1,0
1999,102180,"Charles Auffray",0,2,2,0
1999,102239,"Francisco Costa",0,1,1,0
1999,102347,"Dmitri Tomashevich",0,1,1,0
1999,102354,"Jerome Hanquez",0,1,1,0
1999,102376,"Radovan Svetlik",0,1,1,0
1999,102381,"Werner Eschauer",0,1,1,0
1999,102405,"Mahesh Bhupathi",0,1,1,0
1999,102410,"David Caldwell",0,2,2,0
1999,102413,"Andy Zingman",0,1,1,0
1999,102443,"Barry Cowan",0,3,3,0
1999,102457,"Miles Maclagan",0,2,2,0
1999,102458,"Jim Thomas",0,1,1,0
1999,102473,"Thomas Schiessling",0,2,2,0
1999,102477,"Gaston Etlis",0,3,3,0
1999,102501,"Johan Landsberg",0,2,2,0
1999,102512,"Joseph Sirianni",0,1,1,0
1999,102520,"Olivier Malcor",0,1,1,0
1999,102554,"Diego Moyano",0,1,1,0
1999,102571,"Gregory Carraz",0,1,1,0
1999,102572,"Igor Gaudi",0,1,1,0
1999,102577,"Steven Randjelovic",0,1,1,0
1999,102585,"Sebastian Prieto",0,2,2,0
1999,102600,"David Miketa",0,2,2,0
1999,102623,"Thomas Larsen",0,1,1,0
1999,102655,"Jimy Szymanski",0,1,1,0
1999,102667,"Satoshi Iwabuchi",0,1,1,0
1999,102735,"Cedric Kauffmann",0,1,1,0
1999,102743,"Ben Ellwood",0,1,1,0
1999,102780,"Frederic Niemeyer",0,1,1,0
1999,102791,"Bobby Kokavec",0,1,1,0
1999,102795,"Scott Humphries",0,1,1,0
1999,102836,"Rogier Wassen",0,4,4,0
1999,102842,"Toby Mitchell",0,1,1,0
1999,102883,"Tom Spinks",0,1,1,0
1999,102902,"Thomas Blake",0,1,1,0
1999,102921,"Ota Fukarek",0,1,1,0
1999,102957,"Vadim Kutsenko",0,1,1,0
1999,102961,"Nicklas Timfjord",0,1,1,0
1999,102963,"Robert Lindstedt",0,1,1,0
1999,103007,"Mounir El Aarej",0,1,1,0
1999,103009,"Razvan Sabau",0,1,1,0
1999,103027,"Markus Menzler",0,1,1,0
1999,103060,"Alejandro Hernandez",0,2,2,0
1999,103061,"Jan Boruszewski",0,1,1,0
1999,103109,"Talal Ouahabi",0,1,1,0
1999,103158,"Johan Ortegren",0,1,1,0
1999,103166,"Vladimir Voltchkov",0,5,5,0
1999,103167,"Jocelyn Robichaud",0,1,1,0
1999,103171,"Raemon Sluiter",0,2,2,0
1999,103174,"Noam Okun",0,1,1,0
1999,103176,"David Sanchez",0,1,1,0
1999,103198,"Justin Bower",0,1,1,0
1999,103202,"Oscar Serrano",0,3,3,0
1999,103225,"Simon Larose",0,1,1,0
1999,103240,"Kevin Kim",0,2,2,0
1999,103306,"Florian Allgauer",0,1,1,0
1999,103319,"Jeff Morrison",0,2,2,0
1999,103337,"Ben Qiang Zhu",0,1,1,0
1999,103428,"Juan Ignacio Chela",0,3,3,0
1999,103485,"Ivan Beros",0,1,1,0
1999,103497,"Artem Derepasko",0,1,1,0
1999,103594,"Oliver Marach",0,1,1,0
1999,103632,"Luis Horna",0,1,1,0
1999,103715,"Kirill Ivanov Smolensky",0,1,1,0
1999,103735,"Lovro Zovko",0,2,2,0
1999,103758,"Taylor Dent",0,2,2,0
1999,103789,"Irakli Labadze",0,2,2,0
1999,103817,"Yu Jr Wang",0,1,1,0
1999,103857,"Igor Kunitsyn",0,2,2,0
1999,103894,"Phillip King",0,2,2,0
1999,103958,"Philip Gubenco",0,1,1,0
1999,103995,"Pedro Leao",0,1,1,0
1999,104022,"Mikhail Youzhny",0,1,1,0
1999,108593,"Wing Luen Wong",0,1,1,0
1999,108991,"Sergei Petrouchevsky",0,1,1,0
1999,108998,"Patrick Osnua",0,1,1,0
2000,101167,"Jaime Cortes",0,1,1,0
2000,101263,"Luke Jensen",0,1,1,0
2000,101382,"Marcelo Filippini",0,2,2,0
2000,101439,"Javier Sanchez",0,1,1,0
2000,101463,"Bernd Karbacher",0,2,2,0
2000,101703,"Guillaume Raoux",0,2,2,0
2000,101731,"Nuno Marques",0,1,1,0
2000,101821,"Peter Tramacchi",0,1,1,0
2000,101833,"Michael Tebbutt",0,1,1,0
2000,101890,"Jonathan Stark",0,1,1,0
2000,101900,"Nicklas Kulti",0,5,5,0
2000,101938,"Bernardo Mota",0,1,1,0
2000,101956,"Mark Knowles",0,2,2,0
2000,101991,"Mauricio Hadad",0,1,1,0
2000,102023,"Petr Luxa",0,2,2,0
2000,102086,"Igor Kornienko",0,1,1,0
2000,102087,"Oleg Ogorodov",0,2,2,0
2000,102118,"Radomir Vasek",0,1,1,0
2000,102145,"Francisco Cabello",0,1,1,0
2000,102154,"Marcos Ondruska",0,5,5,0
2000,102168,"Hector Moretti",0,1,1,0
2000,102198,"Paul Kilderry",0,3,3,0
2000,102234,"Oliver Gross",0,2,2,0
2000,102239,"Francisco Costa",0,2,2,0
2000,102405,"Mahesh Bhupathi",0,1,1,0
2000,102410,"David Caldwell",0,1,1,0
2000,102457,"Miles Maclagan",0,1,1,0
2000,102458,"Jim Thomas",0,1,1,0
2000,102463,"Lucas Arnold Ker",0,1,1,0
2000,102497,"Mashiska Washington",0,1,1,0
2000,102501,"Johan Landsberg",0,1,1,0
2000,102502,"Paul Harsanyi",0,1,1,0
2000,102512,"Joseph Sirianni",0,1,1,0
2000,102520,"Olivier Malcor",0,1,1,0
2000,102537,"Melvin Tong",0,1,1,0
2000,102572,"Igor Gaudi",0,1,1,0
2000,102574,"Gabriel Trifu",0,1,1,0
2000,102600,"David Miketa",0,1,1,0
2000,102617,"Kim Tiilikainen",0,1,1,0
2000,102655,"Jimy Szymanski",0,1,1,0
2000,102667,"Satoshi Iwabuchi",0,1,1,0
2000,102689,"Martin Spottl",0,2,2,0
2000,102734,"Lior Mor",0,1,1,0
2000,102735,"Cedric Kauffmann",0,1,1,0
2000,102755,"Alex Witt",0,1,1,0
2000,102772,"Yu Zhang",0,1,1,0
2000,102780,"Frederic Niemeyer",0,1,1,0
2000,102785,"Glenn Weiner",0,1,1,0
2000,102795,"Scott Humphries",0,4,4,0
2000,102835,"Luke Milligan",0,1,1,0
2000,102836,"Rogier Wassen",0,1,1,0
2000,102851,"Giorgio Galimberti",0,1,1,0
2000,102944,"Stefano Cobolli",0,1,1,0
2000,102948,"Oliver Freelove",0,1,1,0
2000,102956,"Sultan Khalfan",0,1,1,0
2000,102957,"Vadim Kutsenko",0,1,1,0
2000,102961,"Nicklas Timfjord",0,1,1,0
2000,102978,"Zbynek Mlynarik",0,1,1,0
2000,102982,"Yaoki Ishii",0,2,2,0
2000,102984,"Martin Garcia",0,1,1,0
2000,103007,"Mounir El Aarej",0,1,1,0
2000,103029,"Mehdi Tahiri",0,1,1,0
2000,103061,"Jan Boruszewski",0,1,1,0
2000,103066,"Mark Nielsen",0,1,1,0
2000,103070,"Christophe Pognon",0,1,1,0
2000,103118,"Ion Moldovan",0,1,1,0
2000,103131,"Michihisa Onoda",0,1,1,0
2000,103174,"Noam Okun",0,1,1,0
2000,103202,"Oscar Serrano",0,1,1,0
2000,103204,"Hugo Armando",0,2,2,0
2000,103216,"Clemens Trimmel",0,2,2,0
2000,103239,"Marcus Sarstrand",0,1,1,0
2000,103242,"Juan Giner",0,1,1,0
2000,103250,"Rodolphe Cadart",0,2,2,0
2000,103256,"Ivan Vajda",0,1,1,0
2000,103280,"Martin Verkerk",0,1,1,0
2000,103297,"Alex Kim",0,1,1,0
2000,103319,"Jeff Morrison",0,1,1,0
2000,103337,"Ben Qiang Zhu",0,1,1,0
2000,103348,"Timo Fleischfresser",0,1,1,0
2000,103350,"Denis Golovanov",0,1,1,0
2000,103381,"Andy Fahlke",0,1,1,0
2000,103385,"Paul Baccanello",0,1,1,0
2000,103397,"Alexandre Simoni",0,1,1,0
2000,103401,"Jan Hernych",0,1,1,0
2000,103451,"Bjorn Phau",0,4,4,0
2000,103484,"James Blake",0,4,4,0
2000,103544,"Andy Ram",0,1,1,0
2000,103564,"Jakub Herm Zahlava",0,1,1,0
2000,103677,"Andreas Fasching",0,1,1,0
2000,103735,"Lovro Zovko",0,2,2,0
2000,103781,"Jurgen Melzer",0,3,3,0
2000,103792,"Joji Miyao",0,1,1,0
2000,103799,"Eric Prodon",0,1,1,0
2000,103813,"Jarkko Nieminen",0,1,1,0
2000,103834,"Levar Harper Griffith",0,1,1,0
2000,103852,"Feliciano Lopez",0,1,1,0
2000,103894,"Phillip King",0,4,4,0
2000,103900,"David Nalbandian",0,2,2,0
2000,103917,"Nicolas Mahut",0,2,2,0
2000,103990,"Tommy Robredo",0,2,2,0
2000,104026,"Joachim Johansson",0,2,2,0
2000,104027,"Pablo Gonzalez",0,1,1,0
2000,104156,"Sunil Kumar",0,1,1,0
2000,104188,"Diego Camacho",0,1,1,0
2000,104282,"Dennis Peschek",0,1,1,0
2001,101675,"Martin Rodriguez",0,3,3,0
2001,101711,"Alex Obrien",0,3,3,0
2001,101761,"Jaime Oncins",0,1,1,0
2001,101868,"Dick Norman",0,1,1,0
2001,101890,"Jonathan Stark",0,1,1,0
2001,101937,"Robbie Koenig",0,1,1,0
2001,101969,"Orlin Stanoytchev",0,1,1,0
2001,101970,"Iztok Bozic",0,1,1,0
2001,102023,"Petr Luxa",0,1,1,0
2001,102201,"Lionel Roux",0,2,2,0
2001,102215,"Joshua Eagle",0,1,1,0
2001,102238,"Alberto Berasategui",0,1,1,0
2001,102239,"Francisco Costa",0,1,1,0
2001,102243,"Marcelo Charpentier",0,2,2,0
2001,102250,"Emanuel Couto",0,1,1,0
2001,102251,"Mariano Hood",0,1,1,0
2001,102300,"Gouichi Motomura",0,2,2,0
2001,102306,"Michael Kohlmann",0,2,2,0
2001,102347,"Dmitri Tomashevich",0,1,1,0
2001,102375,"Dinu Pescariu",0,1,1,0
2001,102382,"Julian Knowle",0,2,2,0
2001,102405,"Mahesh Bhupathi",0,1,1,0
2001,102433,"Mose Navarra",0,1,1,0
2001,102455,"Lorenzo Manta",0,1,1,0
2001,102458,"Jim Thomas",0,1,1,0
2001,102467,"Fazaluddin Syed",0,1,1,0
2001,102469,"Solon Peppas",0,1,1,0
2001,102473,"Thomas Schiessling",0,1,1,0
2001,102497,"Mashiska Washington",0,1,1,0
2001,102502,"Paul Harsanyi",0,1,1,0
2001,102520,"Olivier Malcor",0,1,1,0
2001,102529,"Thomas Shimada",0,1,1,0
2001,102538,"Tuomas Ketola",0,2,2,0
2001,102554,"Diego Moyano",0,1,1,0
2001,102558,"Eric Taino",0,2,2,0
2001,102595,"Helge Koll",0,1,1,0
2001,102615,"Dennis Van Scheppingen",0,2,2,0
2001,102629,"Oscar Burrieza",0,1,1,0
2001,102650,"Roberto Carretero",0,1,1,0
2001,102667,"Satoshi Iwabuchi",0,1,1,0
2001,102735,"Cedric Kauffmann",0,1,1,0
2001,102751,"Todd Perry",0,1,1,0
2001,102780,"Frederic Niemeyer",0,1,1,0
2001,102805,"Matthew Breen",0,1,1,0
2001,102808,"Kalle Flygt",0,1,1,0
2001,102811,"Dusan Vemic",0,1,1,0
2001,102835,"Luke Milligan",0,1,1,0
2001,102851,"Giorgio Galimberti",0,1,1,0
2001,102875,"Luke Smith",0,1,1,0
2001,102886,"Frantisek Cermak",0,1,1,0
2001,102904,"Leos Friedl",0,2,2,0
2001,102956,"Sultan Khalfan",0,1,1,0
2001,102959,"Marko Tkalec",0,1,1,0
2001,102968,"Jonathan Erlich",0,1,1,0
2001,102982,"Yaoki Ishii",0,2,2,0
2001,102999,"Stefano Galvani",0,1,1,0
2001,103007,"Mounir El Aarej",0,1,1,0
2001,103015,"Daniel Melo",0,1,1,0
2001,103029,"Mehdi Tahiri",0,1,1,0
2001,103060,"Alejandro Hernandez",0,1,1,0
2001,103063,"Sebastien De Chaunac",0,1,1,0
2001,103066,"Mark Nielsen",0,1,1,0
2001,103068,"Chemseddine Belal",0,1,1,0
2001,103102,"John Hui",0,1,1,0
2001,103118,"Ion Moldovan",0,2,2,0
2001,103131,"Michihisa Onoda",0,2,2,0
2001,103162,"Dejan Petrovic",0,2,2,0
2001,103201,"Adrian Garcia",0,1,1,0
2001,103225,"Simon Larose",0,1,1,0
2001,103256,"Ivan Vajda",0,1,1,0
2001,103280,"Martin Verkerk",0,1,1,0
2001,103281,"Ladislav Svarc",0,1,1,0
2001,103282,"Tiago Sousa",0,1,1,0
2001,103285,"Radek Stepanek",0,1,1,0
2001,103287,"Krystian Pfeiffer",0,1,1,0
2001,103290,"Radim Zitko",0,1,1,0
2001,103319,"Jeff Morrison",0,1,1,0
2001,103333,"Ivo Karlovic",0,1,1,0
2001,103365,"Javier Garcia Sintes",0,1,1,0
2001,103393,"Yuri Schukin",0,2,2,0
2001,103457,"Petr Kralert",0,1,1,0
2001,103497,"Artem Derepasko",0,1,1,0
2001,103530,"Zack Fleishman",0,1,1,0
2001,103546,"Patricio Arquez",0,1,1,0
2001,103553,"Alun Jones",0,2,2,0
2001,103564,"Jakub Herm Zahlava",0,1,1,0
2001,103642,"Shan Jiang",0,1,1,0
2001,103754,"Mark Hilton",0,1,1,0
2001,103817,"Yu Jr Wang",0,1,1,0
2001,103834,"Levar Harper Griffith",0,1,1,0
2001,103835,"Filippo Volandri",0,2,2,0
2001,103862,"Michail Elgin",0,1,1,0
2001,103908,"Paul Henri Mathieu",0,2,2,0
2001,103912,"Mario Radic",0,1,1,0
2001,103914,"Omar Awadhy",0,1,1,0
2001,103999,"Thiago Alves",0,1,1,0
2001,104014,"Lee Childs",0,3,3,0
2001,104026,"Joachim Johansson",0,2,2,0
2001,104034,"Dmitry Vlasov",0,1,1,0
2001,104166,"Alex Bogomolov Jr",0,1,1,0
2002,101543,"Jeff Tarango",0,1,1,0
2002,101733,"Jan Siemerink",0,2,2,0
2002,101735,"Richard Fromberg",0,2,2,0
2002,101750,"Cristiano Caratti",0,3,3,0
2002,101888,"Daniel Vacek",0,2,2,0
2002,101947,"Vincenzo Santopadre",0,1,1,0
2002,102023,"Petr Luxa",0,1,1,0
2002,102077,"Alexander Shvec",0,1,1,0
2002,102100,"Bartlomiej Dabrowski",0,1,1,0
2002,102107,"Jan Frode Andersen",0,1,1,0
2002,102110,"Daniel Nestor",0,1,1,0
2002,102162,"Chris Woodruff",0,1,1,0
2002,102169,"Michael Joyce",0,1,1,0
2002,102192,"Luis Adrian Morejon",0,1,1,0
2002,102233,"Leander Paes",0,1,1,0
2002,102239,"Francisco Costa",0,1,1,0
2002,102269,"Jeff Salzenstein",0,1,1,0
2002,102285,"Nasser Ghanim Al Khulaifi",0,1,1,0
2002,102286,"Wayne Black",0,3,3,0
2002,102405,"Mahesh Bhupathi",0,1,1,0
2002,102406,"Thomas Dupre",0,1,1,0
2002,102464,"Todd Larkham",0,1,1,0
2002,102472,"Marcello Craca",0,1,1,0
2002,102494,"Tomas Behrend",0,2,2,0
2002,102521,"Hendrik Dreekmann",0,1,1,0
2002,102557,"Daniel Willman",0,1,1,0
2002,102558,"Eric Taino",0,1,1,0
2002,102574,"Gabriel Trifu",0,2,2,0
2002,102585,"Sebastian Prieto",0,2,2,0
2002,102617,"Kim Tiilikainen",0,1,1,0
2002,102630,"Slimane Saoudi",0,1,1,0
2002,102652,"Christian Vinck",0,2,2,0
2002,102687,"Herbert Wiltschnig",0,1,1,0
2002,102693,"Leonardo Olguin",0,1,1,0
2002,102715,"Ignacio Hirigoyen",0,1,1,0
2002,102743,"Ben Ellwood",0,1,1,0
2002,102776,"Andrew Ilie",0,7,7,0
2002,102780,"Frederic Niemeyer",0,1,1,0
2002,102785,"Glenn Weiner",0,1,1,0
2002,102817,"Edwin Kempes",0,1,1,0
2002,102836,"Rogier Wassen",0,1,1,0
2002,102865,"Doug Bohaboy",0,1,1,0
2002,102965,"Jamie Delgado",0,4,4,0
2002,102979,"Jeff Coetzee",0,1,1,0
2002,102984,"Martin Garcia",0,1,1,0
2002,103009,"Razvan Sabau",0,1,1,0
2002,103015,"Daniel Melo",0,2,2,0
2002,103047,"Julien Varlet",0,3,3,0
2002,103060,"Alejandro Hernandez",0,1,1,0
2002,103077,"Konstantinos Economidis",0,1,1,0
2002,103080,"Paul Hanley",0,1,1,0
2002,103092,"Nuno Matias",0,1,1,0
2002,103097,"Trevor Spracklin",0,1,1,0
2002,103104,"Bjorn Rehnquist",0,1,1,0
2002,103105,"Ruben Ramirez Hidalgo",0,3,3,0
2002,103118,"Ion Moldovan",0,1,1,0
2002,103131,"Michihisa Onoda",0,1,1,0
2002,103133,"Olivier Mutis",0,1,1,0
2002,103154,"Jaymon Crabb",0,2,2,0
2002,103193,"Peter Wessels",0,1,1,0
2002,103198,"Justin Bower",0,1,1,0
2002,103204,"Hugo Armando",0,2,2,0
2002,103225,"Simon Larose",0,1,1,0
2002,103228,"Marcos Daniel",0,1,1,0
2002,103250,"Rodolphe Cadart",0,1,1,0
2002,103270,"Kristian Capalik",0,1,1,0
2002,103305,"Daniel Elsner",0,1,1,0
2002,103325,"Wesley Moodie",0,1,1,0
2002,103350,"Denis Golovanov",0,2,2,0
2002,103358,"Nicolas Todero",0,1,1,0
2002,103371,"Emin Agaev",0,1,1,0
2002,103401,"Jan Hernych",0,1,1,0
2002,103403,"Takahiro Terachi",0,1,1,0
2002,103505,"Vasilis Mazarakis",0,2,2,0
2002,103506,"Martin Vassallo Arguello",0,2,2,0
2002,103525,"Ivan Miranda",0,2,2,0
2002,103535,"Olivier Patience",0,1,1,0
2002,103594,"Oliver Marach",0,2,2,0
2002,103663,"Matias Boeker",0,1,1,0
2002,103672,"Ricardo Mello",0,1,1,0
2002,103693,"Thierry Ascione",0,1,1,0
2002,103700,"Juan Pablo Guzman",0,1,1,0
2002,103715,"Kirill Ivanov Smolensky",0,2,2,0
2002,103737,"Edgardo Massa",0,5,5,0
2002,103792,"Joji Miyao",0,1,1,0
2002,103799,"Eric Prodon",0,1,1,0
2002,103820,"Alan Mackin",0,1,1,0
2002,103821,"Danai Udomchoke",0,1,1,0
2002,103823,"Denis Gremelmayr",0,1,1,0
2002,103835,"Filippo Volandri",0,2,2,0
2002,103857,"Igor Kunitsyn",0,1,1,0
2002,103862,"Michail Elgin",0,1,1,0
2002,103898,"Julien Benneteau",0,2,2,0
2002,103914,"Omar Awadhy",0,1,1,0
2002,103917,"Nicolas Mahut",0,1,1,0
2002,103923,"Radoslaw Nijaki",0,1,1,0
2002,103948,"Maximilian Abel",0,2,2,0
2002,103986,"Radoslav Lukaev",0,1,1,0
2002,103988,"Mariano Albert Ferrando",0,1,1,0
2002,104004,"Filip Prpic",0,1,1,0
2002,104082,"Hiroki Kondo",0,1,1,0
2002,104126,"Adam Kennedy",0,1,1,0
2002,104180,"Gilles Muller",0,1,1,0
2002,104196,"Carlos Cuadrado",0,1,1,0
2002,104250,"Prakash Amritraj",0,1,1,0
2002,104259,"Philipp Kohlschreiber",0,3,3,0
2002,104325,"Johannes Ager",0,1,1,0
2002,104330,"Rajeev Ram",0,1,1,0
2002,104372,"Alex Bogdanovic",0,2,2,0
2002,104379,"Todd Reid",0,2,2,0
2002,104503,"Guillermo Hormazabal",0,1,1,0
2002,104548,"Brian Baker",0,1,1,0
2003,101750,"Cristiano Caratti",0,1,1,0
2003,101924,"Stefano Pescosolido",0,2,2,0
2003,101964,"Goran Ivanisevic",0,3,3,0
2003,102023,"Petr Luxa",0,3,3,0
2003,102100,"Bartlomiej Dabrowski",0,1,1,0
2003,102107,"Jan Frode Andersen",0,2,2,0
2003,102184,"David Prinosil",0,4,4,0
2003,102207,"Jan Weinzierl",0,1,1,0
2003,102223,"Karim Alami",0,1,1,0
2003,102231,"Alex Calatrava",0,3,3,0
2003,102233,"Leander Paes",0,1,1,0
2003,102234,"Oliver Gross",0,1,1,0
2003,102243,"Marcelo Charpentier",0,2,2,0
2003,102259,"Jerome Golmard",0,3,3,0
2003,102306,"Michael Kohlmann",0,2,2,0
2003,102457,"Miles Maclagan",0,1,1,0
2003,102521,"Hendrik Dreekmann",0,1,1,0
2003,102529,"Thomas Shimada",0,1,1,0
2003,102567,"George Bastl",0,3,3,0
2003,102585,"Sebastian Prieto",0,1,1,0
2003,102607,"Juan Balcells",0,3,3,0
2003,102652,"Christian Vinck",0,1,1,0
2003,102776,"Andrew Ilie",0,2,2,0
2003,102785,"Glenn Weiner",0,1,1,0
2003,102789,"Jay Gooding",0,1,1,0
2003,102831,"Jacobo Diaz",0,2,2,0
2003,102836,"Rogier Wassen",0,1,1,0
2003,102855,"Jack Brasington",0,2,2,0
2003,102864,"Frank Moser",0,1,1,0
2003,102902,"Thomas Blake",0,2,2,0
2003,102956,"Sultan Khalfan",0,1,1,0
2003,102965,"Jamie Delgado",0,2,2,0
2003,102983,"Henrik Andersson",0,1,1,0
2003,103007,"Mounir El Aarej",0,1,1,0
2003,103029,"Mehdi Tahiri",0,1,1,0
2003,103033,"Helder Lopes",0,1,1,0
2003,103035,"Alessio Di Mauro",0,1,1,0
2003,103037,"Andrew Carlson",0,1,1,0
2003,103052,"Mariano Delfino",0,1,1,0
2003,103066,"Mark Nielsen",0,1,1,0
2003,103077,"Konstantinos Economidis",0,1,1,0
2003,103109,"Talal Ouahabi",0,1,1,0
2003,103114,"Martin Lee",0,1,1,0
2003,103193,"Peter Wessels",0,1,1,0
2003,103201,"Adrian Garcia",0,1,1,0
2003,103202,"Oscar Serrano",0,1,1,0
2003,103204,"Hugo Armando",0,5,5,0
2003,103238,"Jean Claude Scherrer",0,2,2,0
2003,103239,"Marcus Sarstrand",0,1,1,0
2003,103240,"Kevin Kim",0,1,1,0
2003,103242,"Juan Giner",0,1,1,0
2003,103254,"Yves Allegro",0,3,3,0
2003,103281,"Ladislav Svarc",0,1,1,0
2003,103337,"Ben Qiang Zhu",0,1,1,0
2003,103350,"Denis Golovanov",0,2,2,0
2003,103353,"Ingo Neumuller",0,1,1,0
2003,103363,"Diego Ayala",0,1,1,0
2003,103395,"Julio Silva",0,1,1,0
2003,103403,"Takahiro Terachi",0,1,1,0
2003,103435,"Massimo Dellacqua",0,1,1,0
2003,103455,"Michal Mertinak",0,2,2,0
2003,103465,"Paul Logtens",0,1,1,0
2003,103503,"Robin Vik",0,1,1,0
2003,103506,"Martin Vassallo Arguello",0,2,2,0
2003,103520,"Pavel Snobel",0,1,1,0
2003,103523,"Rohan Bopanna",0,1,1,0
2003,103535,"Olivier Patience",0,2,2,0
2003,103544,"Andy Ram",0,3,3,0
2003,103586,"Mariusz Fyrstenberg",0,1,1,0
2003,103590,"Michael Quintero",0,1,1,0
2003,103609,"Matthew Behrmann",0,1,1,0
2003,103621,"Igor Levine",0,1,1,0
2003,103690,"Marcin Matkowski",0,1,1,0
2003,103699,"Fred Hemmes",0,2,2,0
2003,103711,"Jaroslav Levinsky",0,1,1,0
2003,103722,"Florent Serra",0,2,2,0
2003,103730,"Jonathan Marray",0,1,1,0
2003,103735,"Lovro Zovko",0,1,1,0
2003,103746,"Miguel Gallardo Valles",0,1,1,0
2003,103752,"Simon Greul",0,1,1,0
2003,103754,"Mark Hilton",0,1,1,0
2003,103808,"Potito Starace",0,1,1,0
2003,103820,"Alan Mackin",0,1,1,0
2003,103821,"Danai Udomchoke",0,1,1,0
2003,103830,"Shao Xuan Zeng",0,1,1,0
2003,103837,"Didac Perez",0,1,1,0
2003,103841,"Julio Peralta",0,1,1,0
2003,103843,"Marco Chiudinelli",0,1,1,0
2003,103849,"Francesco Aldi",0,1,1,0
2003,103857,"Igor Kunitsyn",0,3,3,0
2003,103914,"Omar Awadhy",0,1,1,0
2003,103921,"Sonchat Ratiwatana",0,1,1,0
2003,103925,"Gabriel Moraru",0,1,1,0
2003,103963,"Filip Urban",0,1,1,0
2003,103967,"Michael Lammer",0,1,1,0
2003,104004,"Filip Prpic",0,1,1,0
2003,104035,"Bobby Reynolds",0,2,2,0
2003,104036,"Simon Rea",0,1,1,0
2003,104056,"Roko Karanusic",0,2,2,0
2003,104059,"Rasmus Norby",0,1,1,0
2003,104126,"Adam Kennedy",0,2,2,0
2003,104154,"Paul Capdeville",0,1,1,0
2003,104171,"Richard Bloomfield",0,1,1,0
2003,104180,"Gilles Muller",0,1,1,0
2003,104198,"Guillermo Garcia Lopez",0,1,1,0
2003,104230,"Daniel Koellerer",0,1,1,0
2003,104233,"Frederik Nielsen",0,1,1,0
2003,104295,"Raphael Durek",0,1,1,0
2003,104312,"Andreas Seppi",0,2,2,0
2003,104383,"Diogo Rocha",0,1,1,0
2003,104392,"Franco Ferreiro",0,1,1,0
2003,104433,"Frank Dancevic",0,1,1,0
2003,104439,"Vadim Davletshin",0,1,1,0
2003,104444,"Ryan Henry",0,1,1,0
2003,104460,"Dustin Brown",0,1,1,0
2003,104508,"Robert Yim",0,2,2,0
2003,104548,"Brian Baker",0,3,3,0
2003,106764,"Christopher Koderisch",0,1,1,0
2004,101869,"Juan Luis Tati Rascon",0,1,1,0
2004,101871,"Alexander Reichel",0,1,1,0
2004,101947,"Vincenzo Santopadre",0,1,1,0
2004,101962,"Younes El Aynaoui",0,5,5,0
2004,102110,"Daniel Nestor",0,1,1,0
2004,102184,"David Prinosil",0,1,1,0
2004,102464,"Todd Larkham",0,1,1,0
2004,102473,"Thomas Schiessling",0,1,1,0
2004,102545,"Pedro Braga",0,1,1,0
2004,102548,"Juan Antonio Marin",0,2,2,0
2004,102554,"Diego Moyano",0,1,1,0
2004,102558,"Eric Taino",0,2,2,0
2004,102567,"George Bastl",0,1,1,0
2004,102667,"Satoshi Iwabuchi",0,2,2,0
2004,102722,"Attila Savolt",0,2,2,0
2004,102851,"Giorgio Galimberti",0,1,1,0
2004,102887,"Ramon Delgado",0,1,1,0
2004,102910,"Salvador Navarro",0,1,1,0
2004,102911,"Andrei Stoliarov",0,1,1,0
2004,102956,"Sultan Khalfan",0,1,1,0
2004,102957,"Vadim Kutsenko",0,1,1,0
2004,102985,"Gustavo Marcaccio",0,1,1,0
2004,102987,"Andre Sa",0,1,1,0
2004,102997,"Hermes Gamonal",0,1,1,0
2004,103007,"Mounir El Aarej",0,1,1,0
2004,103009,"Razvan Sabau",0,2,2,0
2004,103029,"Mehdi Tahiri",0,1,1,0
2004,103035,"Alessio Di Mauro",0,3,3,0
2004,103039,"Tripp Phillips",0,1,1,0
2004,103060,"Alejandro Hernandez",0,1,1,0
2004,103066,"Mark Nielsen",0,1,1,0
2004,103077,"Konstantinos Economidis",0,1,1,0
2004,103082,"Markus Hantschk",0,1,1,0
2004,103104,"Bjorn Rehnquist",0,1,1,0
2004,103149,"Mathias Hellstrom",0,1,1,0
2004,103154,"Jaymon Crabb",0,1,1,0
2004,103178,"Johan Settergren",0,1,1,0
2004,103184,"Bob Bryan",0,1,1,0
2004,103193,"Peter Wessels",0,2,2,0
2004,103230,"Tasuku Iwami",0,1,1,0
2004,103238,"Jean Claude Scherrer",0,1,1,0
2004,103254,"Yves Allegro",0,1,1,0
2004,103264,"Mariano Puerta",0,1,1,0
2004,103297,"Alex Kim",0,1,1,0
2004,103328,"Andres Pedroso",0,1,1,0
2004,103422,"Sebastian Fitz",0,1,1,0
2004,103435,"Massimo Dellacqua",0,3,3,0
2004,103455,"Michal Mertinak",0,1,1,0
2004,103460,"Konstantin Don Gruber",0,1,1,0
2004,103468,"Harsh Mankad",0,1,1,0
2004,103478,"Diego Veronelli",0,1,1,0
2004,103505,"Vasilis Mazarakis",0,1,1,0
2004,103516,"Nathan Healey",0,2,2,0
2004,103521,"Andrea Stoppini",0,1,1,0
2004,103529,"Aisam Ul Haq Qureshi",0,1,1,0
2004,103530,"Zack Fleishman",0,2,2,0
2004,103544,"Andy Ram",0,3,3,0
2004,103553,"Alun Jones",0,1,1,0
2004,103582,"Michael Berrer",0,1,1,0
2004,103600,"Mohammad Ghareeb",0,1,1,0
2004,103657,"Ivo Klec",0,1,1,0
2004,103716,"Uros Vico",0,1,1,0
2004,103726,"Jean Christophe Faurel",0,1,1,0
2004,103746,"Miguel Gallardo Valles",0,1,1,0
2004,103817,"Yu Jr Wang",0,1,1,0
2004,103821,"Danai Udomchoke",0,3,3,0
2004,103830,"Shao Xuan Zeng",0,1,1,0
2004,103837,"Didac Perez",0,1,1,0
2004,103847,"Adrian Bohane",0,1,1,0
2004,103849,"Francesco Aldi",0,1,1,0
2004,103862,"Michail Elgin",0,1,1,0
2004,103868,"Ivan Navarro",0,1,1,0
2004,103914,"Omar Awadhy",0,1,1,0
2004,103948,"Maximilian Abel",0,1,1,0
2004,103963,"Filip Urban",0,1,1,0
2004,104010,"Dieter Kindlmann",0,1,1,0
2004,104014,"Lee Childs",0,2,2,0
2004,104035,"Bobby Reynolds",0,1,1,0
2004,104036,"Simon Rea",0,1,1,0
2004,104056,"Roko Karanusic",0,2,2,0
2004,104099,"Israel Matos Gil",0,1,1,0
2004,104117,"Giovanni Lapentti",0,4,4,0
2004,104154,"Paul Capdeville",0,1,1,0
2004,104167,"Todd Widom",0,1,1,0
2004,104171,"Richard Bloomfield",0,1,1,0
2004,104181,"Victor Ionita",0,1,1,0
2004,104182,"Sasa Tuksar",0,1,1,0
2004,104219,"Stephane Bohli",0,1,1,0
2004,104228,"Guillem Burniol",0,1,1,0
2004,104308,"Michal Przysiezny",0,2,2,0
2004,104311,"Leonardo Tavares",0,1,1,0
2004,104325,"Johannes Ager",0,1,1,0
2004,104355,"Lester Cook",0,1,1,0
2004,104392,"Franco Ferreiro",0,1,1,0
2004,104467,"Lamine Ouahab",0,1,1,0
2004,104468,"Gilles Simon",0,1,1,0
2004,104485,"Nick Van Der Meer",0,1,1,0
2004,104503,"Guillermo Hormazabal",0,1,1,0
2004,104527,"Stan Wawrinka",0,6,6,0
2004,104559,"Teymuraz Gabashvili",0,2,2,0
2004,104593,"Daniel Gimeno Traver",0,2,2,0
2004,104612,"Daniel Yoo",0,1,1,0
2004,104639,"Wayne Odesnik",0,3,3,0
2004,104660,"Sergiy Stakhovsky",0,1,1,0
2004,104681,"Sebastian Rieschick",0,1,1,0
2004,104717,"Brendan Evans",0,1,1,0
2004,104807,"Mehdi Ziadi",0,1,1,0
2004,104812,"Scoville Jenkins",0,1,1,0
2004,104816,"Karan Rastogi",0,1,1,0
2004,104864,"Alex Kuznetsov",0,1,1,0
2004,104914,"Ervin Eleskovic",0,2,2,0
2005,102233,"Leander Paes",0,1,1,0
2005,102271,"Hicham Arazi",0,2,2,0
2005,102300,"Gouichi Motomura",0,1,1,0
2005,102382,"Julian Knowle",0,1,1,0
2005,102401,"Scott Draper",0,4,4,0
2005,102497,"Mashiska Washington",0,1,1,0
2005,102538,"Tuomas Ketola",0,1,1,0
2005,102615,"Dennis Van Scheppingen",0,4,4,0
2005,102780,"Frederic Niemeyer",0,2,2,0
2005,102869,"Galo Blanco",0,3,3,0
2005,102945,"Luke Bourgeois",0,1,1,0
2005,103029,"Mehdi Tahiri",0,1,1,0
2005,103060,"Alejandro Hernandez",0,1,1,0
2005,103066,"Mark Nielsen",0,1,1,0
2005,103133,"Olivier Mutis",0,3,3,0
2005,103165,"Gorka Fraile",0,1,1,0
2005,103166,"Vladimir Voltchkov",0,2,2,0
2005,103182,"Markus Hipfl",0,1,1,0
2005,103228,"Marcos Daniel",0,2,2,0
2005,103230,"Tasuku Iwami",0,1,1,0
2005,103254,"Yves Allegro",0,1,1,0
2005,103290,"Radim Zitko",0,1,1,0
2005,103318,"Zeljko Krajan",0,1,1,0
2005,103373,"Sergio Roitman",0,1,1,0
2005,103385,"Paul Baccanello",0,2,2,0
2005,103393,"Yuri Schukin",0,2,2,0
2005,103395,"Julio Silva",0,1,1,0
2005,103465,"Paul Logtens",0,1,1,0
2005,103468,"Harsh Mankad",0,2,2,0
2005,103470,"Robert Kendrick",0,2,2,0
2005,103510,"Rob Steckley",0,1,1,0
2005,103580,"Alexander Peya",0,1,1,0
2005,103586,"Mariusz Fyrstenberg",0,2,2,0
2005,103626,"Tomas Tenconi",0,1,1,0
2005,103646,"Lars Uebel",0,1,1,0
2005,103663,"Matias Boeker",0,2,2,0
2005,103690,"Marcin Matkowski",0,1,1,0
2005,103708,"Jaroslav Pospisil",0,1,1,0
2005,103709,"Kristian Pless",0,2,2,0
2005,103746,"Miguel Gallardo Valles",0,1,1,0
2005,103752,"Simon Greul",0,2,2,0
2005,103754,"Mark Hilton",0,1,1,0
2005,103762,"John Paul Fruttero",0,1,1,0
2005,103775,"Felipe Parada",0,1,1,0
2005,103820,"Alan Mackin",0,7,7,0
2005,103830,"Shao Xuan Zeng",0,1,1,0
2005,103878,"Zach Dailey",0,1,1,0
2005,103914,"Omar Awadhy",0,1,1,0
2005,103964,"Tobias Klein",0,1,1,0
2005,103975,"Eric Nunez",0,1,1,0
2005,103976,"Juan Pablo Brzezicki",0,3,3,0
2005,103997,"Lukasz Kubot",0,1,1,0
2005,104001,"Brian Wilson",0,1,1,0
2005,104003,"Victor Crivoi",0,1,1,0
2005,104010,"Dieter Kindlmann",0,1,1,0
2005,104021,"Marco Mirnegg",0,1,1,0
2005,104037,"Phillip Harboe",0,1,1,0
2005,104070,"Jesse Witten",0,1,1,0
2005,104099,"Israel Matos Gil",0,1,1,0
2005,104115,"Marc Kimmich",0,2,2,0
2005,104121,"Tobias Summerer",0,5,5,0
2005,104122,"Carlos Berlocq",0,1,1,0
2005,104166,"Alex Bogomolov Jr",0,4,4,0
2005,104171,"Richard Bloomfield",0,1,1,0
2005,104181,"Victor Ionita",0,1,1,0
2005,104182,"Sasa Tuksar",0,3,3,0
2005,104219,"Stephane Bohli",0,1,1,0
2005,104250,"Prakash Amritraj",0,2,2,0
2005,104251,"Ti Chen",0,1,1,0
2005,104268,"Alejandro Falla",0,2,2,0
2005,104283,"Minh Quan Do",0,1,1,0
2005,104284,"Frank Condor",0,1,1,0
2005,104287,"Steven Korteling",0,1,1,0
2005,104305,"Luka Gregorc",0,1,1,0
2005,104332,"Philipp Petzschner",0,2,2,0
2005,104349,"Rui Machado",0,1,1,0
2005,104372,"Alex Bogdanovic",0,1,1,0
2005,104379,"Todd Reid",0,3,3,0
2005,104424,"Go Soeda",0,2,2,0
2005,104439,"Vadim Davletshin",0,1,1,0
2005,104445,"Jose Antonio Sanchez De Luna",0,1,1,0
2005,104453,"Michael Ryderstedt",0,2,2,0
2005,104486,"Horia Tecau",0,1,1,0
2005,104534,"Dudi Sela",0,1,1,0
2005,104542,"Jo-Wilfried Tsonga",0,1,1,0
2005,104558,"Mohammed Abdulla",0,1,1,0
2005,104593,"Daniel Gimeno Traver",0,1,1,0
2005,104624,"Joshua Goodall",0,2,2,0
2005,104635,"Robert Smeets",0,1,1,0
2005,104639,"Wayne Odesnik",0,2,2,0
2005,104711,"G Jones",0,1,1,0
2005,104717,"Brendan Evans",0,3,3,0
2005,104732,"Phillip Simmonds",0,1,1,0
2005,104760,"Scott Oudsema",0,1,1,0
2005,104783,"Mikhail Ledovskikh",0,1,1,0
2005,104816,"Karan Rastogi",0,1,1,0
2005,104851,"Gianluca Naso",0,1,1,0
2005,104864,"Alex Kuznetsov",0,2,2,0
2005,104914,"Ervin Eleskovic",0,1,1,0
2005,104926,"Fabio Fognini",0,1,1,0
2005,104951,"Aljoscha Thron",0,2,2,0
2005,104975,"Evgeny Kirillov",0,1,1,0
2005,105048,"Alex Clayton",0,1,1,0
2005,105227,"Marin Cilic",0,1,1,0
2005,105229,"Philip Bester",0,1,1,0
2005,105252,"Takahiro Ittogi",0,1,1,0
2005,105385,"Donald Young",0,7,7,0
2006,102110,"Daniel Nestor",0,1,1,0
2006,102143,"Nicolas Thomann",0,2,2,0
2006,102227,"Sargis Sargsian",0,2,2,0
2006,102282,"Tetsuya Chaen",0,1,1,0
2006,102381,"Werner Eschauer",0,1,1,0
2006,102512,"Joseph Sirianni",0,1,1,0
2006,102539,"Bohdan Ulihrach",0,1,1,0
2006,102571,"Gregory Carraz",0,1,1,0
2006,102770,"John Van Lottum",0,1,1,0
2006,102785,"Glenn Weiner",0,1,1,0
2006,102800,"Nenad Zimonjic",0,1,1,0
2006,102851,"Giorgio Galimberti",0,1,1,0
2006,102856,"Gustavo Kuerten",0,1,1,0
2006,102864,"Frank Moser",0,1,1,0
2006,102881,"David Skoch",0,1,1,0
2006,102885,"Vishal Uppal",0,1,1,0
2006,102956,"Sultan Khalfan",0,1,1,0
2006,102987,"Andre Sa",0,1,1,0
2006,103007,"Mounir El Aarej",0,1,1,0
2006,103063,"Sebastien De Chaunac",0,1,1,0
2006,103066,"Mark Nielsen",0,1,1,0
2006,103077,"Konstantinos Economidis",0,2,2,0
2006,103104,"Bjorn Rehnquist",0,3,3,0
2006,103165,"Gorka Fraile",0,3,3,0
2006,103184,"Bob Bryan",0,1,1,0
2006,103188,"Michael Russell",0,2,2,0
2006,103193,"Peter Wessels",0,1,1,0
2006,103201,"Adrian Garcia",0,2,2,0
2006,103209,"Leonardo Azzaro",0,3,3,0
2006,103248,"Harel Levy",0,2,2,0
2006,103395,"Julio Silva",0,2,2,0
2006,103455,"Michal Mertinak",0,2,2,0
2006,103505,"Vasilis Mazarakis",0,2,2,0
2006,103520,"Pavel Snobel",0,1,1,0
2006,103529,"Aisam Ul Haq Qureshi",0,1,1,0
2006,103530,"Zack Fleishman",0,3,3,0
2006,103592,"Jerome Haehnel",0,1,1,0
2006,103623,"Jacob Adaktusson",0,1,1,0
2006,103653,"Jasper Smit",0,1,1,0
2006,103676,"Michael Yani",0,1,1,0
2006,103684,"Benedikt Dorsch",0,1,1,0
2006,103730,"Jonathan Marray",0,1,1,0
2006,103746,"Miguel Gallardo Valles",0,1,1,0
2006,103761,"Tomas Cakl",0,2,2,0
2006,103775,"Felipe Parada",0,1,1,0
2006,103782,"Rameez Junaid",0,1,1,0
2006,103799,"Eric Prodon",0,1,1,0
2006,103812,"Victor Hanescu",0,6,6,0
2006,103817,"Yu Jr Wang",0,1,1,0
2006,103820,"Alan Mackin",0,1,1,0
2006,103837,"Didac Perez",0,1,1,0
2006,103849,"Francesco Aldi",0,1,1,0
2006,103893,"Paolo Lorenzi",0,1,1,0
2006,103914,"Omar Awadhy",0,1,1,0
2006,103967,"Michael Lammer",0,2,2,0
2006,103976,"Juan Pablo Brzezicki",0,1,1,0
2006,103984,"Julien Mathieu",0,1,1,0
2006,104004,"Filip Prpic",0,1,1,0
2006,104070,"Jesse Witten",0,2,2,0
2006,104115,"Marc Kimmich",0,1,1,0
2006,104117,"Giovanni Lapentti",0,1,1,0
2006,104121,"Tobias Summerer",0,1,1,0
2006,104136,"Santiago Gonzalez",0,2,2,0
2006,104161,"Tomislav Peric",0,1,1,0
2006,104181,"Victor Ionita",0,1,1,0
2006,104182,"Sasa Tuksar",0,1,1,0
2006,104195,"Simone Vagnozzi",0,1,1,0
2006,104208,"Damian Patriarca",0,1,1,0
2006,104217,"Simon Stadler",0,1,1,0
2006,104228,"Guillem Burniol",0,1,1,0
2006,104251,"Ti Chen",0,1,1,0
2006,104253,"Juan Martin Aranguren",0,1,1,0
2006,104262,"Flavio Cipolla",0,1,1,0
2006,104272,"Torsten Popp",0,2,2,0
2006,104317,"David Luque Velasco",0,1,1,0
2006,104327,"Steve Darcis",0,1,1,0
2006,104330,"Rajeev Ram",0,1,1,0
2006,104368,"Daniel King Turner",0,1,1,0
2006,104424,"Go Soeda",0,2,2,0
2006,104453,"Michael Ryderstedt",0,1,1,0
2006,104467,"Lamine Ouahab",0,1,1,0
2006,104488,"Armin Sandbichler",0,1,1,0
2006,104500,"Somdev Devvarman",0,1,1,0
2006,104501,"Xin Yuan Yu",0,1,1,0
2006,104503,"Guillermo Hormazabal",0,1,1,0
2006,104519,"Roman Vogeli",0,1,1,0
2006,104620,"Simone Bolelli",0,4,4,0
2006,104624,"Joshua Goodall",0,2,2,0
2006,104639,"Wayne Odesnik",0,1,1,0
2006,104676,"Andreas Beck",0,2,2,0
2006,104681,"Sebastian Rieschick",0,1,1,0
2006,104714,"Julian Reister",0,1,1,0
2006,104719,"Marcel Granollers",0,2,2,0
2006,104732,"Phillip Simmonds",0,1,1,0
2006,104770,"Martin Fischer",0,1,1,0
2006,104779,"Jamie Baker",0,2,2,0
2006,104797,"Denis Istomin",0,2,2,0
2006,104816,"Karan Rastogi",0,1,1,0
2006,104831,"Bartolome Salva Vidal",0,1,1,0
2006,104864,"Alex Kuznetsov",0,2,2,0
2006,104898,"Robin Haase",0,2,2,0
2006,104914,"Ervin Eleskovic",0,2,2,0
2006,104997,"Igor Sijsling",0,1,1,0
2006,105014,"Antal Van Der Duim",0,1,1,0
2006,105028,"Jesse Levine",0,1,1,0
2006,105030,"Michael Venus",0,1,1,0
2006,105066,"Grzegorz Panfil",0,1,1,0
2006,105098,"Alexandre Sidorenko",0,1,1,0
2006,105104,"Robin Roshardt",0,1,1,0
2006,105166,"Peter Polansky",0,1,1,0
2006,105229,"Philip Bester",0,1,1,0
2006,105231,"Luka Belic",0,1,1,0
2006,105238,"Alexandr Dolgopolov",0,1,1,0
2006,105385,"Donald Young",0,3,3,0
2006,105501,"Akash Wagh",0,1,1,0
2006,105671,"Gastao Elias",0,1,1,0
2007,102202,"Kenneth Carlsen",0,1,1,0
2007,102306,"Michael Kohlmann",0,1,1,0
2007,102548,"Juan Antonio Marin",0,1,1,0
2007,102667,"Satoshi Iwabuchi",0,1,1,0
2007,102694,"Lars Burgsmuller",0,1,1,0
2007,102780,"Frederic Niemeyer",0,1,1,0
2007,102800,"Nenad Zimonjic",0,1,1,0
2007,102863,"Takao Suzuki",0,1,1,0
2007,102881,"David Skoch",0,1,1,0
2007,102945,"Luke Bourgeois",0,1,1,0
2007,102950,"Fernando Vicente",0,5,5,0
2007,102956,"Sultan Khalfan",0,1,1,0
2007,102987,"Andre Sa",0,1,1,0
2007,102998,"Jan Michael Gambill",0,2,2,0
2007,103063,"Sebastien De Chaunac",0,1,1,0
2007,103165,"Gorka Fraile",0,2,2,0
2007,103185,"Mike Bryan",0,1,1,0
2007,103201,"Adrian Garcia",0,4,4,0
2007,103228,"Marcos Daniel",0,2,2,0
2007,103238,"Jean Claude Scherrer",0,1,1,0
2007,103248,"Harel Levy",0,1,1,0
2007,103250,"Rodolphe Cadart",0,1,1,0
2007,103280,"Martin Verkerk",0,9,9,0
2007,103356,"Michel Kratochvil",0,1,1,0
2007,103385,"Paul Baccanello",0,1,1,0
2007,103403,"Takahiro Terachi",0,1,1,0
2007,103523,"Rohan Bopanna",0,3,3,0
2007,103592,"Jerome Haehnel",0,2,2,0
2007,103600,"Mohammad Ghareeb",0,1,1,0
2007,103675,"Diego Junqueira",0,2,2,0
2007,103718,"David Martin",0,1,1,0
2007,103730,"Jonathan Marray",0,1,1,0
2007,103805,"Catalin Gard",0,1,1,0
2007,103820,"Alan Mackin",0,1,1,0
2007,103823,"Denis Gremelmayr",0,4,4,0
2007,103830,"Shao Xuan Zeng",0,1,1,0
2007,103862,"Michail Elgin",0,1,1,0
2007,103894,"Phillip King",0,3,3,0
2007,103914,"Omar Awadhy",0,1,1,0
2007,103924,"Marc Fornell Mestres",0,1,1,0
2007,103967,"Michael Lammer",0,1,1,0
2007,103978,"Rabie Chaki",0,1,1,0
2007,103997,"Lukasz Kubot",0,3,3,0
2007,104001,"Brian Wilson",0,2,2,0
2007,104014,"Lee Childs",0,1,1,0
2007,104035,"Bobby Reynolds",0,3,3,0
2007,104043,"Marc Lopez",0,1,1,0
2007,104070,"Jesse Witten",0,1,1,0
2007,104095,"David Guez",0,2,2,0
2007,104112,"Benjamin Balleret",0,1,1,0
2007,104136,"Santiago Gonzalez",0,1,1,0
2007,104140,"Dawid Olejniczak",0,1,1,0
2007,104171,"Richard Bloomfield",0,3,3,0
2007,104179,"Bruno Echagaray",0,2,2,0
2007,104216,"Maximo Gonzalez",0,2,2,0
2007,104233,"Frederik Nielsen",0,1,1,0
2007,104234,"Predrag Rusevski",0,1,1,0
2007,104251,"Ti Chen",0,1,1,0
2007,104261,"Peng Sun",0,1,1,0
2007,104297,"Rogerio Dutra Silva",0,1,1,0
2007,104330,"Rajeev Ram",0,1,1,0
2007,104361,"Michel Koning",0,1,1,0
2007,104368,"Daniel King Turner",0,1,1,0
2007,104424,"Go Soeda",0,3,3,0
2007,104469,"Erling Tveit",0,1,1,0
2007,104478,"Hyun Woo Nam",0,1,1,0
2007,104500,"Somdev Devvarman",0,2,2,0
2007,104501,"Xin Yuan Yu",0,1,1,0
2007,104586,"Lukas Rosol",0,1,1,0
2007,104619,"Jesse Huta Galung",0,1,1,0
2007,104624,"Joshua Goodall",0,2,2,0
2007,104646,"Purav Raja",0,1,1,0
2007,104655,"Pablo Cuevas",0,1,1,0
2007,104660,"Sergiy Stakhovsky",0,2,2,0
2007,104676,"Andreas Beck",0,1,1,0
2007,104684,"Navdeep Singh",0,1,1,0
2007,104714,"Julian Reister",0,1,1,0
2007,104724,"Eduardo Schwank",0,1,1,0
2007,104731,"Kevin Anderson",0,1,1,0
2007,104735,"Tobias Kamke",0,1,1,0
2007,104736,"Farrukh Dustov",0,1,1,0
2007,104753,"Woong Sun Jun",0,3,3,0
2007,104760,"Scott Oudsema",0,1,1,0
2007,104770,"Martin Fischer",0,1,1,0
2007,104831,"Bartolome Salva Vidal",0,4,4,0
2007,104868,"James Ward",0,1,1,0
2007,104871,"Jeremy Chardy",0,3,3,0
2007,104890,"Andreas Haider Maurer",0,1,1,0
2007,104914,"Ervin Eleskovic",0,1,1,0
2007,105041,"Lukas Lacko",0,2,2,0
2007,105053,"Santiago Giraldo",0,4,4,0
2007,105062,"Mikhail Kukushkin",0,1,1,0
2007,105098,"Alexandre Sidorenko",0,1,1,0
2007,105131,"Tim Goransson",0,1,1,0
2007,105155,"Pedro Sousa",0,1,1,0
2007,105166,"Peter Polansky",0,1,1,0
2007,105189,"Pavel Chekhov",0,1,1,0
2007,105229,"Philip Bester",0,1,1,0
2007,105231,"Luka Belic",0,1,1,0
2007,105238,"Alexandr Dolgopolov",0,1,1,0
2007,105402,"Peerakiat Siriluethaiwattana",0,1,1,0
2007,105404,"Michael Mcclune",0,1,1,0
2007,105559,"Jonathan Eysseric",0,2,2,0
2007,105579,"Kittipong Wachiramanowong",0,1,1,0
2008,102318,"Andrei Pavel",0,3,3,0
2008,102667,"Satoshi Iwabuchi",0,1,1,0
2008,102720,"Tomas Zib",0,1,1,0
2008,102780,"Frederic Niemeyer",0,3,3,0
2008,102856,"Gustavo Kuerten",0,4,4,0
2008,102881,"David Skoch",0,1,1,0
2008,102887,"Ramon Delgado",0,2,2,0
2008,102950,"Fernando Vicente",0,1,1,0
2008,103063,"Sebastien De Chaunac",0,2,2,0
2008,103076,"Justin Oneal",0,1,1,0
2008,103077,"Konstantinos Economidis",0,1,1,0
2008,103151,"Mariano Zabaleta",0,2,2,0
2008,103171,"Raemon Sluiter",0,1,1,0
2008,103174,"Noam Okun",0,1,1,0
2008,103201,"Adrian Garcia",0,1,1,0
2008,103240,"Kevin Kim",0,3,3,0
2008,103248,"Harel Levy",0,3,3,0
2008,103280,"Martin Verkerk",0,3,3,0
2008,103292,"Gaston Gaudio",0,1,1,0
2008,103420,"Michal Tabara",0,2,2,0
2008,103437,"Francesco Piccari",0,1,1,0
2008,103444,"Jean Rene Lisnard",0,2,2,0
2008,103455,"Michal Mertinak",0,1,1,0
2008,103520,"Pavel Snobel",0,2,2,0
2008,103530,"Zack Fleishman",0,1,1,0
2008,103594,"Oliver Marach",0,2,2,0
2008,103600,"Mohammad Ghareeb",0,1,1,0
2008,103607,"Victor Estrella",0,1,1,0
2008,103657,"Ivo Klec",0,2,2,0
2008,103676,"Michael Yani",0,1,1,0
2008,103684,"Benedikt Dorsch",0,2,2,0
2008,103709,"Kristian Pless",0,2,2,0
2008,103748,"Jan Minar",0,2,2,0
2008,103752,"Simon Greul",0,1,1,0
2008,103758,"Taylor Dent",0,2,2,0
2008,103761,"Tomas Cakl",0,1,1,0
2008,103799,"Eric Prodon",0,4,4,0
2008,103821,"Danai Udomchoke",0,2,2,0
2008,103822,"Scott Lipsky",0,1,1,0
2008,103830,"Shao Xuan Zeng",0,1,1,0
2008,103843,"Marco Chiudinelli",0,1,1,0
2008,103849,"Francesco Aldi",0,1,1,0
2008,103926,"Daniel Munoz de la Nava",0,1,1,0
2008,103967,"Michael Lammer",0,1,1,0
2008,104004,"Filip Prpic",0,2,2,0
2008,104070,"Jesse Witten",0,1,1,0
2008,104082,"Hiroki Kondo",0,1,1,0
2008,104095,"David Guez",0,2,2,0
2008,104140,"Dawid Olejniczak",0,2,2,0
2008,104166,"Alex Bogomolov Jr",0,2,2,0
2008,104171,"Richard Bloomfield",0,1,1,0
2008,104179,"Bruno Echagaray",0,1,1,0
2008,104192,"Marco Crugnola",0,1,1,0
2008,104195,"Simone Vagnozzi",0,1,1,0
2008,104209,"Rainer Eitzinger",0,2,2,0
2008,104225,"Jan Hajek",0,1,1,0
2008,104233,"Frederik Nielsen",0,2,2,0
2008,104235,"Matwe Middelkoop",0,1,1,0
2008,104261,"Peng Sun",0,2,2,0
2008,104292,"Izak Van Der Merwe",0,1,1,0
2008,104308,"Michal Przysiezny",0,3,3,0
2008,104334,"Alberto Brizzi",0,1,1,0
2008,104368,"Daniel King Turner",0,1,1,0
2008,104397,"Laurent Recouderc",0,1,1,0
2008,104445,"Jose Antonio Sanchez De Luna",0,2,2,0
2008,104470,"Komlavi Loglo",0,1,1,0
2008,104471,"Ivan Dodig",0,1,1,0
2008,104478,"Hyun Woo Nam",0,1,1,0
2008,104501,"Xin Yuan Yu",0,1,1,0
2008,104618,"Devin Mullings",0,1,1,0
2008,104624,"Joshua Goodall",0,1,1,0
2008,104635,"Robert Smeets",0,5,5,0
2008,104667,"Philipp Oswald",0,1,1,0
2008,104692,"Alexander Slabinsky",0,1,1,0
2008,104707,"Denis Matsukevitch",0,1,1,0
2008,104711,"G Jones",0,1,1,0
2008,104735,"Tobias Kamke",0,1,1,0
2008,104770,"Martin Fischer",0,3,3,0
2008,104779,"Jamie Baker",0,3,3,0
2008,104781,"Yuichi Ito",0,1,1,0
2008,104812,"Scoville Jenkins",0,2,2,0
2008,104823,"Bruno Rodriguez",0,1,1,0
2008,104830,"Matteo Marrai",0,1,1,0
2008,104831,"Bartolome Salva Vidal",0,1,1,0
2008,104868,"James Ward",0,2,2,0
2008,104897,"Matthias Bachinger",0,4,4,0
2008,104907,"Jose Rubin Statham",0,1,1,0
2008,104958,"Carsten Ball",0,1,1,0
2008,104965,"Pavol Cervenak",0,1,1,0
2008,104986,"Vishnu Vardhan",0,1,1,0
2008,104997,"Igor Sijsling",0,1,1,0
2008,105015,"Franko Skugor",0,1,1,0
2008,105041,"Lukas Lacko",0,1,1,0
2008,105065,"Tim Smyczek",0,1,1,0
2008,105070,"Hans Podlipnik Castillo",0,1,1,0
2008,105098,"Alexandre Sidorenko",0,1,1,0
2008,105099,"Antonio Veic",0,1,1,0
2008,105104,"Robin Roshardt",0,1,1,0
2008,105131,"Tim Goransson",0,1,1,0
2008,105147,"Tatsuma Ito",0,1,1,0
2008,105166,"Peter Polansky",0,2,2,0
2008,105194,"Nick Lindahl",0,1,1,0
2008,105216,"Yuichi Sugita",0,1,1,0
2008,105220,"Jun Chao Xu",0,1,1,0
2008,105231,"Luka Belic",0,1,1,0
2008,105286,"Greg Jones",0,1,1,0
2008,105339,"Yan Bai",0,1,1,0
2008,105341,"Thomas Fabbiano",0,1,1,0
2008,105454,"Brydan Klein",0,1,1,0
2008,105471,"Cesar Ramirez",0,1,1,0
2008,105539,"Evgeny Donskoy",0,1,1,0
2008,105554,"Daniel Evans",0,1,1,0
2008,105559,"Jonathan Eysseric",0,1,1,0
2008,105572,"Austin Krajicek",0,1,1,0
2008,105575,"Ricardas Berankis",0,2,2,0
2008,105590,"Uladzimir Ignatik",0,1,1,0
2008,105668,"Jerzy Janowicz",0,1,1,0
2008,105671,"Gastao Elias",0,1,1,0
2008,105777,"Grigor Dimitrov",0,1,1,0
2008,105831,"Marko Djokovic",0,1,1,0
2008,108993,"Abdulla Hajji",0,1,1,0
2008,108996,"Mahmoud Nader Al Baloushi",0,1,1,0
2008,108997,"Clint Bowles",0,1,1,0
2009,102318,"Andrei Pavel",0,6,6,0
2009,102512,"Joseph Sirianni",0,2,2,0
2009,102703,"Hyung Taik Lee",0,1,1,0
2009,102863,"Takao Suzuki",0,1,1,0
2009,102887,"Ramon Delgado",0,1,1,0
2009,102950,"Fernando Vicente",0,1,1,0
2009,103104,"Bjorn Rehnquist",0,1,1,0
2009,103181,"Jiri Vanek",0,2,2,0
2009,103248,"Harel Levy",0,1,1,0
2009,103393,"Yuri Schukin",0,1,1,0
2009,103395,"Julio Silva",0,1,1,0
2009,103437,"Francesco Piccari",0,1,1,0
2009,103503,"Robin Vik",0,1,1,0
2009,103521,"Andrea Stoppini",0,2,2,0
2009,103535,"Olivier Patience",0,2,2,0
2009,103581,"Flavio Saretta",0,1,1,0
2009,103592,"Jerome Haehnel",0,1,1,0
2009,103594,"Oliver Marach",0,1,1,0
2009,103600,"Mohammad Ghareeb",0,1,1,0
2009,103672,"Ricardo Mello",0,3,3,0
2009,103676,"Michael Yani",0,3,3,0
2009,103735,"Lovro Zovko",0,1,1,0
2009,103747,"Dominik Meffert",0,2,2,0
2009,103821,"Danai Udomchoke",0,5,5,0
2009,103835,"Filippo Volandri",0,3,3,0
2009,103893,"Paolo Lorenzi",0,1,1,0
2009,103926,"Daniel Munoz de la Nava",0,2,2,0
2009,103976,"Juan Pablo Brzezicki",0,2,2,0
2009,103978,"Rabie Chaki",0,1,1,0
2009,104010,"Dieter Kindlmann",0,4,4,0
2009,104081,"Boris Pashanski",0,1,1,0
2009,104117,"Giovanni Lapentti",0,3,3,0
2009,104136,"Santiago Gonzalez",0,2,2,0
2009,104158,"Andrew Anderson",0,1,1,0
2009,104171,"Richard Bloomfield",0,1,1,0
2009,104179,"Bruno Echagaray",0,1,1,0
2009,104192,"Marco Crugnola",0,1,1,0
2009,104211,"Roman Valent",0,1,1,0
2009,104219,"Stephane Bohli",0,4,4,0
2009,104233,"Frederik Nielsen",0,2,2,0
2009,104305,"Luka Gregorc",0,1,1,0
2009,104308,"Michal Przysiezny",0,1,1,0
2009,104368,"Daniel King Turner",0,1,1,0
2009,104385,"Lars Poerschke",0,1,1,0
2009,104397,"Laurent Recouderc",0,4,4,0
2009,104415,"Colin Fleming",0,1,1,0
2009,104424,"Go Soeda",0,3,3,0
2009,104453,"Michael Ryderstedt",0,1,1,0
2009,104456,"Colin Ebelthite",0,1,1,0
2009,104467,"Lamine Ouahab",0,3,3,0
2009,104504,"Ross Hutchins",0,1,1,0
2009,104550,"Ricardo Hocevar",0,2,2,0
2009,104579,"Romain Jouan",0,1,1,0
2009,104586,"Lukas Rosol",0,1,1,0
2009,104592,"Ilija Bozoljac",0,1,1,0
2009,104595,"Sascha Kloer",0,1,1,0
2009,104619,"Jesse Huta Galung",0,2,2,0
2009,104623,"Josh Goodall",0,1,1,0
2009,104644,"Riccardo Ghedin",0,1,1,0
2009,104672,"Vincent Millot",0,2,2,0
2009,104736,"Farrukh Dustov",0,1,1,0
2009,104738,"Caio Zampieri",0,1,1,0
2009,104807,"Mehdi Ziadi",0,1,1,0
2009,104813,"Grega Zemlja",0,2,2,0
2009,104882,"Blaz Kavcic",0,1,1,0
2009,104890,"Andreas Haider Maurer",0,1,1,0
2009,104896,"Bruno Agostinelli",0,1,1,0
2009,104907,"Jose Rubin Statham",0,1,1,0
2009,105001,"Mao Xin Gong",0,1,1,0
2009,105053,"Santiago Giraldo",0,3,3,0
2009,105138,"Roberto Bautista Agut",0,1,1,0
2009,105147,"Tatsuma Ito",0,2,2,0
2009,105149,"Reda El Amrani",0,1,1,0
2009,105173,"Adrian Mannarino",0,4,4,0
2009,105180,"Daniel Dutra Da Silva",0,1,1,0
2009,105216,"Yuichi Sugita",0,1,1,0
2009,105254,"Nikola Mektic",0,1,1,0
2009,105331,"Petru Alexandru Luncanu",0,2,2,0
2009,105373,"Martin Klizan",0,1,1,0
2009,105385,"Donald Young",0,4,4,0
2009,105440,"Arsenije Zlatanovic",0,1,1,0
2009,105539,"Evgeny Donskoy",0,1,1,0
2009,105554,"Daniel Evans",0,1,1,0
2009,105573,"Henri Kontinen",0,1,1,0
2009,105579,"Kittipong Wachiramanowong",0,1,1,0
2009,105643,"Federico Delbonis",0,1,1,0
2009,105668,"Jerzy Janowicz",0,2,2,0
2009,105683,"Milos Raonic",0,1,1,0
2009,105720,"Stanislav Vovk",0,3,3,0
2009,105730,"Devin Britton",0,2,2,0
2009,105783,"Chase Buchanan",0,1,1,0
2009,105906,"Kevin Krawietz",0,1,1,0
2009,105936,"Filip Krajinovic",0,1,1,0
2009,105960,"Evan King",0,1,1,0
2009,105987,"Mikhail Biryukov",0,1,1,0
2009,106026,"Yuki Bhambri",0,1,1,0
2009,106090,"Daniel Berta",0,2,2,0
2009,108993,"Abdulla Hajji",0,1,1,0
2010,101404,"Thomas Muster",0,1,1,0
2010,102148,"Fabrice Santoro",0,1,1,0
2010,102434,"Vincent Spadea",0,1,1,0
2010,102886,"Frantisek Cermak",0,2,2,0
2010,102999,"Stefano Galvani",0,1,1,0
2010,103103,"Dominik Hrbaty",0,1,1,0
2010,103174,"Noam Okun",0,2,2,0
2010,103292,"Gaston Gaudio",0,1,1,0
2010,103294,"Christophe Rochus",0,10,10,0
2010,103395,"Julio Silva",0,1,1,0
2010,103401,"Jan Hernych",0,1,1,0
2010,103427,"Yew Ming Si",0,1,1,0
2010,103470,"Robert Kendrick",0,4,4,0
2010,103472,"Karim Maamoun",0,1,1,0
2010,103506,"Martin Vassallo Arguello",0,4,4,0
2010,103523,"Rohan Bopanna",0,2,2,0
2010,103535,"Olivier Patience",0,2,2,0
2010,103573,"Rik De Voest",0,3,3,0
2010,103580,"Alexander Peya",0,1,1,0
2010,103600,"Mohammad Ghareeb",0,1,1,0
2010,103675,"Diego Junqueira",0,2,2,0
2010,103676,"Michael Yani",0,2,2,0
2010,103682,"Kyu Tae Im",0,1,1,0
2010,103693,"Thierry Ascione",0,3,3,0
2010,103782,"Rameez Junaid",0,1,1,0
2010,103821,"Danai Udomchoke",0,1,1,0
2010,103851,"Conor Niland",0,1,1,0
2010,104010,"Dieter Kindlmann",0,2,2,0
2010,104035,"Bobby Reynolds",0,2,2,0
2010,104043,"Marc Lopez",0,2,2,0
2010,104070,"Jesse Witten",0,2,2,0
2010,104095,"David Guez",0,5,5,0
2010,104112,"Benjamin Balleret",0,1,1,0
2010,104117,"Giovanni Lapentti",0,2,2,0
2010,104136,"Santiago Gonzalez",0,1,1,0
2010,104166,"Alex Bogomolov Jr",0,1,1,0
2010,104217,"Simon Stadler",0,1,1,0
2010,104219,"Stephane Bohli",0,3,3,0
2010,104226,"Bastian Knittel",0,1,1,0
2010,104233,"Frederik Nielsen",0,1,1,0
2010,104250,"Prakash Amritraj",0,1,1,0
2010,104253,"Juan Martin Aranguren",0,1,1,0
2010,104262,"Flavio Cipolla",0,1,1,0
2010,104281,"Ryler Deheart",0,3,3,0
2010,104297,"Rogerio Dutra Silva",0,1,1,0
2010,104368,"Daniel King Turner",0,1,1,0
2010,104372,"Alex Bogdanovic",0,1,1,0
2010,104385,"Lars Poerschke",0,1,1,0
2010,104465,"Martin Emmrich",0,1,1,0
2010,104477,"Jorge Aguilar",0,2,2,0
2010,104550,"Ricardo Hocevar",0,2,2,0
2010,104579,"Romain Jouan",0,1,1,0
2010,104586,"Lukas Rosol",0,2,2,0
2010,104589,"Chris Guccione",0,2,2,0
2010,104619,"Jesse Huta Galung",0,1,1,0
2010,104628,"Alexander Kudryavtsev",0,1,1,0
2010,104661,"Pierre Ludovic Duclos",0,1,1,0
2010,104695,"Fritz Wolmarans",0,1,1,0
2010,104736,"Farrukh Dustov",0,1,1,0
2010,104739,"Guillermo Alcaide",0,1,1,0
2010,104779,"Jamie Baker",0,3,3,0
2010,104783,"Mikhail Ledovskikh",0,1,1,0
2010,104807,"Mehdi Ziadi",0,1,1,0
2010,104850,"Jonathan Dasnieres De Veigy",0,1,1,0
2010,105001,"Mao Xin Gong",0,1,1,0
2010,105070,"Hans Podlipnik Castillo",0,1,1,0
2010,105084,"James Lemke",0,1,1,0
2010,105116,"Dusan Lojda",0,1,1,0
2010,105138,"Roberto Bautista Agut",0,1,1,0
2010,105147,"Tatsuma Ito",0,1,1,0
2010,105161,"Yann Marti",0,1,1,0
2010,105194,"Nick Lindahl",0,6,6,0
2010,105229,"Philip Bester",0,1,1,0
2010,105318,"Thomas Schoorel",0,1,1,0
2010,105341,"Thomas Fabbiano",0,1,1,0
2010,105357,"John Millman",0,1,1,0
2010,105376,"Peter Gojowczyk",0,1,1,0
2010,105413,"Andrej Martin",0,1,1,0
2010,105438,"Inigo Cervantes Huegun",0,1,1,0
2010,105449,"Steve Johnson",0,1,1,0
2010,105554,"Daniel Evans",0,1,1,0
2010,105583,"Dusan Lajovic",0,2,2,0
2010,105585,"Ze Zhang",0,1,1,0
2010,105589,"Gerald Melzer",0,1,1,0
2010,105601,"Cristobal Saavedra Corvalan",0,1,1,0
2010,105609,"Ilya Belyaev",0,1,1,0
2010,105614,"Bradley Klahn",0,1,1,0
2010,105643,"Federico Delbonis",0,2,2,0
2010,105657,"Marius Copil",0,1,1,0
2010,105668,"Jerzy Janowicz",0,2,2,0
2010,105730,"Devin Britton",0,1,1,0
2010,105738,"Tsung Hua Yang",0,3,3,0
2010,105831,"Marko Djokovic",0,1,1,0
2010,105842,"Di Wu",0,1,1,0
2010,105872,"Christian Lindell",0,1,1,0
2010,105894,"Javier Marti",0,1,1,0
2010,105906,"Kevin Krawietz",0,1,1,0
2010,105917,"Gianni Mina",0,2,2,0
2010,106006,"Agustin Velotti",0,1,1,0
2010,106058,"Jack Sock",0,1,1,0
2010,106186,"Jason Kubler",0,1,1,0
2010,108993,"Abdulla Hajji",0,1,1,0
2011,101404,"Thomas Muster",0,2,2,0
2011,102905,"Stefan Koubek",0,1,1,0
2011,102967,"Marc Gicquel",0,3,3,0
2011,102999,"Stefano Galvani",0,1,1,0
2011,103228,"Marcos Daniel",0,3,3,0
2011,103393,"Yuri Schukin",0,1,1,0
2011,103454,"Nicolas Massu",0,1,1,0
2011,103523,"Rohan Bopanna",0,2,2,0
2011,103534,"Nicolas Devilder",0,1,1,0
2011,103580,"Alexander Peya",0,1,1,0
2011,103708,"Jaroslav Pospisil",0,4,4,0
2011,103714,"Andreas Vinciguerra",0,1,1,0
2011,103747,"Dominik Meffert",0,1,1,0
2011,103799,"Eric Prodon",0,3,3,0
2011,103850,"Sebastian Decoud",0,1,1,0
2011,103851,"Conor Niland",0,2,2,0
2011,103914,"Omar Awadhy",0,1,1,0
2011,103926,"Daniel Munoz de la Nava",0,1,1,0
2011,103969,"Roman Borvanov",0,1,1,0
2011,103999,"Thiago Alves",0,1,1,0
2011,104007,"Andre Ghem",0,1,1,0
2011,104025,"Amer Delic",0,1,1,0
2011,104035,"Bobby Reynolds",0,3,3,0
2011,104071,"Raven Klaasen",0,1,1,0
2011,104095,"David Guez",0,1,1,0
2011,104106,"Ludovic Walter",0,1,1,0
2011,104154,"Paul Capdeville",0,7,7,0
2011,104171,"Richard Bloomfield",0,1,1,0
2011,104192,"Marco Crugnola",0,1,1,0
2011,104217,"Simon Stadler",0,1,1,0
2011,104219,"Stephane Bohli",0,4,4,0
2011,104225,"Jan Hajek",0,8,8,0
2011,104227,"Augustin Gensse",0,2,2,0
2011,104233,"Frederik Nielsen",0,1,1,0
2011,104372,"Alex Bogdanovic",0,1,1,0
2011,104415,"Colin Fleming",0,1,1,0
2011,104476,"Louk Sorensen",0,1,1,0
2011,104477,"Jorge Aguilar",0,1,1,0
2011,104505,"Konstantin Kravchuk",0,2,2,0
2011,104535,"Daniel Garza",0,1,1,0
2011,104550,"Ricardo Hocevar",0,1,1,0
2011,104579,"Romain Jouan",0,1,1,0
2011,104639,"Wayne Odesnik",0,1,1,0
2011,104640,"Pablo Galdon",0,1,1,0
2011,104672,"Vincent Millot",0,4,4,0
2011,104676,"Andreas Beck",0,4,4,0
2011,104677,"Artem Sitak",0,1,1,0
2011,104692,"Alexander Slabinsky",0,1,1,0
2011,104729,"Ivan Nedelko",0,1,1,0
2011,104732,"Phillip Simmonds",0,1,1,0
2011,104770,"Martin Fischer",0,4,4,0
2011,104778,"Andrey Kumantsov",0,1,1,0
2011,104783,"Mikhail Ledovskikh",0,1,1,0
2011,104789,"Sherif Sabry",0,1,1,0
2011,104810,"Zhe Li",0,2,2,0
2011,104820,"Erik Chvojka",0,1,1,0
2011,104857,"Robert Farah",0,4,4,0
2011,104864,"Alex Kuznetsov",0,1,1,0
2011,104932,"Kenny De Schepper",0,2,2,0
2011,104958,"Carsten Ball",0,1,1,0
2011,104967,"Alexander Sadecky",0,1,1,0
2011,104975,"Evgeny Kirillov",0,1,1,0
2011,105001,"Mao Xin Gong",0,1,1,0
2011,105015,"Franko Skugor",0,3,3,0
2011,105028,"Jesse Levine",0,1,1,0
2011,105030,"Michael Venus",0,1,1,0
2011,105091,"Peter Torebko",0,1,1,0
2011,105132,"Jurgen Zopp",0,1,1,0
2011,105149,"Reda El Amrani",0,2,2,0
2011,105155,"Pedro Sousa",0,1,1,0
2011,105161,"Yann Marti",0,1,1,0
2011,105254,"Nikola Mektic",0,1,1,0
2011,105262,"Fernando Romboli",0,1,1,0
2011,105283,"Gerard Granollers",0,2,2,0
2011,105286,"Greg Jones",0,3,3,0
2011,105300,"Sergio Gutierrez Ferrol",0,1,1,0
2011,105357,"John Millman",0,1,1,0
2011,105373,"Martin Klizan",0,2,2,0
2011,105449,"Steve Johnson",0,2,2,0
2011,105487,"Facundo Bagnis",0,2,2,0
2011,105539,"Evgeny Donskoy",0,2,2,0
2011,105554,"Daniel Evans",0,2,2,0
2011,105579,"Kittipong Wachiramanowong",0,1,1,0
2011,105614,"Bradley Klahn",0,1,1,0
2011,105638,"Daniel Cox",0,3,3,0
2011,105668,"Jerzy Janowicz",0,1,1,0
2011,105671,"Gastao Elias",0,1,1,0
2011,105688,"Manuel Sanchez",0,1,1,0
2011,105707,"Nicolaas Scholtz",0,1,1,0
2011,105807,"Pablo Carreno Busta",0,1,1,0
2011,105827,"Laurynas Grigelis",0,1,1,0
2011,105842,"Di Wu",0,1,1,0
2011,105872,"Christian Lindell",0,4,4,0
2011,105941,"Felipe Rios",0,1,1,0
2011,106026,"Yuki Bhambri",0,1,1,0
2011,106105,"Guilherme Clezar",0,1,1,0
2011,106207,"Mate Pavic",0,1,1,0
2011,106243,"Mate Delic",0,1,1,0
2011,106244,"Oliver Golding",0,1,1,0
2011,106246,"Robin Kern",0,1,1,0
2012,102382,"Julian Knowle",0,1,1,0
2012,102967,"Marc Gicquel",0,1,1,0
2012,103165,"Gorka Fraile",0,1,1,0
2012,103444,"Jean Rene Lisnard",0,1,1,0
2012,103454,"Nicolas Massu",0,1,1,0
2012,103470,"Robert Kendrick",0,1,1,0
2012,103565,"Stephane Robert",0,3,3,0
2012,103573,"Rik De Voest",0,3,3,0
2012,103657,"Ivo Klec",0,1,1,0
2012,103735,"Lovro Zovko",0,3,3,0
2012,103799,"Eric Prodon",0,7,7,0
2012,103821,"Danai Udomchoke",0,2,2,0
2012,103863,"Mikhail Elgin",0,1,1,0
2012,103914,"Omar Awadhy",0,1,1,0
2012,103925,"Gabriel Moraru",0,1,1,0
2012,103999,"Thiago Alves",0,1,1,0
2012,104003,"Victor Crivoi",0,1,1,0
2012,104025,"Amer Delic",0,1,1,0
2012,104112,"Benjamin Balleret",0,1,1,0
2012,104136,"Santiago Gonzalez",0,1,1,0
2012,104216,"Maximo Gonzalez",0,1,1,0
2012,104219,"Stephane Bohli",0,1,1,0
2012,104233,"Frederik Nielsen",0,1,1,0
2012,104453,"Michael Ryderstedt",0,1,1,0
2012,104473,"Walter Trusendi",0,1,1,0
2012,104500,"Somdev Devvarman",0,3,3,0
2012,104516,"Arnau Brugues Davi",0,1,1,0
2012,104535,"Daniel Garza",0,1,1,0
2012,104589,"Chris Guccione",0,1,1,0
2012,104623,"Josh Goodall",0,1,1,0
2012,104628,"Alexander Kudryavtsev",0,1,1,0
2012,104629,"Adrian Menendez Maceiras",0,1,1,0
2012,104644,"Riccardo Ghedin",0,1,1,0
2012,104661,"Pierre Ludovic Duclos",0,1,1,0
2012,104693,"Dominic Inglot",0,1,1,0
2012,104729,"Ivan Nedelko",0,1,1,0
2012,104778,"Andrey Kumantsov",0,1,1,0
2012,104783,"Mikhail Ledovskikh",0,1,1,0
2012,104807,"Mehdi Ziadi",0,1,1,0
2012,104810,"Zhe Li",0,1,1,0
2012,104820,"Erik Chvojka",0,1,1,0
2012,104839,"Yassine Idmbarek",0,1,1,0
2012,104850,"Jonathan Dasnieres De Veigy",0,1,1,0
2012,104864,"Alex Kuznetsov",0,2,2,0
2012,104890,"Andreas Haider Maurer",0,3,3,0
2012,104893,"Maxime Authom",0,1,1,0
2012,104947,"Marsel Ilhan",0,3,3,0
2012,104953,"Nikolai Fidirko",0,1,1,0
2012,104963,"Yannick Mertens",0,1,1,0
2012,104970,"Matteo Viola",0,3,3,0
2012,104971,"Blake Strode",0,1,1,0
2012,104986,"Vishnu Vardhan",0,2,2,0
2012,104999,"Mischa Zverev",0,3,3,0
2012,105011,"Illya Marchenko",0,1,1,0
2012,105029,"Sergey Betov",0,1,1,0
2012,105030,"Michael Venus",0,1,1,0
2012,105072,"Sanam Singh",0,1,1,0
2012,105120,"Andres Molteni",0,1,1,0
2012,105155,"Pedro Sousa",0,1,1,0
2012,105166,"Peter Polansky",0,1,1,0
2012,105175,"Kristijan Mesaros",0,1,1,0
2012,105217,"Thiemo De Bakker",0,2,2,0
2012,105270,"Maxime Teixeira",0,2,2,0
2012,105283,"Gerard Granollers",0,1,1,0
2012,105286,"Greg Jones",0,1,1,0
2012,105294,"Dennis Lajola",0,1,1,0
2012,105336,"Nicolas Meister",0,1,1,0
2012,105357,"John Millman",0,1,1,0
2012,105376,"Peter Gojowczyk",0,1,1,0
2012,105402,"Peerakiat Siriluethaiwattana",0,1,1,0
2012,105471,"Cesar Ramirez",0,1,1,0
2012,105529,"Carlos Gomez Herrera",0,1,1,0
2012,105539,"Evgeny Donskoy",0,4,4,0
2012,105550,"Guido Pella",0,1,1,0
2012,105554,"Daniel Evans",0,1,1,0
2012,105572,"Austin Krajicek",0,1,1,0
2012,105671,"Gastao Elias",0,1,1,0
2012,105711,"Dino Marcan",0,1,1,0
2012,105733,"Rhyne Williams",0,2,2,0
2012,105738,"Tsung Hua Yang",0,1,1,0
2012,105757,"Sandro Ehrat",0,1,1,0
2012,105781,"Andrei Vasilevski",0,1,1,0
2012,105819,"Guido Andreozzi",0,1,1,0
2012,105831,"Marko Djokovic",0,2,2,0
2012,105842,"Di Wu",0,2,2,0
2012,105872,"Christian Lindell",0,1,1,0
2012,105916,"Marton Fucsovics",0,1,1,0
2012,105967,"Henri Laaksonen",0,2,2,0
2012,106053,"Philip Davydenko",0,1,1,0
2012,106093,"Benjamin Mitchell",0,2,2,0
2012,106244,"Oliver Golding",0,2,2,0
2012,106246,"Robin Kern",0,1,1,0
2012,106277,"Ariez Elyaas Deen Heshaam",0,1,1,0
2012,106281,"Liam Broady",0,1,1,0
2012,106325,"Jabor Al Mutawa",0,1,1,0
2012,108701,"Juan Sebastian Cabal",0,1,1,0
2013,100644,"Alexander Zverev",0,1,1,0
2013,102967,"Marc Gicquel",0,5,5,0
2013,103454,"Nicolas Massu",0,1,1,0
2013,103523,"Rohan Bopanna",0,1,1,0
2013,103573,"Rik De Voest",0,1,1,0
2013,103657,"Ivo Klec",0,1,1,0
2013,103672,"Ricardo Mello",0,1,1,0
2013,103714,"Andreas Vinciguerra",0,1,1,0
2013,103722,"Florent Serra",0,4,4,0
2013,103843,"Marco Chiudinelli",0,4,4,0
2013,103857,"Igor Kunitsyn",0,2,2,0
2013,103863,"Mikhail Elgin",0,1,1,0
2013,104003,"Victor Crivoi",0,1,1,0
2013,104043,"Marc Lopez",0,1,1,0
2013,104112,"Benjamin Balleret",0,1,1,0
2013,104113,"Carlos Salamanca",0,1,1,0
2013,104214,"Igor Andreev",0,1,1,0
2013,104219,"Stephane Bohli",0,1,1,0
2013,104226,"Bastian Knittel",0,1,1,0
2013,104233,"Frederik Nielsen",0,2,2,0
2013,104275,"Josko Topic",0,1,1,0
2013,104291,"Malek Jaziri",0,1,1,0
2013,104349,"Rui Machado",0,1,1,0
2013,104368,"Daniel King Turner",0,1,1,0
2013,104477,"Jorge Aguilar",0,1,1,0
2013,104494,"Adrian Ungur",0,7,7,0
2013,104535,"Daniel Garza",0,1,1,0
2013,104592,"Ilija Bozoljac",0,3,3,0
2013,104619,"Jesse Huta Galung",0,4,4,0
2013,104627,"Boy Westerhof",0,1,1,0
2013,104629,"Adrian Menendez Maceiras",0,2,2,0
2013,104644,"Riccardo Ghedin",0,1,1,0
2013,104676,"Andreas Beck",0,2,2,0
2013,104693,"Dominic Inglot",0,1,1,0
2013,104721,"Josselin Ouanna",0,2,2,0
2013,104770,"Martin Fischer",0,3,3,0
2013,104779,"Jamie Baker",0,2,2,0
2013,104803,"Younes Rachidi",0,1,1,0
2013,104807,"Mehdi Ziadi",0,1,1,0
2013,104847,"Adrien Bossel",0,1,1,0
2013,104851,"Gianluca Naso",0,1,1,0
2013,104868,"James Ward",0,3,3,0
2013,104873,"Aleksandr Nedovyesov",0,1,1,0
2013,104893,"Maxime Authom",0,1,1,0
2013,104905,"Nicolas Barrientos",0,1,1,0
2013,104944,"Niels Desein",0,1,1,0
2013,104960,"Miguel Angel Reyes Varela",0,1,1,0
2013,104976,"Ryan Sweeting",0,1,1,0
2013,105001,"Mao Xin Gong",0,1,1,0
2013,105011,"Illya Marchenko",0,4,4,0
2013,105060,"Aldin Setkic",0,1,1,0
2013,105099,"Antonio Veic",0,5,5,0
2013,105100,"Edward Corrie",0,1,1,0
2013,105137,"Pere Riba",0,2,2,0
2013,105155,"Pedro Sousa",0,1,1,0
2013,105166,"Peter Polansky",0,1,1,0
2013,105254,"Nikola Mektic",0,1,1,0
2013,105270,"Maxime Teixeira",0,1,1,0
2013,105283,"Gerard Granollers",0,1,1,0
2013,105292,"Alejandro Gonzalez",0,1,1,0
2013,105302,"Ante Pavic",0,1,1,0
2013,105341,"Thomas Fabbiano",0,1,1,0
2013,105413,"Andrej Martin",0,1,1,0
2013,105427,"Milos Sekulic",0,1,1,0
2013,105436,"Markus Eriksson",0,2,2,0
2013,105441,"John Patrick Smith",0,1,1,0
2013,105471,"Cesar Ramirez",0,1,1,0
2013,105528,"Alexander Ward",0,1,1,0
2013,105583,"Dusan Lajovic",0,4,4,0
2013,105585,"Ze Zhang",0,2,2,0
2013,105589,"Gerald Melzer",0,2,2,0
2013,105591,"Matt Reid",0,1,1,0
2013,105679,"Eduardo Struvay",0,1,1,0
2013,105711,"Dino Marcan",0,1,1,0
2013,105842,"Di Wu",0,3,3,0
2013,105894,"Javier Marti",0,1,1,0
2013,105906,"Kevin Krawietz",0,1,1,0
2013,105936,"Filip Krajinovic",0,1,1,0
2013,105987,"Mikhail Biryukov",0,1,1,0
2013,106006,"Agustin Velotti",0,1,1,0
2013,106026,"Yuki Bhambri",0,1,1,0
2013,106032,"Facundo Arguello",0,3,3,0
2013,106065,"Marco Cecchinato",0,1,1,0
2013,106093,"Benjamin Mitchell",0,2,2,0
2013,106105,"Guilherme Clezar",0,1,1,0
2013,106148,"Roberto Carballes Baena",0,1,1,0
2013,106158,"Suk Young Jeong",0,1,1,0
2013,106207,"Mate Pavic",0,3,3,0
2013,106210,"Jiri Vesely",0,5,5,0
2013,106228,"Juan Ignacio Londero",0,1,1,0
2013,106234,"Aslan Karatsev",0,2,2,0
2013,106246,"Robin Kern",0,1,1,0
2013,106291,"Luke Saville",0,1,1,0
2013,106325,"Jabor Al Mutawa",0,1,1,0
2013,106374,"Filip Veger",0,1,1,0
2013,106397,"Wishaya Trongcharoenchaikul",0,1,1,0
2013,106432,"Borna Coric",0,1,1,0
2013,110476,"Mousa Shanan Zayed",0,1,1,0
2013,110536,"Kevin King",0,1,1,0
2013,110602,"Dennis Novak",0,1,1,0
2013,111200,"Elias Ymer",0,1,1,0
2013,111202,"Hyeon Chung",0,1,1,0
2013,111456,"Mackenzie Mcdonald",0,1,1,0
2013,111513,"Laslo Djere",0,1,1,0
2013,111578,"Stefan Kozlov",0,1,1,0
2013,122279,"Romain Bogaerts",0,1,1,0
2013,123768,"Collin Altamirano",0,1,1,0
2014,103105,"Ruben Ramirez Hidalgo",0,3,3,0
2014,103722,"Florent Serra",0,1,1,0
2014,103843,"Marco Chiudinelli",0,3,3,0
2014,103926,"Daniel Munoz de la Nava",0,1,1,0
2014,104043,"Marc Lopez",0,1,1,0
2014,104095,"David Guez",0,2,2,0
2014,104112,"Benjamin Balleret",0,1,1,0
2014,104225,"Jan Hajek",0,3,3,0
2014,104327,"Steve Darcis",0,1,1,0
2014,104393,"Gregoire Burquier",0,1,1,0
2014,104467,"Lamine Ouahab",0,1,1,0
2014,104505,"Konstantin Kravchuk",0,1,1,0
2014,104589,"Chris Guccione",0,1,1,0
2014,104639,"Wayne Odesnik",0,5,5,0
2014,104667,"Philipp Oswald",0,1,1,0
2014,104676,"Andreas Beck",0,3,3,0
2014,104736,"Farrukh Dustov",0,3,3,0
2014,104905,"Nicolas Barrientos",0,1,1,0
2014,104907,"Jose Rubin Statham",0,1,1,0
2014,104944,"Niels Desein",0,1,1,0
2014,104945,"James Mcgee",0,1,1,0
2014,104947,"Marsel Ilhan",0,5,5,0
2014,104960,"Miguel Angel Reyes Varela",0,1,1,0
2014,104970,"Matteo Viola",0,1,1,0
2014,104993,"Martin Vaisse",0,1,1,0
2014,105030,"Michael Venus",0,1,1,0
2014,105059,"Kento Takeuchi",0,1,1,0
2014,105063,"Andrea Arnaboldi",0,1,1,0
2014,105080,"Miloslav Mecir Jr",0,2,2,0
2014,105113,"Patrik Rosenholm",0,1,1,0
2014,105216,"Yuichi Sugita",0,3,3,0
2014,105233,"Jeevan Nedunchezhiyan",0,1,1,0
2014,105245,"Fabiano De Paula",0,1,1,0
2014,105339,"Yan Bai",0,1,1,0
2014,105413,"Andrej Martin",0,1,1,0
2014,105436,"Markus Eriksson",0,1,1,0
2014,105441,"John Patrick Smith",0,2,2,0
2014,105561,"Alessandro Giannessi",0,1,1,0
2014,105585,"Ze Zhang",0,2,2,0
2014,105589,"Gerald Melzer",0,3,3,0
2014,105613,"Norbert Gombos",0,2,2,0
2014,105634,"Viktor Galovic",0,1,1,0
2014,105638,"Daniel Cox",0,2,2,0
2014,105651,"Daniel Smethurst",0,1,1,0
2014,105655,"Hiroki Moriya",0,2,2,0
2014,105679,"Eduardo Struvay",0,1,1,0
2014,105731,"Steven Diez",0,1,1,0
2014,105783,"Chase Buchanan",0,1,1,0
2014,105806,"Mirza Basic",0,1,1,0
2014,105830,"Hicham Khaddari",0,1,1,0
2014,105842,"Di Wu",0,2,2,0
2014,105853,"Tigre Hank",0,1,1,0
2014,105882,"Stefano Travaglia",0,1,1,0
2014,105917,"Gianni Mina",0,1,1,0
2014,105930,"Daniel Kosakowski",0,1,1,0
2014,105932,"Nikoloz Basilashvili",0,1,1,0
2014,105999,"Bowen Ouyang",0,1,1,0
2014,106032,"Facundo Arguello",0,5,5,0
2014,106065,"Marco Cecchinato",0,3,3,0
2014,106066,"Victor Baluda",0,1,1,0
2014,106078,"Egor Gerasimov",0,1,1,0
2014,106105,"Guilherme Clezar",0,2,2,0
2014,106174,"Gonzalo Lama",0,1,1,0
2014,106218,"Marcos Giron",0,2,2,0
2014,106228,"Juan Ignacio Londero",0,1,1,0
2014,106234,"Aslan Karatsev",0,1,1,0
2014,106238,"Andres Artunedo Martinavarro",0,1,1,0
2014,106283,"Mitchell Krueger",0,1,1,0
2014,106293,"Kimmer Coppejans",0,1,1,0
2014,106321,"Xin Gao",0,1,1,0
2014,106353,"Pedja Krstin",0,2,2,0
2014,106362,"Laurent Lokoli",0,2,2,0
2014,106378,"Kyle Edmund",0,5,5,0
2014,106415,"Yoshihito Nishioka",0,1,1,0
2014,106426,"Cristian Garin",0,2,2,0
2014,106430,"Patrick Ciorcila",0,1,1,0
2014,108701,"Juan Sebastian Cabal",0,1,1,0
2014,110476,"Mousa Shanan Zayed",0,1,1,0
2014,110536,"Kevin King",0,1,1,0
2014,110636,"Clay Thompson",0,1,1,0
2014,111156,"Nathan Pasha",0,1,1,0
2014,111442,"Jordan Thompson",0,1,1,0
2014,111444,"Karim Hossam",0,1,1,0
2014,111511,"Noah Rubin",0,2,2,0
2014,111575,"Karen Khachanov",0,2,2,0
2014,111577,"Jared Donaldson",0,2,2,0
2014,111578,"Stefan Kozlov",0,1,1,0
2014,111790,"Brayden Schnur",0,1,1,0
2014,117357,"Omar Jasika",0,1,1,0
2014,126094,"Andrey Rublev",0,1,1,0
2014,126207,"Frances Tiafoe",0,1,1,0
2015,103188,"Michael Russell",0,1,1,0
2015,104007,"Andre Ghem",0,1,1,0
2015,104095,"David Guez",0,1,1,0
2015,104112,"Benjamin Balleret",0,1,1,0
2015,104117,"Giovanni Lapentti",0,1,1,0
2015,104216,"Maximo Gonzalez",0,6,6,0
2015,104297,"Rogerio Dutra Silva",0,3,3,0
2015,104308,"Michal Przysiezny",0,2,2,0
2015,104433,"Frank Dancevic",0,3,3,0
2015,104499,"Jimmy Wang",0,1,1,0
2015,104500,"Somdev Devvarman",0,2,2,0
2015,104505,"Konstantin Kravchuk",0,1,1,0
2015,104535,"Daniel Garza",0,1,1,0
2015,104619,"Jesse Huta Galung",0,1,1,0
2015,104628,"Alexander Kudryavtsev",0,2,2,0
2015,104672,"Vincent Millot",0,3,3,0
2015,104676,"Andreas Beck",0,1,1,0
2015,104736,"Farrukh Dustov",0,1,1,0
2015,104770,"Martin Fischer",0,1,1,0
2015,104783,"Mikhail Ledovskikh",0,1,1,0
2015,104802,"Fabrice Martin",0,1,1,0
2015,104822,"N Vijay Sundar Prashanth",0,1,1,0
2015,104839,"Yassine Idmbarek",0,1,1,0
2015,104847,"Adrien Bossel",0,1,1,0
2015,104873,"Aleksandr Nedovyesov",0,5,5,0
2015,104905,"Nicolas Barrientos",0,1,1,0
2015,104907,"Jose Rubin Statham",0,1,1,0
2015,104944,"Niels Desein",0,1,1,0
2015,104945,"James Mcgee",0,1,1,0
2015,105026,"Takuto Niki",0,1,1,0
2015,105047,"Tim Puetz",0,1,1,0
2015,105098,"Alexandre Sidorenko",0,1,1,0
2015,105099,"Antonio Veic",0,1,1,0
2015,105120,"Andres Molteni",0,1,1,0
2015,105132,"Jurgen Zopp",0,2,2,0
2015,105137,"Pere Riba",0,2,2,0
2015,105229,"Philip Bester",0,1,1,0
2015,105270,"Maxime Teixeira",0,1,1,0
2015,105271,"Gonzalo Escobar",0,1,1,0
2015,105281,"Eric Quigley",0,1,1,0
2015,105302,"Ante Pavic",0,2,2,0
2015,105325,"Germain Gigounon",0,1,1,0
2015,105341,"Thomas Fabbiano",0,3,3,0
2015,105401,"Matteo Trevisan",0,1,1,0
2015,105436,"Markus Eriksson",0,1,1,0
2015,105438,"Inigo Cervantes Huegun",0,1,1,0
2015,105454,"Brydan Klein",0,1,1,0
2015,105613,"Norbert Gombos",0,2,2,0
2015,105633,"Mohamed Safwat",0,1,1,0
2015,105671,"Gastao Elias",0,2,2,0
2015,105733,"Rhyne Williams",0,1,1,0
2015,105841,"Lorenzo Giustino",0,1,1,0
2015,105842,"Di Wu",0,3,3,0
2015,105888,"Toni Androic",0,2,2,0
2015,105916,"Marton Fucsovics",0,2,2,0
2015,105943,"Federico Gaio",0,1,1,0
2015,105967,"Henri Laaksonen",0,2,2,0
2015,105985,"Darian King",0,1,1,0
2015,106005,"Constant Lestienne",0,1,1,0
2015,106026,"Yuki Bhambri",0,1,1,0
2015,106034,"Yasutaka Uchiyama",0,2,2,0
2015,106065,"Marco Cecchinato",0,4,4,0
2015,106105,"Guilherme Clezar",0,3,3,0
2015,106109,"Alex Bolt",0,1,1,0
2015,106138,"Yaraslav Shyla",0,1,1,0
2015,106207,"Mate Pavic",0,1,1,0
2015,106216,"Bjorn Fratangelo",0,2,2,0
2015,106243,"Mate Delic",0,2,2,0
2015,106261,"Dennis Novikov",0,1,1,0
2015,106290,"Filip Peliwo",0,1,1,0
2015,106291,"Luke Saville",0,2,2,0
2015,106293,"Kimmer Coppejans",0,3,3,0
2015,106325,"Jabor Al Mutawa",0,1,1,0
2015,106362,"Laurent Lokoli",0,2,2,0
2015,106368,"Ramkumar Ramanathan",0,2,2,0
2015,106393,"Frederico Ferreira Silva",0,1,1,0
2015,109739,"Maximilian Marterer",0,2,2,0
2015,110754,"David Vega Hernandez",0,1,1,0
2015,111153,"Christopher Eubanks",0,1,1,0
2015,111192,"Lucas Miedler",0,1,1,0
2015,111442,"Jordan Thompson",0,1,1,0
2015,111460,"Quentin Halys",0,2,2,0
2015,111506,"Maxime Hamou",0,2,2,0
2015,111511,"Noah Rubin",0,1,1,0
2015,111513,"Laslo Djere",0,1,1,0
2015,111578,"Stefan Kozlov",0,2,2,0
2015,117356,"Cem Ilkel",0,2,2,0
2015,123921,"Calvin Hemery",0,1,1,0
2015,126152,"Ryan Shane",0,1,1,0
2015,126205,"Tommy Paul",0,1,1,0
2015,144707,"Mikael Ymer",0,1,1,0
2016,103401,"Jan Hernych",0,1,1,0
2016,103835,"Filippo Volandri",0,2,2,0
2016,103857,"Igor Kunitsyn",0,1,1,0
2016,104007,"Andre Ghem",0,1,1,0
2016,104095,"David Guez",0,1,1,0
2016,104117,"Giovanni Lapentti",0,1,1,0
2016,104308,"Michal Przysiezny",0,1,1,0
2016,104424,"Go Soeda",0,1,1,0
2016,104467,"Lamine Ouahab",0,1,1,0
2016,104500,"Somdev Devvarman",0,1,1,0
2016,104628,"Alexander Kudryavtsev",0,2,2,0
2016,104676,"Andreas Beck",0,1,1,0
2016,104802,"Fabrice Martin",0,1,1,0
2016,104804,"Amir Weintraub",0,2,2,0
2016,104810,"Zhe Li",0,2,2,0
2016,104864,"Alex Kuznetsov",0,2,2,0
2016,104868,"James Ward",0,3,3,0
2016,104897,"Matthias Bachinger",0,1,1,0
2016,104945,"James Mcgee",0,1,1,0
2016,104947,"Marsel Ilhan",0,5,5,0
2016,105030,"Michael Venus",0,1,1,0
2016,105031,"Saketh Myneni",0,1,1,0
2016,105051,"Matthew Ebden",0,4,4,0
2016,105060,"Aldin Setkic",0,1,1,0
2016,105137,"Pere Riba",0,1,1,0
2016,105149,"Reda El Amrani",0,1,1,0
2016,105155,"Pedro Sousa",0,1,1,0
2016,105161,"Yann Marti",0,1,1,0
2016,105271,"Gonzalo Escobar",0,1,1,0
2016,105292,"Alejandro Gonzalez",0,3,3,0
2016,105426,"Michael Linzer",0,2,2,0
2016,105454,"Brydan Klein",0,2,2,0
2016,105515,"Jordi Samper Montana",0,1,1,0
2016,105528,"Alexander Ward",0,2,2,0
2016,105585,"Ze Zhang",0,3,3,0
2016,105586,"Alexandar Lazov",0,1,1,0
2016,105649,"Cedrik Marcel Stebe",0,1,1,0
2016,105655,"Hiroki Moriya",0,1,1,0
2016,105668,"Jerzy Janowicz",0,3,3,0
2016,105751,"Roberto Ortega Olmedo",0,1,1,0
2016,105782,"Enrique Lopez Perez",0,1,1,0
2016,105819,"Guido Andreozzi",0,1,1,0
2016,105841,"Lorenzo Giustino",0,1,1,0
2016,105853,"Tigre Hank",0,2,2,0
2016,105872,"Christian Lindell",0,1,1,0
2016,105874,"Albano Olivetti",0,1,1,0
2016,105877,"Emilio Gomez",0,1,1,0
2016,105943,"Federico Gaio",0,1,1,0
2016,105985,"Darian King",0,1,1,0
2016,106006,"Agustin Velotti",0,1,1,0
2016,106026,"Yuki Bhambri",0,3,3,0
2016,106032,"Facundo Arguello",0,2,2,0
2016,106035,"Isak Arvidsson",0,1,1,0
2016,106093,"Benjamin Mitchell",0,1,1,0
2016,106099,"Salvatore Caruso",0,1,1,0
2016,106105,"Guilherme Clezar",0,2,2,0
2016,106167,"Joris De Loore",0,1,1,0
2016,106220,"Dimitar Kuzmanov",0,1,1,0
2016,106234,"Aslan Karatsev",0,2,2,0
2016,106250,"Luis Patino",0,1,1,0
2016,106269,"Austin Smith",0,1,1,0
2016,106281,"Liam Broady",0,2,2,0
2016,106291,"Luke Saville",0,1,1,0
2016,106296,"Gregoire Barrere",0,2,2,0
2016,106328,"Christian Harrison",0,1,1,0
2016,106393,"Frederico Ferreira Silva",0,1,1,0
2016,106398,"Pedro Cachin",0,1,1,0
2016,106412,"Lucas Gomez",0,2,2,0
2016,106423,"Thanasi Kokkinakis",0,1,1,0
2016,106426,"Cristian Garin",0,1,1,0
2016,109739,"Maximilian Marterer",0,2,2,0
2016,110596,"Fred Simonsson",0,1,1,0
2016,110602,"Dennis Novak",0,1,1,0
2016,110686,"Finn Tearney",0,1,1,0
2016,111153,"Christopher Eubanks",0,1,1,0
2016,111456,"Mackenzie Mcdonald",0,3,3,0
2016,111513,"Laslo Djere",0,1,1,0
2016,111581,"Michael Mmoh",0,3,3,0
2016,111797,"Nicolas Jarry",0,2,2,0
2016,117352,"Oliver Anderson",0,1,1,0
2016,117356,"Cem Ilkel",0,2,2,0
2016,117361,"Akira Santillan",0,2,2,0
2016,120424,"Yannick Maden",0,1,1,0
2016,122570,"Mubarak Shannan Zayid",0,1,1,0
2016,123828,"Jan Choinski",0,1,1,0
2016,125802,"Ilya Ivashka",0,1,1,0
2016,126120,"Nino Serdarusic",0,1,1,0
2016,126627,"Johan Nikles",0,1,1,0
2016,126646,"Tim Van Rijthoven",0,1,1,0
2016,132283,"Lorenzo Sonego",0,1,1,0
2016,134472,"Antoine Bellier",0,1,1,0
2016,134770,"Casper Ruud",0,1,1,0
2016,144719,"Jaume Munar",0,1,1,0
2016,144760,"Amine Ahouda",0,1,1,0
2016,202359,"Marvin Moeller",0,1,1,0
2017,103781,"Jurgen Melzer",0,1,1,0
2017,103794,"Benjamin Becker",0,3,3,0
2017,103843,"Marco Chiudinelli",0,4,4,0
2017,103914,"Omar Awadhy",0,1,1,0
2017,104338,"Juan Monaco",0,3,3,0
2017,104424,"Go Soeda",0,3,3,0
2017,104559,"Teymuraz Gabashvili",0,3,3,0
2017,104563,"Luca Vanni",0,2,2,0
2017,104593,"Daniel Gimeno Traver",0,1,1,0
2017,104677,"Artem Sitak",0,1,1,0
2017,104868,"James Ward",0,2,2,0
2017,104882,"Blaz Kavcic",0,2,2,0
2017,104890,"Andreas Haider Maurer",0,3,3,0
2017,104907,"Jose Rubin Statham",0,1,1,0
2017,105030,"Michael Venus",0,1,1,0
2017,105031,"Saketh Myneni",0,1,1,0
2017,105060,"Aldin Setkic",0,1,1,0
2017,105147,"Tatsuma Ito",0,2,2,0
2017,105254,"Nikola Mektic",0,1,1,0
2017,105359,"Jason Jung",0,2,2,0
2017,105406,"Roberto Marcora",0,1,1,0
2017,105438,"Inigo Cervantes Huegun",0,1,1,0
2017,105441,"John Patrick Smith",0,3,3,0
2017,105497,"Jose Hernandez",0,1,1,0
2017,105528,"Alexander Ward",0,1,1,0
2017,105551,"Anil Yuksel",0,1,1,0
2017,105559,"Jonathan Eysseric",0,1,1,0
2017,105572,"Austin Krajicek",0,1,1,0
2017,105585,"Ze Zhang",0,3,3,0
2017,105688,"Manuel Sanchez",0,1,1,0
2017,105692,"Alessandro Bega",0,1,1,0
2017,105731,"Steven Diez",0,1,1,0
2017,105821,"Riccardo Bellotti",0,1,1,0
2017,105841,"Lorenzo Giustino",0,1,1,0
2017,105871,"Sekou Bangoura",0,1,1,0
2017,105877,"Emilio Gomez",0,1,1,0
2017,105902,"James Duckworth",0,1,1,0
2017,106006,"Agustin Velotti",0,1,1,0
2017,106099,"Salvatore Caruso",0,1,1,0
2017,106105,"Guilherme Clezar",0,1,1,0
2017,106109,"Alex Bolt",0,2,2,0
2017,106137,"Tristan Lamasine",0,1,1,0
2017,106207,"Mate Pavic",0,1,1,0
2017,106220,"Dimitar Kuzmanov",0,1,1,0
2017,106288,"Mathias Bourgue",0,2,2,0
2017,106293,"Kimmer Coppejans",0,1,1,0
2017,106296,"Gregoire Barrere",0,1,1,0
2017,106311,"Marko Tepavac",0,1,1,0
2017,106324,"Vaclav Safranek",0,1,1,0
2017,106328,"Christian Harrison",0,2,2,0
2017,106331,"Christopher Oconnell",0,2,2,0
2017,106335,"Alexios Halebian",0,1,1,0
2017,106362,"Laurent Lokoli",0,1,1,0
2017,106412,"Lucas Gomez",0,1,1,0
2017,106425,"Blake Mott",0,1,1,0
2017,106426,"Cristian Garin",0,1,1,0
2017,109054,"Daniel Masur",0,2,2,0
2017,109739,"Maximilian Marterer",0,10,10,0
2017,110686,"Finn Tearney",0,1,1,0
2017,111506,"Maxime Hamou",0,1,1,0
2017,111515,"Thai Son Kwiatkowski",0,2,2,0
2017,111574,"Jc Aragone",0,1,1,0
2017,111581,"Michael Mmoh",0,4,4,0
2017,111790,"Brayden Schnur",0,1,1,0
2017,111794,"Kamil Majchrzak",0,1,1,0
2017,111797,"Nicolas Jarry",0,2,2,0
2017,117356,"Cem Ilkel",0,3,3,0
2017,117357,"Omar Jasika",0,1,1,0
2017,117360,"Marc Polmans",0,2,2,0
2017,117365,"Petros Chrysochos",0,1,1,0
2017,122548,"Edan Leshem",0,1,1,0
2017,122570,"Mubarak Shannan Zayid",0,1,1,0
2017,123921,"Calvin Hemery",0,1,1,0
2017,124186,"Alexandre Muller",0,1,1,0
2017,126128,"Roman Safiullin",0,1,1,0
2017,126149,"Gianluca Mager",0,1,1,0
2017,126185,"Evgenii Tiurnev",0,1,1,0
2017,126197,"Orlando Luz",0,1,1,0
2017,126208,"Yusuke Takahashi",0,1,1,0
2017,126610,"Matteo Berrettini",0,1,1,0
2017,134472,"Antoine Bellier",0,1,1,0
2017,134868,"Tallon Griekspoor",0,2,2,0
2017,136440,"Dominik Koepfer",0,1,1,0
2017,144707,"Mikael Ymer",0,5,5,0
2017,144750,"Lloyd Harris",0,2,2,0
2017,144972,"Geoffrey Blancaneaux",0,1,1,0
2017,200059,"Yibing Wu",0,2,2,0
2017,200095,"Nicola Kuhn",0,1,1,0
2017,200247,"Alexandar Lazarov",0,1,1,0
2017,200484,"Rudolf Molleker",0,1,1,0
2017,200516,"Patrick Kypson",0,1,1,0
2018,103990,"Tommy Robredo",0,2,2,0
2018,104460,"Dustin Brown",0,4,4,0
2018,104563,"Luca Vanni",0,1,1,0
2018,104593,"Daniel Gimeno Traver",0,1,1,0
2018,104597,"Nicolas Almagro",0,1,1,0
2018,104810,"Zhe Li",0,1,1,0
2018,104890,"Andreas Haider Maurer",0,9,9,0
2018,104932,"Kenny De Schepper",0,2,2,0
2018,104947,"Marsel Ilhan",0,1,1,0
2018,104970,"Matteo Viola",0,1,1,0
2018,104978,"Daniel Brands",0,1,1,0
2018,105030,"Michael Venus",0,1,1,0
2018,105147,"Tatsuma Ito",0,1,1,0
2018,105163,"Gleb Sakharov",0,1,1,0
2018,105217,"Thiemo De Bakker",0,1,1,0
2018,105226,"Attila Balazs",0,1,1,0
2018,105441,"John Patrick Smith",0,4,4,0
2018,105497,"Jose Hernandez",0,1,1,0
2018,105515,"Jordi Samper Montana",0,1,1,0
2018,105554,"Daniel Evans",0,1,1,0
2018,105585,"Ze Zhang",0,1,1,0
2018,105613,"Norbert Gombos",0,3,3,0
2018,105626,"Takanyi Garanganga",0,1,1,0
2018,105633,"Mohamed Safwat",0,2,2,0
2018,105649,"Cedrik Marcel Stebe",0,2,2,0
2018,105656,"Marcelo Arevalo",0,1,1,0
2018,105842,"Di Wu",0,1,1,0
2018,105943,"Federico Gaio",0,2,2,0
2018,105952,"Renzo Olivo",0,1,1,0
2018,105960,"Evan King",0,1,1,0
2018,105985,"Darian King",0,2,2,0
2018,106167,"Joris De Loore",0,1,1,0
2018,106220,"Dimitar Kuzmanov",0,1,1,0
2018,106228,"Juan Ignacio Londero",0,1,1,0
2018,106296,"Gregoire Barrere",0,4,4,0
2018,106324,"Vaclav Safranek",0,1,1,0
2018,106325,"Jabor Al Mutawa",0,1,1,0
2018,106348,"Evgeny Karlovskiy",0,1,1,0
2018,106393,"Frederico Ferreira Silva",0,1,1,0
2018,106398,"Pedro Cachin",0,1,1,0
2018,106412,"Lucas Gomez",0,2,2,0
2018,106426,"Cristian Garin",0,1,1,0
2018,110536,"Kevin King",0,2,2,0
2018,111153,"Christopher Eubanks",0,1,1,0
2018,111190,"Zhizhen Zhang",0,1,1,0
2018,111192,"Lucas Miedler",0,1,1,0
2018,111459,"Arjun Kadhe",0,1,1,0
2018,111515,"Thai Son Kwiatkowski",0,1,1,0
2018,111574,"Jc Aragone",0,1,1,0
2018,111576,"Sumit Nagal",0,1,1,0
2018,111578,"Stefan Kozlov",0,1,1,0
2018,111790,"Brayden Schnur",0,1,1,0
2018,111795,"Filippo Baldi",0,1,1,0
2018,117356,"Cem Ilkel",0,2,2,0
2018,123755,"Daniel Elahi Galan",0,1,1,0
2018,123768,"Collin Altamirano",0,1,1,0
2018,124079,"Pedro Martinez",0,2,2,0
2018,126120,"Nino Serdarusic",0,1,1,0
2018,126125,"Maxime Janvier",0,1,1,0
2018,126127,"Benjamin Bonzi",0,1,1,0
2018,126845,"Max Purcell",0,1,1,0
2018,126846,"Aleksandar Vukic",0,1,1,0
2018,126952,"Soon Woo Kwon",0,1,1,0
2018,127339,"Borna Gojo",0,1,1,0
2018,132482,"Liam Caruana",0,4,4,0
2018,144645,"Zdenek Kolar",0,1,1,0
2018,144760,"Amine Ahouda",0,1,1,0
2018,200031,"Lucas Catarina",0,1,1,0
2018,200175,"Miomir Kecmanovic",0,2,2,0
2018,200384,"Hugo Gaston",0,1,1,0
2018,200436,"Zsombor Piros",0,1,1,0
2018,200514,"Jurij Rodionov",0,1,1,0
2018,200574,"Alexander Donski",0,1,1,0
2018,200611,"Elliot Benchetrit",0,1,1,0
2018,200624,"Sebastian Korda",0,1,1,0
2018,202090,"Adrian Andreev",0,1,1,0
2018,202130,"Emil Reinberg",0,1,1,0
2018,202358,"Chun Hsin Tseng",0,1,1,0
2018,202385,"Jenson Brooksby",0,1,1,0
2018,205734,"Thiago Seyboth Wild",0,1,1,0
2019,103990,"Tommy Robredo",0,1,1,0
2019,104122,"Carlos Berlocq",0,3,3,0
2019,104297,"Rogerio Dutra Silva",0,1,1,0
2019,104534,"Dudi Sela",0,1,1,0
2019,104563,"Luca Vanni",0,1,1,0
2019,104735,"Tobias Kamke",0,1,1,0
2019,104804,"Amir Weintraub",0,1,1,0
2019,104810,"Zhe Li",0,4,4,0
2019,104868,"James Ward",0,3,3,0
2019,104970,"Matteo Viola",0,1,1,0
2019,105015,"Franko Skugor",0,1,1,0
2019,105063,"Andrea Arnaboldi",0,1,1,0
2019,105074,"Ruben Bemelmans",0,2,2,0
2019,105091,"Peter Torebko",0,1,1,0
2019,105147,"Tatsuma Ito",0,3,3,0
2019,105155,"Pedro Sousa",0,7,7,0
2019,105163,"Gleb Sakharov",0,1,1,0
2019,105166,"Peter Polansky",0,3,3,0
2019,105217,"Thiemo De Bakker",0,1,1,0
2019,105339,"Yan Bai",0,1,1,0
2019,105385,"Donald Young",0,2,2,0
2019,105413,"Andrej Martin",0,1,1,0
2019,105585,"Ze Zhang",0,2,2,0
2019,105633,"Mohamed Safwat",0,1,1,0
2019,105634,"Viktor Galovic",0,2,2,0
2019,105641,"Blaz Rola",0,1,1,0
2019,105656,"Marcelo Arevalo",0,1,1,0
2019,105757,"Sandro Ehrat",0,1,1,0
2019,105806,"Mirza Basic",0,2,2,0
2019,105870,"Yannick Hanfmann",0,2,2,0
2019,105902,"James Duckworth",0,3,3,0
2019,105943,"Federico Gaio",0,1,1,0
2019,105985,"Darian King",0,1,1,0
2019,106005,"Constant Lestienne",0,2,2,0
2019,106031,"Raymond Sarmiento",0,1,1,0
2019,106032,"Facundo Arguello",0,1,1,0
2019,106058,"Jack Sock",0,4,4,0
2019,106072,"Alexey Vatutin",0,2,2,0
2019,106186,"Jason Kubler",0,1,1,0
2019,106203,"Pedro Sakamoto",0,1,1,0
2019,106220,"Dimitar Kuzmanov",0,1,1,0
2019,106283,"Mitchell Krueger",0,1,1,0
2019,106293,"Kimmer Coppejans",0,2,2,0
2019,106353,"Pedja Krstin",0,1,1,0
2019,106412,"Lucas Gomez",0,1,1,0
2019,109640,"Andrea Basso",0,1,1,0
2019,109699,"Julian Lenz",0,2,2,0
2019,111192,"Lucas Miedler",0,1,1,0
2019,111453,"Mikael Torpegaard",0,1,1,0
2019,111459,"Arjun Kadhe",0,1,1,0
2019,111460,"Quentin Halys",0,1,1,0
2019,111511,"Noah Rubin",0,3,3,0
2019,111515,"Thai Son Kwiatkowski",0,1,1,0
2019,111574,"Jc Aragone",0,1,1,0
2019,111576,"Sumit Nagal",0,2,2,0
2019,111795,"Filippo Baldi",0,2,2,0
2019,117356,"Cem Ilkel",0,2,2,0
2019,121531,"Mats Moraing",0,1,1,0
2019,122570,"Mubarak Shannan Zayid",0,1,1,0
2019,124014,"Ernesto Escobedo",0,1,1,0
2019,124079,"Pedro Martinez",0,2,2,0
2019,124186,"Alexandre Muller",0,1,1,0
2019,126125,"Maxime Janvier",0,3,3,0
2019,126204,"Gerardo Lopez Villasenor",0,1,1,0
2019,126523,"Bernabe Zapata Miralles",0,2,2,0
2019,127157,"Daniel Altmaier",0,1,1,0
2019,133297,"Yosuke Watanuki",0,1,1,0
2019,144817,"Marc Andrea Huesler",0,1,1,0
2019,144946,"Rayane Roumane",0,1,1,0
2019,144984,"Artem Dubrivnyy",0,1,1,0
2019,144985,"Ergi Kirkin",0,1,1,0
2019,200031,"Lucas Catarina",0,1,1,0
2019,200218,"Mate Valkusz",0,1,1,0
2019,200247,"Alexandar Lazarov",0,1,1,0
2019,200368,"Jack Mingjie Lin",0,1,1,0
2019,200514,"Jurij Rodionov",0,2,2,0
2019,202090,"Adrian Andreev",0,1,1,0
2019,202103,"Francisco Cerundolo",0,1,1,0
2019,202358,"Chun Hsin Tseng",0,1,1,0
2019,202400,"Alastair Gray",0,1,1,0
2019,206703,"Paul Jubb",0,2,2,0
2019,207182,"Emilio Nava",0,1,1,0
2019,208230,"Alibek Kachmazov",0,1,1,0
2019,208260,"Zachary Svajda",0,1,1,0
